"master_key","cntyvtd","total","anglo","nanglo","asian","black","hisp","bh","vap","anglovap","nanglovap","asianvap","blackvap","hispvap","bhvap"
"n292109","292109",0,0,0,0,0,0,0,0,0,0,0,0,0,0
"n294043","294043",5072,1287,3785,228,1413,2195,3455,3598,1018,2580,156,967,1441,2343
"n390073","390073",1770,510,1260,139,687,431,1105,1211,384,827,97,458,264,714
"n650101","650101",679,585,94,3,4,55,58,515,461,54,3,2,31,32
"n850221","850221",7160,4974,2186,506,752,811,1523,5024,3617,1407,323,483,512,978
"n1134606","1134606",7614,1464,6150,195,405,5483,5847,5461,1283,4178,147,274,3669,3936
"n4850304","4850304",1730,956,774,26,123,574,686,1322,797,525,13,77,387,458
"n2150211","2150211",647,89,558,12,8,540,547,460,69,391,8,6,377,383
"n2450067","2450067",4037,371,3666,63,2818,772,3565,2904,328,2576,49,2044,467,2496
"n2890003","2890003",766,601,165,7,58,83,141,639,510,129,6,49,57,106
"n3210008","3210008",1230,680,550,3,83,427,506,940,545,395,1,61,302,362
"n4510201","4510201",5530,3031,2499,226,480,1751,2149,4486,2583,1903,191,394,1271,1615
"n4550007","4550007",250,217,33,1,7,13,20,192,169,23,0,4,10,14
"n1133077","1133077",5110,619,4491,266,2074,2172,4184,3773,557,3216,194,1551,1478,2992
"n1131724","1131724",401,76,325,10,197,124,314,254,59,195,7,116,74,187
"n2010218","2010218",6362,875,5487,156,254,5066,5267,4848,756,4092,129,191,3754,3922
"n2010881","2010881",7316,979,6337,540,2044,3847,5752,5022,772,4250,409,1345,2529,3807
"n2010550","2010550",7443,1322,6121,203,3414,2545,5827,5538,1193,4345,166,2407,1764,4102
"n2090112","2090112",3717,1138,2579,89,362,2124,2420,2905,971,1934,68,226,1620,1811
"n410018","410018",1118,141,977,5,318,645,953,861,126,735,5,263,462,717
"n670021","670021",459,392,67,5,17,24,41,340,298,42,4,10,18,28
"n850244","850244",4566,2404,2162,1544,193,321,503,3053,1655,1398,996,130,198,323
"n1134629","1134629",3946,597,3349,452,890,1996,2845,2853,523,2330,343,620,1345,1947
"n11330A4","11330A4",26,2,24,4,2,18,19,13,0,13,0,2,9,10
"n1131747","1131747",5587,1986,3601,1360,1208,960,2125,4408,1699,2709,1045,907,678,1567
"n2010195","2010195",2680,390,2290,46,1261,1013,2237,2145,349,1796,42,1050,716,1745
"n2030025","2030025",4430,3426,1004,80,334,453,774,3231,2602,629,48,214,257,467
"n2150188","2150188",4998,1040,3958,61,41,3847,3858,3764,1018,2746,39,16,2663,2672
"n2450044","2450044",1598,284,1314,43,423,850,1260,1112,241,871,34,272,560,828
"n4890002","4890002",145,25,120,3,2,114,116,118,25,93,0,2,90,92
"n1330001","1330001",4305,3171,1134,52,121,866,971,3352,2572,780,40,77,578,651
"n1410218","1410218",291,8,283,0,0,280,280,224,8,216,0,0,214,214
"n1573168","1573168",942,109,833,615,139,67,204,605,74,531,397,76,46,121
"n1870125","1870125",275,162,113,4,11,87,98,233,158,75,3,11,50,61
"n2010527","2010527",1627,187,1440,20,62,1367,1418,1175,161,1014,17,38,963,998
"n2010858","2010858",622,12,610,2,410,206,605,432,12,420,2,316,106,415
"n190409","190409",1272,808,464,16,14,344,358,1049,683,366,10,13,264,277
"n292064","292064",3969,706,3263,49,101,3115,3194,3073,626,2447,29,70,2327,2386
"n293202","293202",1735,760,975,142,116,715,812,1247,578,669,94,82,482,555
"n390027","390027",2656,1503,1153,428,386,303,685,2284,1376,908,318,314,233,545
"n2490004","2490004",1849,213,1636,8,6,1619,1622,1345,182,1163,3,3,1152,1152
"n2930303","2930303",312,224,88,9,18,52,69,256,199,57,7,13,27,40
"n3270004A","3270004A",310,209,101,0,2,96,97,237,157,80,0,2,75,76
"n3550022","3550022",649,153,496,15,13,481,487,508,121,387,11,6,377,378
"n3810227","3810227",4250,3212,1038,264,113,560,662,3375,2624,751,181,84,403,483
"n4270004","4270004",882,46,836,3,8,827,831,716,40,676,1,7,669,673
"n4394141","4394141",7771,2978,4793,928,1483,2333,3740,6110,2561,3549,722,1116,1633,2703
"n4392310","4392310",3680,1747,1933,156,1100,636,1674,2781,1469,1312,115,738,398,1116
"n214022","214022",4374,1900,2474,26,291,2057,2336,3198,1618,1580,19,224,1250,1470
"n294020","294020",3339,678,2661,146,244,2292,2491,2596,615,1981,123,179,1667,1825
"n292086","292086",5054,1503,3551,368,339,2825,3112,3892,1251,2641,299,245,2055,2275
"n390050","390050",5530,1072,4458,1014,2572,910,3375,4112,893,3219,733,1888,596,2433
"n610083","610083",3884,587,3297,31,28,3215,3226,2750,530,2220,25,20,2145,2156
"n850198","850198",186,117,69,1,4,59,61,140,98,42,1,2,35,37
"n3530008","3530008",195,171,24,0,2,17,18,169,154,15,0,1,10,11
"n3770004","3770004",1492,34,1458,44,7,1407,1414,1107,28,1079,28,5,1046,1051
"n4230057","4230057",621,550,71,26,26,14,38,561,501,60,22,21,12,31
"n2010904","2010904",0,0,0,0,0,0,0,0,0,0,0,0,0,0
"n2090218","2090218",65,10,55,4,14,35,49,38,4,34,1,8,24,32
"n2150234","2150234",3256,75,3181,4,21,3160,3166,2390,51,2339,3,15,2324,2327
"n2450090","2450090",73,14,59,8,37,15,50,60,14,46,7,29,11,38
"n2910018","2910018",2125,580,1545,20,1036,440,1466,1580,413,1167,19,831,276,1106
"n323003B","323003B",8068,204,7864,21,28,7806,7809,5595,148,5447,16,18,5409,5412
"n294206","294206",1077,296,781,47,159,598,731,757,225,532,34,100,405,489
"n291103","291103",1909,586,1323,85,127,1084,1196,1352,453,899,60,84,724,801
"n850052","850052",8073,2126,5947,3351,1060,1456,2492,5664,1637,4027,2314,719,921,1631
"n850058","850058",5532,2668,2864,1254,995,527,1488,4484,2314,2170,989,715,368,1067
"n1132300","1132300",2632,650,1982,85,130,1764,1861,1979,566,1413,72,91,1234,1311
"n1212091","1212091",5538,3889,1649,810,312,435,731,4736,3416,1320,662,240,328,560
"n4910399","4910399",1688,193,1495,1308,52,101,145,1021,137,884,784,29,53,80
"n2592060","2592060",2939,2130,809,63,36,642,668,1945,1455,490,38,21,381,396
"n3390033","3390033",4482,3199,1283,386,160,608,759,3955,2922,1033,321,126,484,608
"n38719-4","38719-4",420,354,66,2,42,10,51,346,290,56,2,42,6,47
"n4010111","4010111",3320,1889,1431,13,888,481,1364,2999,1714,1285,12,834,406,1235
"n4392474","4392474",1240,705,535,20,115,376,482,925,583,342,13,73,227,298
"n4530275","4530275",3018,2071,947,268,157,460,592,2438,1736,702,190,112,331,432
"n1510010B","1510010B",0,0,0,0,0,0,0,0,0,0,0,0,0,0
"n1572114","1572114",6942,272,6670,89,4426,2287,6576,5098,249,4849,61,3282,1578,4779
"n2010712","2010712",10110,1734,8376,568,2717,5222,7710,7052,1385,5667,432,1779,3499,5162
"n2010049","2010049",6772,2029,4743,168,1011,3532,4473,4673,1585,3088,98,643,2285,2901
"n2150048","2150048",6645,143,6502,77,24,6405,6408,4972,102,4870,54,10,4807,4808
"n2150042","2150042",5498,291,5207,46,44,5135,5162,3884,270,3614,38,33,3548,3572
"n294189","294189",1766,322,1444,63,527,897,1368,1205,267,938,41,334,580,892
"n291080","291080",7340,1427,5913,441,1286,4269,5388,5530,1232,4298,337,913,3025,3878
"n292041","292041",4356,245,4111,43,195,3892,4041,3354,216,3138,28,146,2967,3088
"n294183","294183",80,39,41,1,1,41,41,71,35,36,0,1,36,36
"n850035","850035",2577,1639,938,36,63,755,815,1920,1306,614,27,43,472,515
"n1132144","1132144",1910,1436,474,124,70,242,298,1647,1262,385,92,51,206,246
"n4530246","4530246",5843,2734,3109,712,702,1653,2276,4846,2451,2395,567,542,1233,1731
"n4710103","4710103",2443,1530,913,20,377,467,827,1916,1253,663,19,278,319,587
"n3290208","3290208",1808,676,1132,38,208,855,1047,1358,550,808,29,144,597,736
"n3390053","3390053",7747,4361,3386,165,516,2548,3012,5727,3485,2242,123,357,1629,1961
"n3830003B","3830003B",124,81,43,3,0,40,40,101,65,36,1,0,34,34
"n4030001","4030001",2487,2074,413,48,176,120,288,2056,1759,297,38,115,77,188
"n4392402","4392402",93,40,53,13,31,13,39,88,39,49,13,28,12,35
"n4393192","4393192",1338,950,388,66,123,165,274,1110,809,301,50,95,129,215
"n1212068","1212068",6944,3597,3347,241,1551,1445,2925,4732,2662,2070,136,945,900,1803
"n2010072","2010072",4588,350,4238,45,226,3999,4187,3505,319,3186,32,182,2984,3148
"n2010735","2010735",6374,2928,3446,454,755,2173,2878,4486,2235,2251,316,479,1395,1847
"n2150065","2150065",4563,275,4288,369,60,3877,3908,3234,216,3018,286,39,2703,2728
"n2610006","2610006",26,2,24,2,1,21,21,16,2,14,2,0,11,11
"n2630401","2630401",177,142,35,3,4,27,29,149,121,28,2,4,21,23
"n291057","291057",5964,1041,4923,61,129,4721,4820,4155,873,3282,37,101,3123,3207
"n1132020","1132020",3300,2373,927,212,236,442,664,2803,2056,747,157,207,353,550
"n1134660","1134660",99,29,70,5,7,57,63,70,24,46,5,6,35,41
"n1213137","1213137",4819,2101,2718,406,495,1748,2204,3662,1761,1901,309,376,1147,1503
"n1430046","1430046",1637,1056,581,32,52,450,490,1261,872,389,21,33,291,322
"n1573107","1573107",2328,1162,1166,880,93,168,255,2008,1033,975,742,76,132,205
"n4393322","4393322",2561,1948,613,128,101,327,421,2117,1676,441,109,73,214,281
"n4530433","4530433",904,463,441,46,54,314,359,803,435,368,35,45,262,302
"n4690015","4690015",173,93,80,2,7,66,71,140,82,58,0,4,50,53
"n4930206","4930206",3897,1642,2255,50,86,2086,2153,2958,1372,1586,29,67,1457,1511
"n2010835","2010835",845,33,812,2,21,796,809,570,31,539,2,14,526,536
"n2010172","2010172",1543,121,1422,18,52,1344,1385,1160,110,1050,14,27,996,1022
"n2010004","2010004",2509,1752,757,152,110,448,546,2009,1416,593,110,94,347,429
"n3390075","3390075",6728,4219,2509,514,696,1148,1801,5681,3780,1901,380,521,876,1374
"n4070005","4070005",4167,2314,1853,23,105,1581,1674,2995,1821,1174,18,83,969,1041
"n4394178","4394178",5816,3222,2594,222,955,1318,2237,4733,2828,1905,186,684,963,1624
"n1132408","1132408",5635,983,4652,408,408,3819,4186,4202,896,3306,357,331,2598,2904
"n1170003","1170003",4853,1875,2978,22,81,2843,2893,3549,1585,1964,17,54,1855,1891
"n1212114","1212114",2744,1129,1615,1058,209,311,512,2198,943,1255,831,172,220,385
"n1470011","1470011",3739,2916,823,28,141,437,569,2804,2267,537,22,82,265,347
"n1573044","1573044",6863,1140,5723,4801,565,354,894,4694,867,3827,3221,365,227,571
"n2010027","2010027",5791,1033,4758,145,341,4248,4531,4736,945,3791,109,273,3367,3607
"n4530464","4530464",5669,1844,3825,305,414,3092,3451,4442,1646,2796,241,305,2201,2476
"n467003A","467003A",1406,1045,361,17,158,153,308,1117,873,244,10,105,100,203
"n4910434","4910434",1696,1144,552,6,72,435,498,1355,951,404,1,56,323,372
"n2010689","2010689",4463,671,3792,1116,329,2377,2671,3635,594,3041,962,264,1833,2070
"n2010149","2010149",5832,2486,3346,1277,827,1155,1959,3888,1756,2132,809,530,731,1255
"n4230071","4230071",5343,4057,1286,405,432,333,757,4097,3176,921,290,313,237,545
"n4394110","4394110",2063,200,1863,15,23,1837,1850,1525,166,1359,8,17,1337,1348
"n4393385","4393385",3587,2807,780,285,79,303,373,2769,2208,561,209,66,194,254
"n4530320","4530320",5122,3813,1309,560,70,562,628,3764,2878,886,373,56,391,443
"n250013","250013",2097,719,1378,9,25,1334,1351,1586,577,1009,7,11,984,991
"n291017","291017",498,105,393,9,29,361,377,421,98,323,8,23,295,310
"n292103","292103",563,6,557,1,7,549,555,395,2,393,0,5,387,392
"n1133000","1133000",5488,3969,1519,491,308,611,895,5260,3858,1402,463,256,561,801
"n1134116","1134116",0,0,0,0,0,0,0,0,0,0,0,0,0,0
"n1270005","1270005",881,41,840,1,4,833,837,676,35,641,0,2,636,638
"n4510112","4510112",1469,991,478,15,10,435,442,1095,748,347,10,5,318,320
"n3410202","3410202",2701,1292,1409,87,43,1209,1242,1878,1033,845,53,22,701,720
"n3510014","3510014",365,147,218,0,197,8,205,303,117,186,0,168,7,175
"n3670140","3670140",1927,1608,319,22,20,201,219,1446,1239,207,15,15,115,130
"n4394048","4394048",2135,139,1996,26,123,1857,1958,1548,121,1427,12,85,1329,1403
"n4392171","4392171",4150,2694,1456,109,446,825,1226,3139,2195,944,75,251,522,765
"n4393447","4393447",0,0,0,0,0,0,0,0,0,0,0,0,0,0
"n1410203","1410203",11376,816,10560,217,482,9901,10291,7318,587,6731,141,308,6282,6553
"n1574066","1574066",8243,587,7656,1544,3136,3051,6084,6387,495,5892,1298,2356,2271,4572
"n1870213","1870213",5320,2995,2325,112,241,1867,2081,3695,2169,1526,79,156,1208,1353
"n2010295","2010295",1420,27,1393,7,1103,280,1371,1066,24,1042,6,841,190,1025
"n2010627","2010627",8559,638,7921,2401,1841,3587,5366,6338,540,5798,1872,1314,2559,3832
"n321001B","321001B",6019,2568,3451,86,870,2491,3287,4472,2153,2319,76,544,1672,2178
"n294060","294060",3713,870,2843,149,739,1974,2630,2726,777,1949,115,523,1296,1787
"n410012","410012",6816,4129,2687,200,902,1467,2319,5324,3467,1857,152,607,987,1569
"n850121","850121",4225,1144,3081,2569,211,225,427,3084,906,2178,1825,150,146,292
"n1131109","1131109",2264,139,2125,20,77,2038,2103,1462,128,1334,13,70,1257,1320
"n1213154","1213154",3803,2952,851,294,166,316,471,2814,2242,572,206,113,206,311
"n1410097","1410097",3609,472,3137,73,167,2902,3031,2795,425,2370,56,113,2190,2287
"n3730010","3730010",3576,1750,1826,36,790,970,1744,2758,1475,1283,21,564,670,1224
"n4190002","4190002",1171,973,198,2,19,159,178,889,760,129,1,10,103,113
"n4230017","4230017",2104,1725,379,23,78,163,238,1604,1349,255,16,58,99,156
"n4391625","4391625",0,0,0,0,0,0,0,0,0,0,0,0,0,0
"n4570004","4570004",1735,1526,209,12,62,52,113,1355,1207,148,9,44,34,78
"n4870001A","4870001A",3237,1840,1397,167,223,938,1136,2414,1508,906,110,135,600,731
"n1670225","1670225",3715,2920,795,87,68,551,605,3348,2697,651,74,43,439,479
"n1990006","1990006",7447,6474,973,89,93,546,627,5464,4813,651,62,52,356,403
"n2010981","2010981",105,54,51,34,3,5,8,90,47,43,33,0,4,4
"n213002M","213002M",1440,1125,315,64,65,125,188,1059,848,211,44,43,73,116
"n2450050","2450050",4559,257,4302,436,1786,2086,3832,3320,210,3110,347,1413,1333,2726
"n2870101","2870101",3596,1462,2134,24,449,1622,2034,2590,1196,1394,17,300,1030,1322
"n270310","270310",750,606,144,7,9,107,114,574,473,101,4,4,74,78
"n291063","291063",4227,734,3493,41,71,3357,3404,3002,624,2378,24,45,2268,2307
"n292149","292149",6206,1299,4907,1676,997,2260,3149,4643,1151,3492,1084,659,1729,2334
"n350010","350010",2218,1601,617,20,77,447,509,1658,1241,417,13,51,290,336
"n450001","450001",265,142,123,5,9,108,116,194,108,86,4,7,76,83
"n570002","570002",1038,441,597,32,22,537,551,773,360,413,22,14,371,380
"n2550012","2550012",1537,450,1087,61,259,709,962,1364,418,946,57,243,592,832
"n3090085","3090085",1549,548,1001,16,507,460,950,1150,463,687,15,361,292,643
"n3390069","3390069",5821,4150,1671,558,192,774,959,4340,3178,1162,373,137,538,671
"n3470047","3470047",1225,1145,80,0,6,21,27,1029,973,56,0,0,11,11
"n3630012","3630012",575,450,125,6,11,93,102,474,393,81,2,5,62,66
"n2010673","2010673",4248,2841,1407,74,77,1180,1249,3423,2421,1002,53,49,826,870
"n2030008","2030008",3899,2359,1540,85,826,565,1364,2960,1908,1052,71,576,332,904
"n2150171","2150171",40,4,36,3,2,36,36,34,1,33,0,2,33,33
"n2150088","2150088",6615,177,6438,8,34,6410,6422,4574,124,4450,6,18,4434,4438
"n2250010","2250010",386,285,101,3,52,33,82,301,240,61,3,34,17,50
"n2310434","2310434",1846,1479,367,19,42,228,266,1466,1219,247,11,28,154,179
"n710007","710007",3875,2493,1382,36,171,1090,1251,2947,2026,921,34,125,701,816
"n850012","850012",2786,2095,691,156,172,282,441,2097,1617,480,103,118,184,298
"n890302","890302",1276,1122,154,13,27,100,126,1059,950,109,11,16,71,87
"n1134066","1134066",4196,102,4094,22,87,3985,4055,2895,93,2802,19,51,2725,2774
"n1132511","1132511",2840,1571,1269,418,373,457,811,2306,1324,982,336,288,321,596
"n2010341","2010341",3733,175,3558,27,804,2750,3520,2495,151,2344,7,396,1942,2323
"n294106","294106",1591,160,1431,40,304,1116,1377,1038,133,905,32,189,690,860
"n293104","293104",3463,1896,1567,134,235,1167,1374,2819,1642,1177,92,174,863,1026
"n294143","294143",5097,923,4174,250,1574,2460,3855,3477,690,2787,151,1004,1619,2559
"n291125","291125",3469,1027,2442,208,445,1848,2214,2417,778,1639,133,294,1232,1485
"n293018","293018",2180,1566,614,60,52,473,517,1690,1235,455,40,27,358,383
"n410058","410058",1350,935,415,155,92,150,240,1276,907,369,148,76,134,210
"n3090027","3090027",2762,456,2306,48,1302,981,2215,1802,389,1413,37,747,617,1343
"n3390012","3390012",6338,2315,4023,74,113,3750,3836,4301,1761,2540,38,69,2374,2423
"n4090111","4090111",221,179,42,0,1,41,42,185,150,35,0,1,34,35
"n4391455","4391455",0,0,0,0,0,0,0,0,0,0,0,0,0,0
"n2010487","2010487",12011,545,11466,2595,2638,6158,8620,8570,448,8122,2157,1773,4127,5792
"n2150025","2150025",6485,738,5747,60,48,5649,5667,4567,694,3873,39,20,3812,3823
"n2450004","2450004",2135,1510,625,65,332,211,532,1676,1226,450,44,248,137,380
"n2730021","2730021",2790,786,2004,77,123,1798,1900,2109,656,1453,67,87,1280,1357
"n277004GA","277004GA",1165,930,235,24,30,85,113,920,773,147,20,20,40,59
"n3030063","3030063",424,203,221,1,17,200,217,294,151,143,0,10,129,139
"n850075","850075",3567,2076,1491,701,310,421,718,3025,1850,1175,558,253,321,564
"n1132040","1132040",2236,1885,351,81,38,187,216,1628,1408,220,52,22,115,131
"n1131055","1131055",2542,245,2297,50,145,2082,2224,1829,234,1595,40,100,1439,1537
"n11332C1","11332C1",0,0,0,0,0,0,0,0,0,0,0,0,0,0
"n2010818","2010818",1734,389,1345,25,481,860,1320,1325,382,943,12,356,575,923
"n2011027","2011027",1065,410,655,20,173,452,609,713,307,406,18,117,252,368
"n10023","10023",1689,1461,228,5,68,98,166,1395,1236,159,4,45,67,112
"n293162","293162",4881,1966,2915,417,406,2052,2416,4217,1816,2401,326,336,1698,2013
"n510410","510410",2590,1900,690,25,216,327,538,2198,1682,516,17,154,240,391
"n530006","530006",717,624,93,8,10,61,70,603,537,66,6,8,38,46
"n770011","770011",1206,1042,164,8,5,111,115,976,864,112,4,3,68,71
"n1134021","1134021",4129,1738,2391,263,548,1538,2048,3683,1687,1996,233,476,1236,1682
"n4710405","4710405",142,93,49,3,15,25,40,114,75,39,3,11,19,30
"n4910411","4910411",5233,2477,2756,61,146,2492,2600,3755,2034,1721,40,92,1525,1605
"n3010001","3010001",28,23,5,1,1,1,1,17,15,2,0,0,0,0
"n3610005","3610005",2354,984,1370,26,1133,182,1310,1855,833,1022,22,840,134,970
"n4010213","4010213",2830,1996,834,20,363,352,708,2185,1625,560,13,264,203,465
"n4370011","4370011",500,250,250,9,24,211,233,392,216,176,6,18,146,163
"n4391010","4391010",1424,271,1153,19,423,704,1109,1087,242,845,12,337,478,805
"n4530384","4530384",5701,2991,2710,1994,144,487,606,4245,2403,1842,1333,110,333,422
"n1211008","1211008",5846,3598,2248,53,274,1673,1926,4464,2972,1492,39,167,1098,1258
"n2010381","2010381",7710,399,7311,160,1375,5876,7130,5005,312,4693,129,947,3642,4542
"n2010132","2010132",2885,37,2848,16,2320,543,2821,2234,31,2203,11,1881,330,2185
"n2150125","2150125",2841,85,2756,16,21,2729,2740,1953,69,1884,15,10,1867,1871
"n227034A","227034A",49,38,11,0,2,8,10,34,27,7,0,0,6,6
"n227208C","227208C",225,162,63,2,4,51,55,156,121,35,1,1,27,28
"n150412","150412",908,509,399,12,161,213,369,721,426,295,7,128,146,271
"n150206","150206",1613,1362,251,5,45,136,180,1304,1121,183,4,32,93,125
"n293058","293058",6314,2109,4205,686,519,3010,3451,5554,1913,3641,544,452,2625,3016
"n293064","293064",564,268,296,16,15,266,273,444,229,215,13,5,193,197
"n610043","610043",2729,195,2534,13,15,2497,2503,1917,144,1773,13,7,1744,1750
"n1030004","1030004",1190,292,898,8,21,858,876,833,233,600,6,14,568,582
"n4393212","4393212",3742,1945,1797,226,941,522,1403,3010,1741,1269,176,610,377,955
"n4530254","4530254",6575,2704,3871,1220,658,1963,2547,5409,2350,3059,994,525,1483,1965
"n5010406","5010406",1112,282,830,19,18,785,801,786,230,556,16,12,522,533
"n3030154","3030154",6161,3599,2562,408,309,1750,2026,4200,2642,1558,278,175,1018,1185
"n3050004","3050004",1317,974,343,4,13,311,320,887,668,219,2,3,202,204
"n3550045","3550045",1275,104,1171,4,60,1115,1160,972,88,884,4,36,845,876
"n3550039","3550039",1257,403,854,28,57,767,820,1063,374,689,24,47,614,659
"n4394242","4394242",1017,711,306,30,62,181,241,845,624,221,27,45,119,164
"n4391301","4391301",3587,340,3247,60,1729,1460,3164,2587,293,2294,49,1316,915,2222
"n1132105","1132105",3031,1756,1275,281,495,478,941,2850,1678,1172,264,444,429,855
"n1572059","1572059",3216,131,3085,59,2340,732,3017,2522,114,2408,38,1875,509,2353
"n1571038","1571038",12075,4262,7813,3546,1079,3045,4043,8055,3030,5025,2243,714,1983,2641
"n2011067","2011067",3717,529,3188,375,1888,907,2747,2753,468,2285,313,1259,678,1910
"n2010772","2010772",6199,4100,2099,934,291,779,1032,4681,3202,1479,665,212,520,710
"n2190014","2190014",1178,759,419,3,17,375,385,896,585,311,3,11,277,287
"n294003","294003",3002,236,2766,44,521,2268,2705,2216,183,2033,26,396,1628,1994
"n350004","350004",638,470,168,3,28,106,132,527,418,109,2,14,71,84
"n910101","910101",5422,3955,1467,82,134,1135,1247,4374,3341,1033,64,84,788,869
"n1131326","1131326",2438,913,1525,161,393,940,1317,1831,752,1079,137,271,635,904
"n1211054","1211054",4555,2543,2012,148,890,849,1699,3013,1753,1260,97,559,513,1054
"n1211051","1211051",916,434,482,57,258,159,410,668,352,316,35,165,103,266
"n4430001","4430001",186,70,116,3,7,104,110,155,67,88,1,3,79,82
"n4770418","4770418",874,515,359,12,135,199,330,686,438,248,8,92,141,233
"n4910312","4910312",1193,900,293,19,35,226,252,1002,789,213,17,13,163,175
"n2570003","2570003",3861,2439,1422,99,473,747,1203,2878,1893,985,68,339,486,819
"n2930203","2930203",186,88,98,3,72,24,93,145,69,76,2,64,9,72
"n3630018","3630018",273,236,37,2,1,23,24,210,179,31,2,1,17,18
"n3950023","3950023",1396,384,1012,8,285,729,988,1009,311,698,6,182,501,676
"n4392318","4392318",2720,1605,1115,97,380,604,956,2208,1388,820,79,271,426,682
"n4393654","4393654",0,0,0,0,0,0,0,0,0,0,0,0,0,0
"n1350207","1350207",2996,1907,1089,29,70,927,979,2236,1552,684,17,34,570,603
"n1850009","1850009",414,282,132,5,63,53,107,313,213,100,5,50,33,78
"n2010921","2010921",417,219,198,18,30,138,166,321,192,129,11,22,84,106
"n2010089","2010089",1818,1217,601,293,86,200,279,1405,946,459,216,72,149,218
"n2010086","2010086",5906,3402,2504,680,444,1304,1711,5074,3003,2071,545,375,1060,1411
"n2030002","2030002",4487,1318,3169,27,2047,1064,3064,3461,1193,2268,17,1529,674,2181
"n291120","291120",409,18,391,7,48,350,381,255,12,243,4,24,222,240
"n1132102","1132102",6088,4361,1727,572,318,713,1010,5865,4241,1624,541,293,665,939
"n1131061","1131061",1690,1214,476,45,84,293,365,1438,1074,364,34,60,222,274
"n1134536","1134536",113,22,91,18,11,55,64,92,22,70,15,8,40,46
"n1133307","1133307",5504,1114,4390,82,1403,2881,4230,3695,935,2760,66,821,1823,2631
"n1214199","1214199",67,64,3,0,1,2,3,54,53,1,0,1,0,1
"n4392742","4392742",1127,178,949,309,165,457,618,875,166,709,251,129,312,438
"n4530192","4530192",4913,1925,2988,508,873,1609,2406,3702,1576,2126,390,587,1117,1663
"n4630007","4630007",772,358,414,7,5,389,392,592,311,281,0,2,266,268
"n4850101","4850101",388,336,52,6,6,27,31,294,263,31,3,3,11,14
"n2010775","2010775",4643,2651,1992,590,324,1022,1330,4166,2485,1681,469,279,867,1135
"n2010481","2010481",6990,3654,3336,425,934,1804,2692,5288,2974,2314,315,612,1256,1850
"n3390018","3390018",6083,3546,2537,84,301,2028,2310,4393,2784,1609,49,202,1251,1452
"n3790203","3790203",2072,1870,202,7,15,134,147,1656,1518,138,6,7,84,91
"n4394485","4394485",1686,276,1410,57,23,1304,1324,1125,240,885,37,15,809,824
"n4391473","4391473",382,73,309,7,6,293,298,260,59,201,6,4,189,192
"n1410057","1410057",3620,566,3054,99,273,2692,2891,2783,510,2273,90,197,1964,2124
"n1572070","1572070",3355,597,2758,468,1097,1164,2236,2643,540,2103,403,802,855,1645
"n1571013","1571013",5519,1488,4031,118,771,3161,3858,4035,1278,2757,99,490,2152,2615
"n1670434","1670434",2594,497,2097,13,1504,579,2050,1840,389,1451,5,1073,352,1413
"n1890306","1890306",214,42,172,7,18,142,160,142,36,106,3,17,82,99
"n2010235","2010235",5623,283,5340,117,4330,945,5208,4535,259,4276,105,3529,666,4154
"n293165","293165",5752,2696,3056,629,352,2031,2324,4152,2049,2103,442,229,1378,1583
"n291023","291023",4531,119,4412,16,53,4333,4363,3381,96,3285,8,26,3231,3248
"n293001","293001",6129,2671,3458,569,490,2388,2804,4943,2335,2608,392,385,1794,2127
"n37008A","37008A",1267,485,782,10,573,176,746,955,369,586,8,454,109,562
"n410078","410078",416,214,202,0,21,168,188,297,168,129,0,7,110,117
"n850138","850138",2654,1758,896,286,217,332,543,2202,1514,688,229,161,249,408
"n4790274","4790274",4789,109,4680,30,16,4639,4641,3009,73,2936,29,16,2900,2902
"n4910209","4910209",5252,4002,1250,154,163,770,894,3679,2930,749,93,95,451,528
"n2150128","2150128",4932,84,4848,11,12,4818,4822,3448,55,3393,11,10,3370,3374
"n2210216","2210216",3487,3167,320,47,28,166,194,3104,2850,254,34,18,132,150
"n2750302","2750302",68,53,15,0,4,11,13,65,53,12,0,2,8,10
"n3290403","3290403",5011,3372,1639,179,188,1155,1324,3622,2571,1051,129,117,711,818
"n4530386A","4530386A",4163,1910,2253,1632,88,461,537,2943,1465,1478,1094,61,270,329
"n4530171","4530171",5747,2231,3516,688,1212,1553,2702,4471,1893,2578,522,874,1103,1941
"n1134110","1134110",2095,17,2078,12,679,1408,2067,1499,11,1488,9,577,914,1478
"n1132076","1132076",12,7,5,1,5,0,5,11,6,5,1,5,0,5
"n2010964","2010964",4162,1236,2926,276,1487,1192,2630,2901,938,1963,189,1011,759,1755
"n2011130","2011130",1628,253,1375,176,188,1016,1194,1189,216,973,134,147,694,834
"n2010467","2010467",2776,123,2653,382,769,1526,2270,2093,102,1991,335,602,1059,1652
"n2010633","2010633",5486,2996,2490,629,670,1069,1718,4218,2448,1770,485,483,707,1179
"n270419","270419",1594,1048,546,49,173,288,433,1216,858,358,32,112,175,269
"n294103","294103",13,6,7,1,0,5,5,10,4,6,1,0,4,4
"n293142","293142",1254,410,844,121,162,573,716,1080,372,708,94,129,495,608
"n410055","410055",6453,3204,3249,713,969,1445,2375,5234,2750,2484,592,660,1118,1763
"n590008","590008",1875,1540,335,7,62,210,262,1404,1189,215,4,29,133,161
"n850115","850115",3993,2563,1430,514,382,464,837,3294,2182,1112,414,289,347,632
"n4530363","4530363",4941,2857,2084,1314,178,525,692,3295,1998,1297,822,112,313,418
"n4910163","4910163",6119,1933,4186,814,1362,2003,3242,4327,1589,2738,545,844,1303,2092
"n4970005","4970005",3119,2279,840,16,40,638,672,2330,1790,540,8,25,397,419
"n3550082","3550082",1253,165,1088,17,69,992,1056,1001,148,853,14,58,773,829
"n3670310","3670310",3201,2489,712,56,130,452,573,2634,2110,524,47,108,303,404
"n4170303","4170303",426,374,52,2,7,36,40,334,305,29,1,3,19,20
"n4230023","4230023",3636,2095,1541,91,620,783,1374,2843,1770,1073,69,412,545,951
"n4391184","4391184",2522,837,1685,77,453,1159,1575,1839,735,1104,54,312,727,1020
"n4393732","4393732",2691,2027,664,79,62,458,504,2035,1607,428,49,30,278,306
"n910204","910204",5032,3292,1740,99,84,1458,1526,4006,2733,1273,66,58,1050,1098
"n2010987","2010987",2036,68,1968,20,784,1179,1947,1501,48,1453,15,631,813,1433
"n2150151","2150151",5222,631,4591,263,81,4257,4312,3945,532,3413,181,58,3155,3203
"n2510042","2510042",5951,2676,3275,62,529,2539,3026,4187,2093,2094,21,355,1574,1916
"n3090066","3090066",1980,1603,377,7,47,236,275,1563,1324,239,3,27,151,176
"n3310318","3310318",3828,2408,1420,33,325,1015,1295,2912,1977,935,22,211,646,838
"n50031","50031",705,379,326,2,31,287,315,515,288,227,2,23,195,218
"n294080","294080",4549,835,3714,94,888,2778,3579,3303,713,2590,72,599,1896,2476
"n1133040","1133040",3943,128,3815,18,2451,1355,3768,2639,102,2537,11,1635,881,2502
"n1134517","1134517",5155,2222,2933,206,933,1699,2580,4193,2028,2165,157,705,1189,1872
"n1131329","1131329",24,11,13,0,4,10,13,19,11,8,0,2,7,8
"n1214215","1214215",4497,3048,1449,497,320,502,800,3041,2145,896,318,192,297,483
"n4910491","4910491",6210,3036,3174,449,865,1735,2548,4470,2299,2171,333,581,1139,1698
"n3090088","3090088",1477,571,906,5,279,598,863,1046,440,606,4,191,394,578
"n3490104","3490104",1441,765,676,5,67,568,628,1066,614,452,0,47,370,416
"n3970003","3970003",2625,1533,1092,166,381,520,872,1762,1080,682,114,204,314,518
"n4210202","4210202",202,137,65,3,4,55,59,142,99,43,3,4,33,37
"n4391105","4391105",2007,1202,805,77,320,395,699,1691,1086,605,56,245,282,517
"n4394534","4394534",6959,3976,2983,241,779,1806,2521,5155,3098,2057,189,531,1206,1701
"n1410163","1410163",4951,106,4845,22,30,4798,4817,3812,71,3741,11,18,3712,3723
"n1610006B","1610006B",31,24,7,0,1,6,7,28,22,6,0,1,5,6
"n1870415","1870415",8057,3499,4558,457,1293,2790,3926,5538,2571,2967,292,820,1760,2525
"n2010255","2010255",3557,1951,1606,304,643,590,1212,2863,1606,1257,225,528,436,951
"n2090316","2090316",3545,1789,1756,112,176,1460,1611,2909,1608,1301,86,143,1054,1190
"n2450030","2450030",1661,1402,259,17,53,138,189,1284,1111,173,10,30,88,118
"n90007","90007",292,239,53,4,1,26,27,224,194,30,1,1,15,16
"n292001","292001",2369,188,2181,57,191,1982,2123,1451,139,1312,32,103,1191,1273
"n292123","292123",3195,1024,2171,170,201,1816,1973,2253,777,1476,118,122,1219,1328
"n37001A","37001A",3155,376,2779,15,2294,449,2719,2172,306,1866,11,1537,286,1812
"n390013","390013",6515,2896,3619,519,1078,1950,2991,4704,2190,2514,382,772,1297,2050
"n1134147","1134147",113,4,109,3,5,99,104,80,2,78,2,4,69,73
"n4530137","4530137",5604,1514,4090,476,789,2847,3561,4325,1353,2972,383,601,1996,2552
"n4630001","4630001",1857,429,1428,6,26,1403,1411,1373,379,994,5,12,977,983
"n3030022","3030022",4598,2358,2240,78,399,1689,2023,3409,1982,1427,54,243,1046,1266
"n3490402","3490402",3466,2092,1374,41,524,690,1192,2739,1799,940,32,361,455,805
"n391003A","391003A",918,463,455,2,68,389,441,718,401,317,1,47,266,309
"n4394456","4394456",1467,1139,328,41,84,165,247,1178,938,240,29,54,120,173
"n4392027","4392027",1507,325,1182,188,260,731,977,1051,272,779,148,165,466,627
"n4392546","4392546",417,52,365,11,199,165,352,338,52,286,10,165,119,274
"n1131176","1131176",0,0,0,0,0,0,0,0,0,0,0,0,0,0
"n1214193","1214193",6709,4916,1793,107,234,1244,1442,4790,3742,1048,71,126,700,812
"n1650002","1650002",4359,2646,1713,38,55,1563,1602,2876,1735,1141,23,31,1036,1063
"n2010610","2010610",9688,941,8747,257,315,8173,8435,6596,789,5807,199,201,5385,5557
"n2090422","2090422",3045,1578,1467,82,166,1189,1321,2392,1316,1076,58,124,845,953
"n2170012","2170012",2628,1862,766,12,340,319,655,1975,1459,516,9,245,181,426
"n292024","292024",4262,299,3963,46,194,3760,3898,2986,254,2732,42,116,2587,2677
"n610026","610026",3334,531,2803,20,28,2751,2761,2502,492,2010,15,13,1973,1978
"n930004","930004",134,108,26,0,1,21,22,102,94,8,0,0,6,6
"n1131142","1131142",4745,3248,1497,264,385,797,1159,3087,2163,924,151,242,493,724
"n1133500","1133500",5132,2401,2731,1606,460,558,1000,3690,1766,1924,1160,307,378,680
"n4490001","4490001",1489,141,1348,13,404,925,1318,1025,104,921,8,328,576,899
"n4910149","4910149",5588,2374,3214,367,1199,1650,2752,4352,2025,2327,289,819,1201,1960
"n2010107","2010107",5752,267,5485,45,1271,4202,5429,4026,229,3797,34,829,2934,3748
"n2010022","2010022",5700,405,5295,157,3307,1847,5084,4033,344,3689,130,2302,1256,3518
"n2011102","2011102",6081,2299,3782,494,1004,2258,3164,4546,1819,2727,356,700,1615,2265
"n2010853","2010853",3478,2163,1315,294,325,621,924,2624,1710,914,219,219,407,612
"n3650005","3650005",741,553,188,4,69,92,158,546,422,124,2,53,51,104
"n397003AA","397003AA",4734,3177,1557,127,201,1078,1265,3383,2387,996,88,135,663,791
"n294118","294118",117,58,59,2,6,50,55,90,47,43,2,5,35,39
"n291052","291052",3632,371,3261,34,65,3170,3200,2641,317,2324,28,34,2250,2276
"n291101","291101",1,0,1,1,0,1,1,1,0,1,1,0,1,1
"n291137","291137",0,0,0,0,0,0,0,0,0,0,0,0,0,0
"n550301","550301",2001,842,1159,10,49,1053,1089,1527,716,811,6,36,730,756
"n910308","910308",3938,2312,1626,43,78,1436,1505,3252,2007,1245,35,65,1084,1143
"n4391382","4391382",5902,1235,4667,358,3324,1035,4249,4698,1093,3605,280,2577,753,3268
"n4550002","4550002",1205,1052,153,7,21,72,92,1029,909,120,4,11,53,64
"n4590002","4590002",4114,3437,677,27,124,319,439,3080,2654,426,21,74,171,243
"n4970020","4970020",1775,1487,288,7,23,181,201,1351,1170,181,6,13,104,117
"n2010462","2010462",4283,1138,3145,476,1077,1575,2610,3479,1025,2454,421,898,1113,1981
"n2010499","2010499",3137,2184,953,338,147,415,544,2566,1801,765,286,114,328,432
"n2650404","2650404",1213,1005,208,7,11,158,168,989,842,147,6,2,114,116
"n2730044","2730044",1008,206,802,27,45,732,773,810,175,635,20,35,578,612
"n3690301","3690301",2353,1314,1039,6,16,1009,1018,1750,1050,700,5,12,674,683
"n4391241","4391241",1282,257,1025,199,570,248,803,849,202,647,118,350,161,508
"n990102","990102",2053,1689,364,18,42,213,250,1624,1384,240,13,16,145,157
"n1110002","1110002",119,77,42,1,1,35,35,79,56,23,0,0,20,20
"n1213132","1213132",4717,2320,2397,568,770,971,1723,3751,1926,1825,437,583,729,1303
"n149201E","149201E",2015,1315,700,16,192,453,638,1544,1081,463,13,123,294,412
"n1571146","1571146",13078,4847,8231,4104,1231,2741,3892,8191,3130,5061,2499,737,1705,2409
"n2011039","2011039",0,0,0,0,0,0,0,0,0,0,0,0,0,0
"n293180","293180",1546,727,819,60,83,672,739,1290,642,648,47,54,529,578
"n294224","294224",0,0,0,0,0,0,0,0,0,0,0,0,0,0
"n292124","292124",838,275,563,42,52,468,506,685,243,442,38,32,369,396
"n410092","410092",0,0,0,0,0,0,0,0,0,0,0,0,0,0
"n1134041","1134041",1369,30,1339,6,354,981,1327,1014,28,986,4,317,666,978
"n1211026","1211026",4927,4368,559,155,129,187,306,4831,4348,483,141,105,157,256
"n3450003","3450003",24,19,5,0,1,5,5,21,17,4,0,0,4,4
"n3610023","3610023",4223,3684,539,77,44,285,317,3028,2688,340,58,24,159,178
"n3910003","3910003",762,367,395,3,46,342,379,596,315,281,1,36,241,272
"n4230055","4230055",4026,1728,2298,238,1434,533,1946,3275,1515,1760,181,1107,396,1493
"n4730418","4730418",4471,2774,1697,253,458,932,1346,2945,1876,1069,156,279,577,838
"n4910258","4910258",278,133,145,44,24,55,78,184,87,97,28,15,37,51
"n1310008","1310008",2526,328,2198,30,27,2070,2082,1817,272,1545,24,16,1442,1448
"n1410135","1410135",4088,116,3972,27,37,3914,3940,3174,84,3090,22,16,3058,3067
"n2010896","2010896",2440,1612,828,276,186,341,513,2269,1531,738,248,166,297,456
"n2010648","2010648",4841,2550,2291,676,668,884,1520,3726,2081,1645,514,475,606,1055
"n2011145","2011145",6339,3434,2905,664,316,1787,2087,4207,2410,1797,410,192,1091,1282
"n2150060","2150060",8272,333,7939,38,17,7846,7857,5506,262,5244,24,12,5175,5181
"n293033","293033",3184,1718,1466,215,157,1046,1187,2653,1558,1095,161,119,778,885
"n390065","390065",4235,2158,2077,184,673,1158,1791,3244,1804,1440,128,477,767,1227
"n390022","390022",5193,3635,1558,135,233,1082,1283,4018,2951,1067,90,162,714,862
"n850047","850047",3658,1861,1797,309,381,1056,1411,2974,1639,1335,236,291,759,1029
"n1134506","1134506",3509,662,2847,105,388,2339,2669,2579,593,1986,73,254,1605,1839
"n1391045","1391045",188,153,35,5,3,26,29,146,122,24,5,0,18,18
"n4790416","4790416",2310,58,2252,2,14,2240,2244,1636,42,1594,2,10,1586,1589
"n4790453","4790453",1131,22,1109,0,1,1108,1108,827,14,813,0,1,812,812
"n2090252","2090252",4740,1476,3264,159,348,2739,3032,3443,1156,2287,111,262,1867,2101
"n2410001","2410001",66,54,12,1,5,0,5,54,47,7,1,1,0,1
"n3550020","3550020",5480,752,4728,143,348,4268,4536,4048,616,3432,108,238,3056,3276
"n3550014","3550014",695,185,510,12,18,471,486,461,146,315,8,12,290,299
"n4110001","4110001",1402,801,601,8,11,564,570,1100,680,420,8,10,389,394
"n411004B","411004B",164,155,9,0,2,7,7,143,134,9,0,2,7,7
"n1410029","1410029",4771,677,4094,159,195,3770,3933,3885,600,3285,136,159,3005,3142
"n1670143","1670143",5323,1599,3724,42,1186,2488,3575,3752,1266,2486,32,741,1667,2367
"n2010747","2010747",6080,1474,4606,241,1965,2371,4257,4317,1218,3099,175,1317,1556,2836
"n2010753","2010753",813,174,639,54,347,264,582,578,136,442,32,240,184,407
"n2090450A","2090450A",1580,1259,321,42,26,207,232,1189,963,226,26,21,139,159
"n2090443","2090443",3830,2829,1001,275,98,569,654,2464,1865,599,174,61,321,377
"n270410","270410",8598,1933,6665,323,3331,3090,6110,6391,1667,4724,247,2367,2093,4282
"n292081","292081",1437,175,1262,47,104,1106,1203,1105,165,940,31,73,818,889
"n490215","490215",304,275,29,0,10,9,19,269,244,25,0,8,8,16
"n730024","730024",3443,2176,1267,39,779,388,1155,2631,1702,929,36,581,265,841
"n1132608","1132608",4400,1759,2641,1686,359,517,863,3450,1478,1972,1282,269,356,618
"n1133981","1133981",2254,1382,872,280,182,343,515,1820,1176,644,200,135,243,373
"n3150004","3150004",555,369,186,3,164,9,171,446,311,135,0,123,4,127
"n3390086","3390086",4048,2752,1296,71,251,855,1098,3087,2194,893,59,171,572,736
"n4310002A","4310002A",249,118,131,9,3,122,124,183,88,95,3,1,90,91
"n4391821","4391821",0,0,0,0,0,0,0,0,0,0,0,0,0,0
"n4530357","4530357",4935,2931,2004,385,216,1319,1503,3942,2451,1491,299,182,942,1102
"n4690030","4690030",820,313,507,10,52,434,479,631,261,370,6,34,318,349
"n1410178","1410178",1975,269,1706,28,105,1599,1671,1478,243,1235,18,77,1146,1207
"n1573138","1573138",750,65,685,393,202,86,279,573,48,525,303,152,58,208
"n2010605","2010605",4077,384,3693,48,1000,2673,3620,2915,330,2585,40,754,1817,2531
"n2010356","2010356",6761,2668,4093,531,1386,2162,3459,5133,2180,2953,443,973,1507,2429
"n2150103","2150103",4912,580,4332,60,34,4236,4262,3755,519,3236,44,21,3164,3179
"n2270025","2270025",1727,1016,711,52,61,544,595,1281,822,459,39,40,338,373
"n294075","294075",1037,109,928,20,72,844,899,791,90,701,10,53,640,681
"n291095","291095",881,460,421,69,162,193,323,637,343,294,54,109,119,211
"n610015","610015",3389,258,3131,19,19,3093,3099,2606,214,2392,19,18,2357,2363
"n97001C","97001C",7301,4283,3018,145,518,2161,2618,5341,3478,1863,106,318,1285,1584
"n1133072","1133072",170,8,162,1,71,92,158,120,8,112,1,53,62,110
"n1213126","1213126",4820,1707,3113,577,1324,1171,2444,3731,1466,2265,452,952,803,1730
"n4910486","4910486",1756,840,916,388,173,361,516,1360,747,613,265,121,220,332
"n4970028","4970028",3282,1897,1385,41,46,1190,1234,2304,1446,858,27,25,728,753
"n3290308","3290308",6056,1047,5009,90,1476,3463,4869,4455,818,3637,75,1130,2425,3531
"n3670440","3670440",5368,4580,788,79,102,443,537,3720,3237,483,39,61,266,323
"n4394130","4394130",3068,2595,473,132,94,187,271,2286,1977,309,89,66,117,180
"n4391208","4391208",2649,2038,611,118,127,280,396,2055,1638,417,87,96,176,267
"n4530482","4530482",4671,1071,3600,30,774,2796,3547,3977,1017,2960,17,752,2184,2919
"n4590008","4590008",1441,1100,341,2,135,169,297,1116,867,249,1,107,108,211
"n1490315","1490315",736,597,139,1,9,117,126,618,523,95,0,9,75,84
"n1870409","1870409",4184,1491,2693,343,1180,1237,2317,2869,1089,1780,234,797,753,1513
"n2010456","2010456",9852,3071,6781,309,2479,3984,6321,7281,2584,4697,252,1743,2639,4316
"n2010996","2010996",1080,371,709,85,158,468,621,831,317,514,58,126,331,456
"n2150203","2150203",8173,698,7475,525,165,6806,6931,5629,500,5129,383,98,4647,4734
"n2650215","2650215",4513,3066,1447,70,42,1202,1237,3612,2608,1004,46,30,814,841
"n293108","293108",1889,1096,793,64,124,590,694,1506,916,590,40,92,432,514
"n310302","310302",1796,1425,371,20,8,275,279,1468,1176,292,19,5,215,219
"n550111","550111",3188,1410,1778,29,412,1337,1724,2648,1277,1371,17,333,1001,1326
"n850079","850079",6200,2200,4000,1629,985,1371,2284,5151,1865,3286,1477,784,984,1729
"n1134046","1134046",3118,36,3082,13,554,2520,3059,2131,30,2101,11,458,1632,2085
"n1131059","1131059",2455,1409,1046,44,123,802,919,1936,1176,760,35,96,564,657
"n4910468","4910468",1719,752,967,132,381,439,794,1433,660,773,111,300,346,630
"n2310213","2310213",1519,1186,333,10,26,233,257,1131,909,222,6,17,143,159
"n2630301","2630301",88,71,17,1,3,15,16,66,54,12,1,3,10,11
"n3050002","3050002",797,429,368,5,9,330,336,603,334,269,1,3,245,248
"n3390051","3390051",6783,2305,4478,154,1444,2844,4203,4984,1937,3047,121,932,1934,2835
"n4530324","4530324",3810,2851,959,219,64,561,612,2754,2161,593,128,37,340,370
"n475004M","475004M",420,226,194,4,14,161,170,298,173,125,2,4,106,109
"n1132406","1132406",5804,2323,3481,765,1289,1340,2578,4867,2127,2740,642,999,1002,1969
"n1212112","1212112",2520,1186,1334,609,260,419,663,2028,1017,1011,478,184,302,481
"n2010408","2010408",4498,303,4195,77,48,4064,4091,3112,265,2847,61,36,2740,2763
"n2011071","2011071",6026,1497,4529,98,1731,2687,4304,4243,1222,3021,71,1094,1800,2847
"n2010739","2010739",5706,1195,4511,89,1720,2715,4335,4101,979,3122,83,1175,1861,2973
"n2150069","2150069",18067,797,17270,18,604,16644,17184,12303,675,11628,13,575,11049,11581
"n570006","570006",719,225,494,10,21,457,476,560,190,370,10,18,337,354
"n850102","850102",2942,2352,590,149,114,223,331,2314,1900,414,107,75,143,217
"n1134070","1134070",3376,215,3161,12,141,3014,3141,2537,180,2357,9,105,2245,2343
"n1131090","1131090",5681,357,5324,28,1133,4151,5250,4024,328,3696,21,859,2791,3637
"n1132515","1132515",1113,700,413,71,82,242,319,888,581,307,61,58,169,224
"n1213135","1213135",10410,3373,7037,1423,1246,4283,5445,7652,2818,4834,959,885,2884,3737
"n2011048","2011048",1086,451,635,238,194,206,391,766,318,448,174,141,138,274
"n2150046","2150046",791,38,753,3,6,737,740,537,37,500,2,3,491,491
"n2270409","2270409",877,603,274,5,10,228,235,649,470,179,5,2,143,145
"n2591110","2591110",2959,2142,817,48,26,681,701,2371,1808,563,39,16,453,466
"n4930313","4930313",5577,3486,2091,61,133,1760,1874,4148,2727,1421,45,78,1173,1247
"n1410078","1410078",1879,92,1787,22,17,1747,1756,1609,84,1525,19,16,1487,1496
"n1573102","1573102",3467,596,2871,2602,116,135,251,2691,480,2211,1993,84,114,198
"n1690005","1690005",166,129,37,2,0,33,33,131,104,27,2,0,23,23
"n2010716","2010716",4556,2582,1974,85,295,1495,1769,3433,2058,1375,67,198,1004,1195
"n2010385","2010385",2696,2020,676,337,57,246,297,2137,1654,483,234,37,176,209
"n2010053","2010053",3100,1801,1299,310,252,703,941,2731,1610,1121,267,220,609,820
"n213020","213020",10083,1594,8489,57,264,8093,8318,6833,1335,5498,41,194,5191,5364
"n292084","292084",4320,1954,2366,171,242,1941,2145,3483,1696,1787,121,163,1449,1601
"n1134094","1134094",930,175,755,29,65,648,705,724,156,568,27,48,479,524
"n1131114","1131114",2242,95,2147,53,1096,991,2071,1628,95,1533,34,866,620,1479
"n1132802","1132802",6820,3377,3443,1812,243,1272,1488,4930,2645,2285,1240,151,794,939
"n1213158","1213158",4759,3331,1428,279,294,731,999,3823,2797,1026,218,200,498,685
"n4710101","4710101",2534,858,1676,24,931,722,1636,2235,797,1438,23,804,610,1402
"n4910367","4910367",203,80,123,25,11,85,95,159,60,99,18,9,67,76
"n3550049","3550049",1864,733,1131,16,68,1028,1078,1422,628,794,10,46,713,751
"n3850003","3850003",680,415,265,7,12,232,241,555,361,194,3,6,168,172
"n4330003","4330003",296,239,57,1,9,46,52,252,213,39,1,7,32,36
"n4394250","4394250",7477,3369,4108,656,1708,1639,3241,5942,2962,2980,499,1207,1141,2312
"n4392413","4392413",1380,166,1214,141,466,609,1056,992,127,865,103,338,420,744
"n4530252","4530252",5523,659,4864,584,702,3571,4235,3812,579,3233,479,502,2238,2723
"n2011025","2011025",1343,438,905,125,371,415,769,904,315,589,82,256,249,497
"n2010193","2010193",1532,177,1355,38,1084,254,1305,1248,155,1093,32,866,205,1050
"n2010031","2010031",5059,111,4948,42,4350,646,4878,3460,94,3366,33,2988,392,3316
"n2010693","2010693",1343,237,1106,67,540,518,1036,1012,206,806,46,403,363,751
"n2010362","2010362",8134,4532,3602,682,598,2191,2727,6071,3576,2495,496,397,1473,1831
"n2150023","2150023",4324,553,3771,10,29,3728,3738,3056,517,2539,5,15,2512,2518
"n1370001","1370001",353,88,265,3,1,255,256,286,79,207,2,1,199,200
"n1410101","1410101",3575,486,3089,54,155,2898,3021,2838,428,2410,44,117,2256,2356
"n1470016","1470016",444,398,46,8,10,10,20,352,325,27,4,5,3,8
"n1573158","1573158",4096,502,3594,3187,173,233,399,2899,371,2528,2245,119,159,277
"n1670439","1670439",5612,3350,2262,157,539,1466,1969,4273,2774,1499,108,356,937,1278
"n1870123","1870123",4,0,4,0,1,3,3,3,0,3,0,1,2,2
"n1134120","1134120",5397,102,5295,30,176,5080,5226,3766,88,3678,19,141,3516,3635
"n1134664","1134664",2456,695,1761,493,311,931,1226,2071,597,1474,408,245,801,1039
"n1133201","1133201",2721,825,1896,50,724,1094,1785,2108,759,1349,38,542,723,1250
"n1214180","1214180",1790,1188,602,193,170,208,366,1405,977,428,146,123,129,245
"n1350302","1350302",2096,597,1499,20,106,1360,1451,1498,502,996,12,52,908,958
"n1410124","1410124",6219,378,5841,83,155,5640,5751,4588,285,4303,45,104,4156,4236
"n4394371","4394371",3321,2624,697,122,85,362,438,2582,2111,471,90,43,238,277
"n4530290","4530290",5848,4606,1242,614,61,464,516,4226,3449,777,387,37,273,307
"n4730104","4730104",1430,572,858,14,168,661,820,1020,462,558,7,132,402,530
"n4910409","4910409",520,347,173,4,12,156,164,415,290,125,4,4,113,117
"n2010008","2010008",2960,1327,1633,137,259,1195,1427,2349,1141,1208,97,191,875,1053
"n2010879","2010879",5957,1324,4633,758,1105,2791,3813,4308,1018,3290,586,723,1969,2647
"n2010548","2010548",5225,1087,4138,403,1173,2534,3649,3894,952,2942,325,835,1727,2533
"n2010671","2010671",5588,1831,3757,664,941,2109,2998,4351,1573,2778,542,672,1508,2148
"n2090103","2090103",0,0,0,0,0,0,0,0,0,0,0,0,0,0
"n4392506","4392506",6832,4141,2691,218,1087,1221,2269,5262,3422,1840,142,741,808,1537
"n1450103","1450103",925,714,211,5,54,119,173,762,609,153,2,38,84,122
"n1574073A","1574073A",2586,820,1766,41,382,1364,1712,1909,741,1168,27,244,899,1134
"n1670371","1670371",4599,2470,2129,552,549,880,1404,3616,2003,1613,439,419,628,1032
"n1870217","1870217",342,86,256,0,23,226,249,253,77,176,0,19,150,169
"n2010339","2010339",4260,344,3916,57,427,3451,3834,3197,298,2899,42,269,2584,2836
"n2010216","2010216",3892,109,3783,32,1317,2449,3729,2874,94,2780,20,1052,1710,2743
"n270207","270207",6975,1871,5104,537,2845,1830,4418,5516,1658,3858,453,2053,1357,3279
"n294064","294064",3831,1071,2760,118,574,2104,2605,2938,935,2003,93,415,1500,1882
"n670018","670018",759,681,78,4,37,19,54,586,523,63,3,29,16,43
"n850248","850248",3598,1542,2056,1156,502,350,835,2559,1171,1388,775,341,226,560
"n11330T6","11330T6",0,0,0,0,0,0,0,0,0,0,0,0,0,0
"n1330005","1330005",1160,718,442,4,12,394,401,879,562,317,2,6,283,288
"n2910022","2910022",7270,2809,4461,89,509,3733,4214,5131,2175,2956,68,361,2410,2761
"n3550003","3550003",5044,1720,3324,280,246,2755,2962,3958,1435,2523,217,190,2061,2236
"n4190006","4190006",762,627,135,4,77,46,120,610,527,83,1,51,21,71
"n4230061","4230061",4391,2142,2249,79,903,1202,2058,3470,1846,1624,63,671,810,1461
"n4393566","4393566",0,0,0,0,0,0,0,0,0,0,0,0,0,0
"n4570008","4570008",240,217,23,0,10,5,15,190,172,18,0,8,2,10
"n1670223","1670223",6093,2690,3403,217,1339,1808,3075,4653,2262,2391,169,864,1285,2121
"n1870310","1870310",3382,1495,1887,119,329,1398,1671,2523,1219,1304,81,218,962,1154
"n2010571","2010571",4684,265,4419,22,126,4307,4381,3214,224,2990,11,87,2915,2968
"n2090216","2090216",401,81,320,2,12,312,316,271,71,200,2,6,194,196
"n2150238","2150238",324,15,309,0,5,309,309,192,6,186,0,1,186,186
"n2450088","2450088",2050,631,1419,148,966,287,1232,1639,564,1075,110,725,218,925
"n250019","250019",1022,140,882,8,28,836,859,720,108,612,8,21,582,599
"n294041","294041",3580,282,3298,25,1540,1769,3245,2625,213,2412,17,1211,1199,2374
"n291061","291061",6261,316,5945,59,202,5742,5877,4308,248,4060,40,134,3916,4023
"n390077","390077",7807,4344,3463,176,468,2734,3140,6034,3605,2429,129,320,1881,2165
"n850225","850225",6520,2071,4449,2645,1191,538,1681,4394,1480,2914,1747,759,350,1088
"n1133081","1133081",1836,1428,408,165,46,162,208,1813,1413,400,163,45,156,201
"n4550005","4550005",780,437,343,14,129,196,323,605,367,238,11,104,119,223
"n4550011","4550011",2211,1839,372,16,85,186,269,1896,1627,269,13,53,132,184
"n3410402","3410402",3211,137,3074,354,391,2347,2718,2185,91,2094,192,308,1590,1893
"n3550026","3550026",6851,2643,4208,813,348,2997,3298,4972,2040,2932,581,221,2066,2263
"n4150006","4150006",494,397,97,1,5,85,90,379,318,61,1,0,54,54
"n4270008","4270008",7296,106,7190,20,19,7144,7153,5053,73,4980,11,14,4952,4960
"n4394162","4394162",1948,310,1638,140,109,1387,1486,1317,252,1065,113,46,903,941
"n4393471","4393471",2303,1835,468,140,76,196,262,1705,1411,294,84,50,117,164
"n1270003","1270003",544,45,499,2,7,492,497,395,40,355,2,3,353,354
"n2010594","2010594",3711,556,3155,91,1161,1884,3008,2821,510,2311,81,881,1324,2182
"n2090332","2090332",4662,2790,1872,298,235,1254,1443,3970,2432,1538,261,186,1002,1155
"n2490002","2490002",882,368,514,1,11,482,492,649,283,366,0,10,340,350
"n2930402","2930402",622,567,55,3,9,30,38,510,472,38,1,7,19,25
"n3270002","3270002",485,284,201,2,9,183,191,383,246,137,2,5,122,127
"n294187","294187",0,0,0,0,0,0,0,0,0,0,0,0,0,0
"n291084","291084",4461,428,4033,87,269,3692,3916,3270,355,2915,60,197,2653,2824
"n292090","292090",4807,1045,3762,337,625,2841,3385,3688,881,2807,248,447,2097,2514
"n390054","390054",4374,1416,2958,681,1174,1093,2210,3314,1138,2176,543,884,721,1582
"n730036","730036",2391,1685,706,6,140,512,642,1916,1452,464,5,95,318,412
"n850202","850202",0,0,0,0,0,0,0,0,0,0,0,0,0,0
"n3390095","3390095",8349,4280,4069,809,1131,2055,3096,6440,3526,2914,569,808,1427,2199
"n3830002","3830002",861,340,521,4,16,503,515,630,281,349,2,8,337,345
"n4090115","4090115",7962,4198,3764,131,280,3209,3437,6196,3597,2599,99,171,2179,2339
"n4393372","4393372",6546,3883,2663,750,657,1128,1733,4447,2681,1766,542,402,702,1086
"n2090430","2090430",2040,1424,616,59,46,435,474,1577,1170,407,36,27,282,305
"n2150192","2150192",1262,52,1210,3,2,1207,1208,855,48,807,2,2,805,806
"n2510004","2510004",6122,4700,1422,137,219,887,1079,4639,3708,931,87,131,559,682
"n2730031","2730031",2965,757,2208,124,120,1931,2024,2276,642,1634,96,85,1427,1499
"n2850416","2850416",1041,883,158,3,30,102,131,854,748,106,3,17,67,84
"n3290206","3290206",2716,1978,738,51,120,530,631,2033,1533,500,32,84,351,423
"n1133058","1133058",2890,43,2847,10,1975,866,2824,2238,39,2199,8,1644,546,2179
"n1132044","1132044",2143,1076,1067,386,256,390,631,1712,879,833,341,199,265,456
"n1170001","1170001",4514,755,3759,22,56,3673,3702,3089,602,2487,18,32,2422,2437
"n1470009","1470009",1219,1037,182,6,24,88,110,1022,885,137,6,16,66,82
"n2010199","2010199",4760,3172,1588,176,300,1012,1274,3678,2601,1077,128,193,668,847
"n2010862","2010862",6626,2585,4041,1257,1175,1585,2680,4816,1958,2858,936,812,1056,1825
"n270314","270314",6576,3097,3479,194,1030,2192,3146,5208,2725,2483,159,740,1516,2218
"n294210","294210",36,11,25,0,7,19,22,23,8,15,0,3,11,12
"n294087","294087",3094,964,2130,189,1236,763,1898,2350,750,1600,132,970,520,1431
"n291107","291107",6767,1057,5710,42,109,5497,5572,4840,866,3974,33,61,3824,3869
"n292067","292067",361,64,297,14,5,276,279,326,58,268,11,5,250,253
"n390031","390031",2007,1221,786,17,86,637,710,1530,996,534,15,57,420,472
"n3390073","3390073",3002,1832,1170,136,370,597,953,2250,1413,837,115,269,406,668
"n3510012","3510012",442,372,70,2,43,8,50,322,279,43,2,23,4,27
"n38713-4","38713-4",709,634,75,6,18,29,46,551,492,59,4,12,21,33
"n4070003","4070003",1105,833,272,5,190,55,240,907,693,214,4,150,36,186
"n4392467","4392467",5153,1665,3488,243,2307,940,3158,4265,1523,2742,214,1759,757,2449
"n2150215","2150215",3427,255,3172,240,42,2879,2916,2519,194,2325,195,38,2077,2114
"n2150092","2150092",1626,55,1571,2,12,1556,1561,978,38,940,1,4,935,936
"n2510026","2510026",2336,1848,488,31,59,302,353,1676,1380,296,17,44,172,215
"n2670001","2670001",943,686,257,11,6,232,237,727,542,185,9,6,164,169
"n2890007","2890007",725,594,131,5,27,85,108,557,485,72,2,11,47,58
"n3290410","3290410",2416,1699,717,89,52,499,542,1631,1207,424,58,23,289,311
"n710011","710011",3547,1945,1602,57,368,1142,1477,2653,1600,1053,44,250,718,958
"n850179","850179",5328,4432,896,317,76,357,428,4314,3721,593,200,50,212,261
"n850056","850056",5895,3083,2812,647,553,1479,2014,4049,2283,1766,444,353,868,1214
"n1132018","1132018",1201,923,278,143,34,88,115,874,688,186,91,31,52,77
"n1132225","1132225",2328,1846,482,204,42,179,220,1698,1408,290,114,24,111,135
"n2010885","2010885",5026,1988,3038,287,1186,1458,2615,3607,1506,2101,203,840,981,1809
"n150310","150310",4389,2518,1871,99,409,1294,1667,3272,2038,1234,63,256,841,1089
"n291123","291123",1340,300,1040,27,20,991,1006,960,251,709,14,15,670,681
"n292045","292045",1497,411,1086,20,27,1034,1054,1239,357,882,15,22,840,857
"n293102","293102",4481,2440,2041,167,284,1521,1777,3503,2022,1481,123,187,1106,1283
"n1133702","1133702",0,0,0,0,0,0,0,0,0,0,0,0,0,0
"n1410061","1410061",2540,411,2129,93,200,1869,2002,1875,358,1517,66,134,1319,1416
"n4393200","4393200",3877,2349,1528,308,515,611,1094,3125,2031,1094,224,361,427,771
"n4790361","4790361",3473,98,3375,19,23,3335,3339,2556,78,2478,14,14,2457,2458
"n3330008","3330008",805,703,102,1,7,65,72,672,602,70,1,2,50,52
"n3390057","3390057",4257,3237,1020,40,132,687,811,3424,2724,700,24,80,452,529
"n3550089","3550089",1139,272,867,17,25,818,834,874,230,644,17,13,600,612
"n4394480","4394480",1366,1087,279,59,44,162,205,961,766,195,48,31,100,131
"n4391345","4391345",841,392,449,33,169,219,381,616,287,329,27,129,152,277
"n4392557","4392557",2424,481,1943,356,1037,542,1538,1684,354,1330,261,684,360,1023
"n1573049","1573049",5470,904,4566,2065,1879,630,2479,4356,763,3593,1660,1459,465,1910
"n1571063","1571063",4241,2947,1294,173,289,737,1015,3332,2387,945,133,207,520,726
"n1730003","1730003",273,185,88,0,8,81,86,222,159,63,0,4,58,62
"n2010733","2010733",1985,92,1893,14,414,1477,1860,1277,79,1198,12,273,912,1173
"n2010816","2010816",135,17,118,2,9,112,115,98,14,84,0,3,81,81
"n2010485","2010485",7816,4118,3698,678,917,2025,2880,5705,3175,2530,460,637,1354,1954
"n50039","50039",885,551,334,17,216,91,304,758,488,270,14,175,67,242
"n350008","350008",3457,2428,1029,37,134,764,877,2723,2078,645,20,79,480,549
"n550405","550405",959,429,530,2,76,416,486,724,365,359,1,60,265,325
"n930009","930009",306,216,90,0,5,81,84,246,176,70,0,2,65,66
"n1211012","1211012",1254,684,570,59,186,305,486,934,530,404,47,129,210,338
"n1391014","1391014",2499,1935,564,25,105,361,458,1972,1610,362,10,74,215,286
"n4770410","4770410",1519,1144,375,15,156,168,323,1216,951,265,7,118,106,224
"n2593030","2593030",2822,2230,592,34,28,433,454,2248,1840,408,24,22,282,299
"n3610009","3610009",3172,2770,402,28,91,190,271,2461,2179,282,23,52,114,165
"n397001BA","397001BA",6426,4823,1603,332,343,769,1097,4465,3446,1019,203,208,480,685
"n4010201","4010201",3750,1838,1912,16,842,1027,1861,3295,1646,1649,14,723,898,1615
"n4391111","4391111",4837,3602,1235,182,211,727,911,3479,2673,806,128,124,452,568
"n4530344","4530344",4286,2678,1608,618,134,761,884,3065,1971,1094,412,81,529,607
"n1850015","1850015",2187,1587,600,13,70,424,487,1705,1299,406,11,50,261,308
"n2010047","2010047",3058,131,2927,18,1309,1630,2896,2261,104,2157,12,1052,1096,2132
"n2010176","2010176",1745,1046,699,379,73,232,300,1299,787,512,289,45,158,201
"n2030006","2030006",2095,1638,457,12,303,108,403,1594,1248,346,7,234,73,304
"n2150169","2150169",771,20,751,3,7,740,745,582,13,569,2,3,565,566
"n229001W","229001W",262,15,247,1,3,244,245,182,15,167,0,1,165,166
"n294193","294193",217,37,180,10,48,126,163,155,29,126,4,34,85,115
"n1050004","1050004",737,132,605,5,11,586,594,559,104,455,2,10,439,447
"n1132148","1132148",1452,584,868,84,299,458,747,1230,538,692,77,234,349,578
"n1410015","1410015",3608,1149,2459,283,130,2052,2153,2705,931,1774,210,90,1488,1556
"n2010779","2010779",4363,218,4145,20,68,4065,4114,2927,178,2749,15,43,2680,2721
"n2011111","2011111",6196,1465,4731,453,1143,3086,4151,4646,1211,3435,342,815,2234,3007
"n4910181","4910181",3146,1407,1739,614,325,758,1052,2277,1065,1212,440,218,516,710
"n4970009","4970009",3285,2744,541,33,46,323,362,2480,2105,375,28,23,218,239
"n2730013","2730013",1114,103,1011,17,38,975,992,818,83,735,16,18,711,720
"n3090025","3090025",4433,874,3559,62,525,2992,3453,3177,776,2401,44,338,1995,2315
"n4393390","4393390",5176,3667,1509,834,144,368,506,3914,2915,999,563,92,216,305
"n4394650","4394650",5584,2561,3023,428,1041,1478,2472,3782,1879,1903,267,638,891,1511
"n4392755","4392755",0,0,0,0,0,0,0,0,0,0,0,0,0,0
"n4850105","4850105",1311,1090,221,9,14,88,102,1018,853,165,3,6,69,75
"n10021","10021",2772,2104,668,38,212,374,575,2169,1717,452,32,140,235,372
"n1134025","1134025",885,16,869,9,182,675,855,625,14,611,4,148,453,601
"n1212095","1212095",3707,1861,1846,1335,175,269,434,2684,1400,1284,942,136,162,293
"n1410001","1410001",3872,287,3585,32,51,3507,3536,2704,244,2460,20,39,2401,2424
"n1810310","1810310",358,250,108,27,14,34,48,273,206,67,10,13,22,35
"n2010093","2010093",9665,771,8894,85,375,8444,8754,6808,671,6137,69,226,5829,6028
"n4530437","4530437",6516,2785,3731,179,375,3071,3386,5501,2520,2981,145,313,2407,2687
"n4790308","4790308",1711,74,1637,20,11,1608,1613,1275,58,1217,17,5,1193,1197
"n2010425","2010425",3528,338,3190,236,605,2375,2934,2533,303,2230,207,441,1591,2011
"n2010130","2010130",3092,2075,1017,341,228,449,638,2569,1754,815,284,185,342,498
"n2150086","2150086",928,163,765,12,6,747,752,749,154,595,11,1,583,584
"n4070009","4070009",706,628,78,2,6,61,66,558,504,54,2,3,43,45
"n4430004A","4430004A",112,53,59,0,2,56,58,77,46,31,0,1,29,30
"n4530122","4530122",6764,865,5899,76,742,5060,5766,4507,750,3757,58,510,3148,3648
"n294147","294147",484,237,247,35,35,185,211,398,211,187,31,28,132,158
"n410016","410016",3296,341,2955,41,577,2334,2890,2331,299,2032,34,399,1581,1977
"n690105","690105",515,64,451,0,17,428,442,351,51,300,0,10,282,292
"n850165","850165",1194,664,530,294,103,113,208,875,533,342,203,58,74,130
"n1134633","1134633",5358,505,4853,3405,885,562,1411,3900,447,3453,2406,637,412,1031
"n1214197","1214197",1889,1600,289,36,20,152,170,1315,1146,169,19,11,81,92
"n3790101","3790101",1932,1635,297,14,35,171,205,1558,1349,209,11,21,110,131
"n4170406A","4170406A",422,337,85,7,10,66,73,324,275,49,6,6,38,42
"n4391639","4391639",2546,333,2213,115,1151,943,2073,1652,258,1394,83,719,595,1306
"n4530201","4530201",4653,3973,680,182,59,367,418,3567,3067,500,121,43,274,316
"n4870021","4870021",3805,2334,1471,260,373,744,1100,3078,1983,1095,188,324,514,831
"n1990010","1990010",3229,1599,1630,24,1378,182,1552,2409,1213,1196,16,1032,118,1147
"n2010239","2010239",2658,37,2621,13,1774,866,2608,2050,33,2017,10,1426,605,2007
"n213003N","213003N",1628,1208,420,17,58,300,357,1265,998,267,15,38,180,218
"n2150232","2150232",4412,88,4324,12,9,4311,4312,2758,55,2703,9,4,2697,2698
"n2450094","2450094",2621,1696,925,250,365,277,636,2069,1378,691,201,270,190,459
"n2773H3C","2773H3C",2049,1340,709,22,425,197,620,1604,1138,466,17,284,115,397
"n294047","294047",5755,1039,4716,217,978,3576,4431,4115,919,3196,135,553,2503,2996
"n291067","291067",6224,1348,4876,88,137,4645,4733,4572,1147,3425,54,78,3253,3309
"n292107","292107",6399,1688,4711,423,680,3712,4261,4286,1215,3071,267,408,2398,2764
"n850016","850016",6289,3949,2340,449,861,875,1695,4236,2781,1455,291,524,518,1023
"n1133044","1133044",5506,105,5401,39,3042,2343,5343,3764,74,3690,34,2201,1474,3647
"n1131728","1131728",3317,807,2510,91,309,2068,2358,2427,694,1733,80,228,1395,1606
"n3290101","3290101",1898,892,1006,27,86,830,906,1386,698,688,20,51,564,614
"n3410101","3410101",5327,1550,3777,230,113,3345,3439,3690,1227,2463,112,83,2197,2272
"n3670215","3670215",5262,4248,1014,41,67,637,701,3897,3229,668,25,46,401,446
"n4392316","4392316",3163,1404,1759,337,866,543,1357,2707,1285,1422,288,682,422,1078
"n4510144","4510144",3582,1210,2372,133,267,1962,2183,2521,889,1632,87,148,1366,1505
"n4910319","4910319",259,160,99,31,27,38,64,180,117,63,14,16,28,44
"n1410207","1410207",4343,69,4274,13,29,4243,4256,3072,52,3020,10,26,3001,3014
"n1610006C","1610006C",0,0,0,0,0,0,0,0,0,0,0,0,0,0
"n2010925","2010925",0,0,0,0,0,0,0,0,0,0,0,0,0,0
"n2010631","2010631",5317,2186,3131,571,967,1583,2482,3980,1820,2160,417,669,1054,1686
"n2150132","2150132",1473,39,1434,1,7,1427,1427,1125,30,1095,0,6,1090,1090
"n2930301","2930301",2381,1347,1034,70,420,519,926,1840,1061,779,65,305,380,682
"n214026","214026",3622,1397,2225,36,723,1435,2114,2619,1148,1471,24,492,904,1382
"n292008","292008",2202,103,2099,13,52,2040,2082,1712,95,1617,5,44,1570,1608
"n293062","293062",81,20,61,3,6,55,56,67,20,47,1,2,44,44
"n410062","410062",2353,943,1410,218,396,744,1112,1824,848,976,186,266,468,722
"n610087","610087",4048,470,3578,33,35,3503,3519,2968,428,2540,25,21,2488,2497
"n850119","850119",3073,1508,1565,1173,136,202,338,2396,1220,1176,876,110,143,253
"n3390016","3390016",7708,4763,2945,63,111,2487,2587,5495,3651,1844,43,69,1516,1576
"n3550043","3550043",1320,131,1189,12,107,1082,1169,941,105,836,7,70,757,822
"n4230024","4230024",2895,2238,657,31,184,388,561,2271,1827,444,21,133,243,373
"n2011080","2011080",2555,326,2229,212,549,1459,1984,1783,269,1514,170,367,962,1314
"n2010660","2010660",6543,218,6325,593,3078,2646,5671,4713,166,4547,480,2349,1716,4035
"n212012","212012",2021,1441,580,36,76,407,473,1655,1214,441,28,62,294,351
"n294010","294010",5196,331,4865,52,1423,3521,4798,3612,289,3323,29,1072,2255,3275
"n293051","293051",416,309,107,12,4,85,88,360,277,83,8,2,67,69
"n293094","293094",7017,3102,3915,663,496,2755,3182,5884,2762,3122,517,395,2176,2535
"n410005","410005",2591,1747,844,16,110,642,747,1955,1419,536,10,70,398,465
"n490101","490101",3482,2548,934,43,151,701,820,2717,2078,639,34,91,467,553
"n4850404","4850404",3776,2706,1070,308,223,463,667,2928,2196,732,226,137,300,432
"n4910332","4910332",4801,2771,2030,1113,211,592,775,3003,1818,1185,646,126,323,438
"n3090017","3090017",1665,722,943,22,384,504,875,1274,632,642,17,290,305,591
"n3550032","3550032",4148,1319,2829,215,286,2267,2514,3310,1176,2134,169,216,1687,1883
"n3630026","3630026",287,183,104,9,24,65,85,194,136,58,8,4,39,43
"n4270014","4270014",4751,81,4670,5,12,4655,4659,3335,56,3279,3,7,3268,3271
"n4530238","4530238",4793,3383,1410,371,209,776,956,3888,2852,1036,262,156,563,702
"n4810301","4810301",3599,2311,1288,13,112,1134,1229,2826,1917,909,9,78,794,865
"n530013","530013",1948,1254,694,25,16,588,601,1459,1005,454,19,6,374,379
"n850231","850231",5308,2852,2456,494,1015,885,1856,4001,2219,1782,376,741,608,1317
"n1134622","1134622",3982,867,3115,438,598,2072,2617,2970,787,2183,318,419,1425,1823
"n1410047","1410047",3674,838,2836,196,407,2268,2603,2816,769,2047,150,260,1607,1852
"n1410211B","1410211B",0,0,0,0,0,0,0,0,0,0,0,0,0,0
"n1810409","1810409",3358,2554,804,67,234,368,583,2651,2107,544,47,165,218,379
"n292093","292093",4101,996,3105,335,600,2228,2762,2975,799,2176,219,401,1562,1940
"n293074","293074",3122,1733,1389,138,108,1130,1216,2602,1543,1059,90,93,850,926
"n510203","510203",562,395,167,7,47,112,157,444,329,115,3,38,73,111
"n610099","610099",1089,66,1023,7,6,1009,1013,748,54,694,5,4,686,688
"n1134008","1134008",7387,170,7217,48,184,6994,7148,4781,131,4650,33,138,4488,4604
"n1133317","1133317",4054,695,3359,116,1492,1719,3170,2809,595,2214,86,1037,1050,2067
"n4850205","4850205",6238,4873,1365,158,329,643,949,4634,3773,861,93,180,375,550
"n317004A","317004A",341,243,98,0,4,93,97,240,171,69,0,4,64,68
"n3550055","3550055",1317,68,1249,2,12,1230,1240,1011,54,957,2,11,943,952
"n4391504","4391504",3220,2340,880,52,143,598,725,2525,1934,591,24,86,392,473
"n4392055","4392055",2690,1605,1085,173,472,418,861,2232,1421,811,134,358,281,628
"n4490020","4490020",2339,1060,1279,72,264,902,1153,1724,871,853,59,185,571,752
"n4710203","4710203",2765,1834,931,13,594,254,841,2215,1507,708,4,471,182,649
"n1410190","1410190",188,2,186,0,0,186,186,172,2,170,0,0,170,170
"n1670483","1670483",5975,3149,2826,381,941,1448,2319,4357,2460,1897,277,612,922,1509
"n2010368","2010368",2143,203,1940,38,728,1191,1893,1496,176,1320,27,498,805,1286
"n2010540","2010540",4132,2232,1900,1010,374,487,845,3773,2103,1670,870,325,446,759
"n2270103","2270103",321,157,164,11,30,113,137,257,132,125,9,20,86,103
"n2450060","2450060",5944,3666,2278,228,279,1672,1929,4319,2864,1455,151,157,1044,1195
"n292116","292116",0,0,0,0,0,0,0,0,0,0,0,0,0,0
"n610076","610076",7051,401,6650,46,32,6582,6592,5094,345,4749,44,17,4684,4693
"n1134031","1134031",4496,137,4359,57,1606,2702,4280,3152,122,3030,46,1282,1698,2966
"n1131407","1131407",63,4,59,1,10,49,57,31,4,27,1,4,24,26
"n1131047","1131047",2899,838,2061,25,174,1830,1980,2208,720,1488,18,112,1317,1423
"n1133207","1133207",5350,1100,4250,71,1661,2515,4120,3754,976,2778,56,1088,1598,2662
"n4391436","4391436",2500,606,1894,124,1157,625,1728,1739,486,1253,96,773,383,1134
"n4394399","4394399",343,248,95,16,21,51,72,290,216,74,11,15,44,59
"n4392220","4392220",3381,2228,1153,374,332,383,694,2647,1843,804,276,234,244,473
"n4450301","4450301",2833,675,2158,36,161,1973,2092,2025,525,1500,26,104,1350,1445
"n4730210","4730210",835,316,519,19,31,450,481,601,261,340,16,23,285,308
"n1350308","1350308",1931,686,1245,56,113,1057,1148,1355,527,828,33,67,699,756
"n2010517","2010517",6760,1210,5550,455,674,4386,4976,4862,1035,3827,332,468,2984,3407
"n2011057","2011057",26,0,26,0,2,24,26,18,0,18,0,2,16,18
"n2030015","2030015",1570,1415,155,6,35,80,110,1152,1062,90,3,20,34,54
"n229004S","229004S",67,30,37,3,0,32,32,57,29,28,3,0,23,23
"n3750424","3750424",3350,629,2721,163,1478,1094,2496,2155,527,1628,94,869,649,1497
"n190102","190102",3173,2417,756,21,41,589,629,2594,2040,554,21,23,424,447
"n294073","294073",3092,977,2115,19,119,1949,2045,2288,794,1494,10,94,1358,1439
"n291135","291135",8,0,8,0,4,4,8,5,0,5,0,4,1,5
"n293031","293031",50,13,37,2,7,30,34,28,8,20,0,3,18,18
"n390020","390020",2501,1529,972,21,161,743,888,1955,1262,693,12,135,504,627
"n550206","550206",2160,661,1499,20,291,1159,1424,1607,567,1040,12,216,768,980
"n4790414","4790414",2881,48,2833,4,4,2824,2824,1921,34,1887,1,1,1881,1881
"n4910484","4910484",5528,2633,2895,1036,708,1130,1793,3711,1910,1801,619,464,676,1110
"n2090228","2090228",3414,1124,2290,214,233,1829,2026,2527,908,1619,166,175,1260,1413
"n2150158","2150158",10125,316,9809,124,89,9591,9630,6610,212,6398,103,55,6235,6269
"n2310321","2310321",2455,2030,425,22,35,250,279,2039,1732,307,16,19,169,188
"n2550002","2550002",191,159,32,1,3,29,30,169,144,25,1,3,23,24
"n4530212","4530212",4281,2871,1410,356,224,757,942,3868,2623,1245,307,205,660,832
"n4570018","4570018",1588,1282,306,17,154,89,236,1278,1075,203,13,94,61,148
"n850002","850002",8196,3476,4720,363,1653,2534,4107,6248,2965,3283,283,1109,1703,2776
"n870202","870202",101,52,49,3,3,47,47,70,39,31,2,0,31,31
"n2010497","2010497",2719,166,2553,19,1042,1496,2523,1842,139,1703,11,713,968,1678
"n2010248","2010248",5537,546,4991,43,791,4171,4879,3931,440,3491,22,576,2871,3409
"n2010994","2010994",5181,920,4261,848,2747,731,3396,4489,843,3646,738,2362,586,2890
"n2010745","2010745",4447,2213,2234,343,493,1311,1762,3542,1907,1635,266,362,911,1257
"n293137","293137",5637,2178,3459,583,451,2448,2807,3722,1490,2232,382,284,1556,1797
"n293172","293172",972,263,709,98,66,552,604,737,216,521,75,43,400,437
"n410048","410048",404,231,173,5,12,150,159,296,189,107,1,9,95,102
"n410085","410085",0,0,0,0,0,0,0,0,0,0,0,0,0,0
"n1132523","1132523",2627,1234,1393,841,217,298,507,2337,1096,1241,758,191,251,437
"n1134673","1134673",0,0,0,0,0,0,0,0,0,0,0,0,0,0
"n4910146","4910146",7927,4386,3541,1126,774,1434,2151,6431,3681,2750,917,601,1042,1607
"n3110004","3110004",151,88,63,5,5,52,55,130,77,53,4,2,46,48
"n3550111","3550111",1981,558,1423,10,72,1331,1388,1364,442,922,8,50,852,894
"n4230053","4230053",621,438,183,2,102,69,170,472,354,118,1,73,34,107
"n4393166","4393166",7236,2350,4886,323,1745,2737,4373,5173,1984,3189,246,1115,1730,2783
"n4530355","4530355",1098,838,260,60,25,151,169,999,776,223,47,18,135,150
"n4910245","4910245",4134,3053,1081,260,146,558,691,2899,2192,707,175,88,347,434
"n1410133","1410133",3907,97,3810,38,114,3704,3769,3144,87,3057,19,76,2977,3034
"n1710005","1710005",2283,1897,386,4,24,281,296,1836,1580,256,2,9,178,181
"n2010888","2010888",4872,690,4182,171,1915,2081,3923,3333,542,2791,127,1294,1351,2605
"n2010851","2010851",7450,3347,4103,624,1140,2300,3362,5766,2760,3006,491,859,1587,2411
"n2150052","2150052",5830,489,5341,454,118,4787,4875,4265,409,3856,322,75,3465,3525
"n2150015","2150015",1599,102,1497,7,5,1478,1478,1151,89,1062,3,3,1050,1050
"n10008","10008",926,295,631,13,308,322,612,735,256,479,7,243,233,465
"n10903-5","10903-5",501,124,377,15,9,350,356,395,119,276,12,7,255,260
"n1132053","1132053",5935,1653,4282,674,1394,2200,3535,5046,1582,3464,620,1208,1604,2767
"n1214166","1214166",3673,1847,1826,129,520,1157,1625,2931,1596,1335,104,383,811,1170
"n1212081","1212081",7330,2904,4426,2932,714,702,1379,4581,1913,2668,1749,475,411,863
"n1370004","1370004",362,116,246,5,3,236,236,290,101,189,3,2,182,182
"n3750121","3750121",3396,2161,1235,134,325,714,1026,2604,1796,808,88,204,459,658
"n397004F","397004F",890,498,392,28,29,321,345,647,377,270,16,22,213,232
"n4090124","4090124",5694,1129,4565,45,173,4362,4472,4247,928,3319,29,107,3167,3252
"n4394006","4394006",1877,845,1032,53,625,348,954,1586,783,803,43,464,283,741
"n4490014","4490014",3580,1186,2394,32,538,1784,2304,2542,974,1568,11,378,1136,1507
"n1410027","1410027",3373,594,2779,123,149,2536,2655,2714,518,2196,109,117,1986,2085
"n1870203","1870203",1913,544,1369,29,162,1176,1322,1440,482,958,14,128,805,924
"n2010119","2010119",2707,913,1794,196,468,1132,1559,1837,686,1151,114,299,731,1008
"n2730042","2730042",1848,136,1712,18,50,1650,1682,1320,100,1220,13,29,1180,1205
"n3030109","3030109",3772,2963,809,123,96,513,597,2854,2324,530,91,61,305,364
"n3650026","3650026",206,151,55,0,39,12,50,152,111,41,0,33,6,39
"n294179","294179",4111,1638,2473,206,321,1926,2193,3252,1415,1837,171,232,1405,1605
"n294216","294216",1794,152,1642,12,46,1578,1607,1258,121,1137,6,25,1092,1112
"n1131099","1131099",210,30,180,2,29,155,178,116,17,99,0,10,91,99
"n1133609","1133609",4670,581,4089,65,3126,904,3978,3572,537,3035,57,2398,578,2946
"n1133965","1133965",5156,2108,3048,569,1311,1132,2382,3785,1663,2122,422,900,758,1626
"n1573020","1573020",4332,2269,2063,676,302,1026,1299,3416,1902,1514,508,206,724,913
"n3390043D","3390043D",14,8,6,0,2,2,4,8,4,4,0,0,2,2
"n4391605","4391605",0,0,0,0,0,0,0,0,0,0,0,0,0,0
"n4391738","4391738",45,37,8,2,0,4,4,34,30,4,2,0,0,0
"n4410102","4410102",4344,2657,1687,70,313,1241,1519,3360,2198,1162,48,179,847,1019
"n1573126","1573126",1475,253,1222,865,249,116,349,1000,176,824,591,155,73,222
"n2011100","2011100",1572,478,1094,105,270,720,969,1206,403,803,85,204,504,695
"n2010056","2010056",2446,1134,1312,189,152,940,1069,1973,982,991,154,122,690,800
"n2011137","2011137",6078,563,5515,299,2618,2684,5163,4055,438,3617,213,1612,1806,3359
"n2850102","2850102",2070,1539,531,6,263,246,506,1583,1208,375,5,191,166,356
"n3390079","3390079",3523,2261,1262,170,358,676,1012,2716,1870,846,120,186,480,655
"n50024","50024",4805,2803,2002,63,609,1201,1794,3345,2093,1252,40,375,739,1108
"n291050","291050",1485,123,1362,10,23,1321,1339,1114,112,1002,10,20,966,984
"n850088","850088",5448,1331,4117,394,1705,2023,3650,4359,1203,3156,339,1292,1505,2754
"n970017","970017",548,508,40,1,3,14,17,426,406,20,0,0,8,8
"n1133027","1133027",1901,26,1875,4,1471,429,1871,1443,20,1423,1,1172,269,1420
"n1132004","1132004",2374,1911,463,135,75,217,283,1768,1449,319,87,45,156,197
"n3030029","3030029",7048,1353,5695,73,1214,4453,5544,5021,1162,3859,58,752,3028,3735
"n325002B","325002B",4083,2427,1656,54,64,1450,1490,3193,1993,1200,33,36,1058,1088
"n4394128","4394128",6407,3465,2942,130,493,2125,2564,4828,2886,1942,94,297,1378,1656
"n4392612","4392612",0,0,0,0,0,0,0,0,0,0,0,0,0,0
"n4530101","4530101",4278,1460,2818,159,1019,1647,2593,3256,1299,1957,127,714,1084,1765
"n4530421","4530421",4166,2606,1560,410,241,883,1071,4037,2555,1482,397,229,830,1010
"n1670333","1670333",5619,3596,2023,609,384,949,1308,3707,2405,1302,398,259,563,817
"n1870407","1870407",2872,1878,994,17,116,801,902,2199,1526,673,12,88,503,588
"n2010411","2010411",6917,494,6423,82,405,5962,6323,4796,427,4369,51,320,4006,4302
"n2010162","2010162",4610,252,4358,32,147,4216,4305,3257,217,3040,26,105,2925,3000
"n2450017","2450017",4153,1443,2710,291,1791,583,2344,3216,1268,1948,210,1295,399,1684
"n2650202","2650202",3291,2116,1175,36,34,1003,1027,2555,1773,782,20,23,657,677
"n211006","211006",7877,2439,5438,44,550,4754,5255,5830,2067,3763,31,435,3215,3629
"n270113","270113",7371,3701,3670,192,745,2657,3295,5380,3015,2365,124,425,1723,2109
"n270106","270106",7834,2110,5724,417,3377,2001,5105,5672,1709,3963,315,2271,1322,3474
"n293088","293088",5893,2709,3184,702,515,1957,2396,4575,2267,2308,496,368,1406,1736
"n850188","850188",240,123,117,24,14,65,74,183,104,79,8,13,44,53
"n850194","850194",31,21,10,0,4,5,9,24,17,7,0,2,4,6
"n4393529","4393529",3891,2369,1522,1039,144,259,393,2583,1686,897,598,87,156,240
"n4530304","4530304",5160,3786,1374,386,160,707,850,4889,3628,1261,364,132,650,772
"n4530293","4530293",6230,4272,1958,870,223,732,942,4688,3326,1362,606,150,515,658
"n2490008","2490008",5421,2118,3303,9,44,3129,3163,3987,1671,2316,4,31,2180,2210
"n2490014","2490014",295,48,247,5,2,236,237,201,44,157,1,1,149,149
"n3090059","3090059",5457,3999,1458,82,274,952,1195,4118,3142,976,62,177,605,770
"n3090053B","3090053B",0,0,0,0,0,0,0,0,0,0,0,0,0,0
"n4393336","4393336",6617,2086,4531,2071,1233,1097,2261,5203,1813,3390,1609,868,780,1618
"n4393330","4393330",1369,1077,292,94,47,118,163,1120,909,211,72,36,81,116
"n1132315","1132315",329,143,186,53,78,49,124,310,138,172,43,77,45,119
"n1132308","1132308",1722,594,1128,452,341,301,638,1508,556,952,377,293,251,540
"n1790002","1790002",5876,2965,2911,34,514,2225,2722,4687,2473,2214,24,471,1609,2066
"n1810101","1810101",4469,1797,2672,39,520,1956,2445,3189,1435,1754,30,370,1224,1577
"n2010311","2010311",8141,850,7291,2441,686,4189,4801,6278,761,5517,2125,553,2855,3350
"n2010305","2010305",9288,1433,7855,574,1734,5518,7131,6538,1124,5414,437,1142,3803,4880
"n291093","291093",2924,823,2101,170,415,1486,1871,2460,738,1722,146,350,1195,1525
"n292179","292179",243,45,198,46,41,112,152,167,34,133,27,28,79,106
"n610013","610013",1443,31,1412,5,4,1400,1402,1030,22,1008,2,2,1000,1002
"n850045","850045",4414,2708,1706,489,642,502,1117,3594,2322,1272,360,471,380,833
"n11340A2","11340A2",0,0,0,0,0,0,0,0,0,0,0,0,0,0
"n1133070","1133070",3909,109,3800,26,2929,870,3761,2900,86,2814,21,2246,551,2778
"n3290306","3290306",7783,559,7224,96,1134,5984,7065,5589,454,5135,48,900,4159,5034
"n3510003","3510003",657,600,57,3,24,10,31,500,474,26,2,10,7,15
"n4391206","4391206",3937,2916,1021,71,128,691,806,3105,2427,678,51,83,434,512
"n4392438","4392438",5331,1153,4178,295,2340,1559,3837,4102,969,3133,252,1785,1085,2838
"n4530480","4530480",3287,330,2957,17,239,2712,2921,2232,305,1927,15,177,1744,1905
"n4790238","4790238",600,26,574,3,2,566,566,394,21,373,3,0,366,366
"n1490204","1490204",1754,1447,307,8,30,223,253,1451,1243,208,7,26,139,165
"n1670137","1670137",5284,3409,1875,491,441,825,1239,3518,2341,1177,348,277,493,765
"n2010702","2010702",1401,20,1381,12,254,1125,1363,1051,16,1035,7,234,800,1022
"n2010454","2010454",3588,59,3529,22,2487,1045,3502,2653,46,2607,15,1955,655,2590
"n2150201","2150201",1963,178,1785,260,34,1512,1524,1370,143,1227,190,19,1024,1031
"n2390008","2390008",830,557,273,10,10,236,245,626,449,177,9,7,148,155
"n294173","294173",3033,1097,1936,130,456,1353,1775,2387,992,1395,87,318,954,1262
"n292031","292031",3888,130,3758,17,126,3643,3714,2520,74,2446,7,62,2380,2418
"n650402","650402",408,359,49,3,7,24,29,323,291,32,0,4,14,17
"n1133603","1133603",278,69,209,7,170,28,198,235,68,167,4,143,18,161
"n1131093","1131093",3941,149,3792,57,1250,2495,3717,2783,127,2656,45,938,1680,2603
"n1214222","1214222",6044,3640,2404,209,758,1251,1962,4044,2541,1503,141,456,768,1204
"n3390084","3390084",10209,4231,5978,1175,1484,3106,4481,7886,3579,4307,911,1012,2182,3131
"n3910001","3910001",943,231,712,4,146,584,700,684,192,492,0,95,404,486
"n4391753","4391753",0,0,0,0,0,0,0,0,0,0,0,0,0,0
"n4410108","4410108",1747,1394,353,29,54,211,259,1363,1123,240,17,38,132,166
"n4690028","4690028",706,461,245,5,11,211,220,565,387,178,4,4,154,158
"n2010554","2010554",6026,408,5618,337,1736,3651,5243,4248,338,3910,317,1337,2310,3573
"n2011094","2011094",0,0,0,0,0,0,0,0,0,0,0,0,0,0
"n2010603","2010603",5799,2165,3634,370,920,2325,3177,4295,1756,2539,268,629,1601,2201
"n2210408","2210408",4195,3273,922,63,74,596,654,3375,2751,624,40,42,368,406
"n2270016","2270016",464,181,283,9,45,223,264,333,136,197,9,36,144,179
"n2910006","2910006",1566,1144,422,8,81,270,349,1181,899,282,8,57,155,212
"n1310006","1310006",192,15,177,1,1,174,175,147,12,135,1,1,132,133
"n1573135","1573135",10817,2209,8608,7295,488,770,1228,7677,1684,5993,5082,340,504,832
"n1572152","1572152",2179,1017,1162,213,519,374,882,1616,784,832,157,398,233,626
"n2010062","2010062",4576,111,4465,22,107,4364,4431,3414,97,3317,17,84,3239,3293
"n2011143","2011143",0,0,0,0,0,0,0,0,0,0,0,0,0,0
"n2010014","2010014",2597,1754,843,245,170,387,548,2012,1399,613,187,127,260,381
"n294162","294162",4322,1273,3049,195,766,2125,2783,3154,1057,2097,129,495,1445,1891
"n291059","291059",1820,148,1672,18,168,1491,1645,1267,140,1127,13,131,975,1102
"n293037","293037",143,77,66,27,12,31,42,101,52,49,15,9,23,32
"n430005","430005",173,136,37,1,2,33,34,159,127,32,1,1,29,30
"n850008","850008",5813,3017,2796,69,118,2475,2567,4333,2545,1788,48,76,1536,1604
"n1450101","1450101",1415,431,984,24,535,430,935,1046,374,672,18,352,284,631
"n4690011","4690011",521,334,187,4,20,152,170,412,264,148,3,14,119,132
"n4910308","4910308",1059,825,234,32,18,156,173,872,703,169,24,12,106,118
"n2250006","2250006",1698,1123,575,18,449,67,513,1340,908,432,16,337,41,377
"n3810230","3810230",6658,5038,1620,100,279,1038,1279,5201,4093,1108,72,187,666,840
"n4270006","4270006",7475,124,7351,6,13,7323,7326,5307,82,5225,5,9,5210,5212
"n4394155","4394155",7923,889,7034,675,255,6095,6309,5492,710,4782,419,165,4184,4332
"n4392314","4392314",4560,3097,1463,302,466,620,1052,3700,2656,1044,224,328,421,729
"n4530221","4530221",4843,3505,1338,290,134,814,929,4003,2936,1067,232,91,654,734
"n1670364","1670364",4239,2790,1449,294,305,783,1065,3153,2184,969,194,187,515,700
"n2010006","2010006",8814,2294,6520,292,2862,3378,6070,6379,1945,4434,224,1916,2277,4095
"n2010337","2010337",3284,157,3127,55,1199,1927,3067,2358,142,2216,43,878,1329,2166
"n2011000","2011000",1112,31,1081,94,363,645,988,843,29,814,76,275,470,735
"n2010669","2010669",5758,2734,3024,485,1445,1046,2446,4621,2388,2233,372,1028,772,1773
"n2132PSN","2132PSN",3583,3012,571,17,46,379,423,2909,2525,384,5,16,248,263
"n294139","294139",22,4,18,1,4,14,18,16,4,12,0,4,8,12
"n291036","291036",6823,841,5982,165,476,5393,5762,4779,718,4061,118,324,3597,3883
"n293014","293014",795,304,491,23,30,445,465,645,265,380,18,21,339,358
"n2011023","2011023",2259,80,2179,43,447,1717,2131,1619,64,1555,32,328,1216,1521
"n2010029","2010029",6488,357,6131,63,65,6007,6051,4655,318,4337,44,32,4256,4278
"n2010360","2010360",6015,3343,2672,1301,396,858,1236,5001,2941,2060,956,319,683,997
"n467002A","467002A",6072,5165,907,74,153,517,663,4576,4000,576,49,99,295,392
"n3550001","3550001",2495,1270,1225,65,140,991,1111,2313,1231,1082,62,115,866,976
"n3770006","3770006",85,24,61,2,1,57,58,49,19,30,1,0,27,27
"n4230059","4230059",4769,3403,1366,361,469,432,894,3770,2829,941,241,332,290,617
"n4394097","4394097",2482,439,2043,76,95,1857,1941,1792,350,1442,57,49,1314,1360
"n4392246","4392246",1405,1033,372,77,86,174,253,1173,903,270,52,66,129,191
"n4530185","4530185",1949,505,1444,38,97,1297,1372,1481,457,1024,35,52,913,965
"n2010691","2010691",7183,4009,3174,575,644,1877,2494,5043,2972,2071,400,416,1176,1586
"n2150021","2150021",988,23,965,4,10,956,961,700,15,685,4,2,680,681
"n2270026","2270026",768,317,451,11,53,384,432,534,264,270,6,20,242,260
"n2570016","2570016",5165,4135,1030,74,178,610,776,3984,3296,688,53,117,395,510
"n3030058","3030058",2189,1357,832,198,101,504,595,1812,1179,633,167,75,365,433
"n323004A","323004A",2934,99,2835,17,14,2815,2818,2153,71,2082,9,4,2068,2069
"n291013","291013",4354,146,4208,8,44,4170,4196,3297,123,3174,7,35,3143,3164
"n850223","850223",2975,1627,1348,853,190,247,425,1947,1124,823,522,115,140,252
"n1134608","1134608",8592,1765,6827,1087,2497,3218,5613,6583,1590,4993,831,1844,2291,4067
"n1133079","1133079",2496,343,2153,19,239,1878,2108,1596,271,1325,12,177,1121,1293
"n1131726","1131726",5236,1092,4144,152,576,3377,3915,3707,959,2748,99,412,2208,2599
"n1270001","1270001",2236,253,1983,35,50,1891,1922,1606,209,1397,25,36,1324,1352
"n1410199","1410199",1887,306,1581,45,53,1499,1532,1412,278,1134,33,26,1078,1096
"n1670150","1670150",4099,2085,2014,80,463,1350,1792,3176,1751,1425,58,328,939,1255
"n1930004","1930004",247,204,43,0,6,34,39,194,166,28,0,0,24,24
"n4730102","4730102",4858,1497,3361,47,1626,1680,3250,3659,1280,2379,34,1222,1095,2291
"n4910402","4910402",8395,3713,4682,308,1366,2987,4216,5763,2690,3073,191,918,1881,2736
"n1134631","1134631",2288,972,1316,193,190,911,1081,1786,833,953,156,141,635,764
"n1330003","1330003",2686,1952,734,33,125,525,639,2140,1605,535,22,108,364,466
"n1410220","1410220",1791,57,1734,16,28,1621,1632,1419,46,1373,9,14,1280,1287
"n1670218","1670218",4628,2449,2179,134,435,1532,1942,3796,2165,1631,97,302,1153,1441
"n1990002","1990002",7058,6046,1012,53,359,395,744,5396,4739,657,35,205,248,452
"n2010646","2010646",4631,420,4211,1438,1162,1661,2759,3598,332,3266,1179,905,1200,2073
"n2010977","2010977",4228,276,3952,608,519,2831,3319,3015,231,2784,496,404,1890,2269
"n2010314","2010314",3405,1418,1987,781,581,609,1160,2465,1078,1387,556,388,415,796
"n4394245A","4394245A",530,32,498,11,76,416,477,347,25,322,7,47,265,305
"n4530250","4530250",4018,1428,2590,427,558,1573,2074,3234,1277,1957,336,421,1169,1551
"n4690034","4690034",2266,237,2029,5,332,1700,2011,1649,176,1473,3,253,1222,1458
"n4910346","4910346",1697,1457,240,28,16,161,172,1427,1253,174,16,14,107,116
"n190305","190305",3474,2543,931,37,52,712,754,2904,2207,697,28,41,521,554
"n292065B","292065B",226,49,177,8,27,143,164,151,39,112,1,17,94,107
"n293198","293198",1112,356,756,313,23,408,429,788,278,510,209,18,273,290
"n390029","390029",5486,1423,4063,1693,1374,1048,2354,3973,1080,2893,1203,990,693,1652
"n850177","850177",4417,2552,1865,597,662,518,1150,3755,2280,1475,458,508,404,901
"n1133033","1133033",1193,49,1144,9,606,539,1133,782,42,740,4,408,329,734
"n4530427","4530427",5999,2254,3745,375,973,2343,3251,5199,2116,3083,356,766,1891,2612
"n4530435","4530435",3251,1465,1786,147,228,1384,1585,2797,1351,1446,128,192,1091,1264
"n5070004","5070004",1487,182,1305,5,18,1287,1298,1075,149,926,4,9,915,922
"n2150167","2150167",811,149,662,17,6,639,643,639,121,518,14,3,500,501
"n2790012","2790012",354,249,105,3,5,96,99,243,180,63,0,1,59,60
"n3390071","3390071",6887,4754,2133,641,209,1131,1313,4845,3415,1430,431,139,750,875
"n3470043","3470043",2098,1291,807,20,257,470,722,1560,1052,508,14,163,282,442
"n4070001","4070001",4326,3275,1051,26,546,345,878,3541,2753,788,22,423,219,634
"n4393286","4393286",1431,992,439,266,60,69,121,985,738,247,143,30,36,63
"n1132513","1132513",4164,1737,2427,961,803,628,1415,3298,1443,1855,799,564,454,1015
"n1213133","1213133",7102,4033,3069,690,801,1450,2196,5446,3303,2143,511,544,955,1468
"n1573096","1573096",5898,1152,4746,1687,1944,1133,2995,4690,967,3723,1410,1441,854,2253
"n2010168","2010168",995,39,956,1,491,466,951,751,22,729,0,411,319,724
"n2010174","2010174",4731,2961,1770,844,242,633,853,3899,2551,1348,626,191,476,653
"n2010837","2010837",344,164,180,132,18,27,45,302,142,160,117,16,24,40
"n213018","213018",2682,1645,1037,30,135,803,919,1998,1344,654,10,98,482,574
"n294016","294016",4008,373,3635,36,119,3502,3581,3209,325,2884,26,79,2783,2836
"n390052","390052",4394,2482,1912,413,453,1013,1442,3250,1906,1344,308,329,665,986
"n610079","610079",6790,1028,5762,227,130,5415,5507,5023,916,4107,178,77,3839,3899
"n850200","850200",2517,1767,750,40,201,434,628,1868,1369,499,29,117,299,414
"n850077","850077",5229,2500,2729,1091,784,793,1541,3960,2014,1946,853,528,515,1021
"n2010151","2010151",1611,30,1581,22,662,902,1546,1204,28,1176,21,551,602,1146
"n2010814","2010814",4927,482,4445,841,2655,1010,3587,3410,391,3019,675,1672,708,2330
"n2150144","2150144",94,4,90,1,2,88,88,64,4,60,1,0,59,59
"n4090113","4090113",4160,1207,2953,117,85,2699,2763,2859,866,1993,82,49,1819,1860
"n4393367","4393367",2421,1785,636,110,128,341,461,1858,1425,433,85,91,210,297
"n4530460","4530460",6318,736,5582,74,683,4853,5451,4533,642,3891,55,490,3336,3781
"n1133056","1133056",2474,171,2303,15,1810,487,2277,2037,159,1878,11,1577,294,1859
"n1132404","1132404",4463,1033,3430,452,443,2511,2927,3334,920,2414,372,305,1704,2002
"n1212110","1212110",3770,1755,2015,762,329,850,1151,3001,1500,1501,606,237,582,805
"n1219203","1219203",0,0,0,0,0,0,0,0,0,0,0,0,0,0
"n1573046","1573046",4771,1787,2984,1731,506,750,1211,3780,1484,2296,1370,357,544,871
"n1573029","1573029",2380,1522,858,260,134,434,557,1939,1297,642,206,90,313,395
"n250017","250017",1839,421,1418,20,78,1309,1371,1377,341,1036,20,59,947,993
"n294039","294039",2551,89,2462,24,1157,1331,2406,1790,71,1719,13,903,818,1678
"n294208","294208",4,3,1,0,0,1,1,4,3,1,0,0,1,1
"n292020","292020",6861,230,6631,255,653,5766,6358,4614,166,4448,136,501,3831,4300
"n37004C","37004C",1816,622,1194,77,979,116,1087,1405,545,860,57,706,76,776
"n631001","631001",3187,1622,1565,21,491,998,1464,2319,1291,1028,17,364,598,953
"n2591030","2591030",385,289,96,2,13,70,82,270,225,45,2,0,34,34
"n2890005","2890005",617,562,55,2,10,30,40,492,457,35,0,4,21,25
"n3390029","3390029",7202,5548,1654,72,190,1109,1275,5258,4193,1065,52,117,694,803
"n3510010","3510010",602,559,43,3,18,19,35,475,448,27,2,8,12,20
"n4230036","4230036",6815,1518,5297,53,2835,2364,5158,5331,1391,3940,41,2217,1617,3820
"n4394044","4394044",6698,3848,2850,316,764,1651,2334,4613,2843,1770,207,473,977,1428
"n850054","850054",5677,2291,3386,1083,1011,1175,2138,4513,1969,2544,869,722,834,1540
"n1131720","1131720",4897,1635,3262,212,693,2326,2979,3786,1452,2334,135,515,1621,2119
"n1132223","1132223",2302,1817,485,200,29,183,206,1597,1279,318,119,21,124,144
"n1212087","1212087",6683,3153,3530,825,745,1829,2540,4998,2454,2544,616,533,1283,1790
"n2010714","2010714",1411,88,1323,9,32,1280,1304,974,76,898,7,23,871,889
"n2150044","2150044",7982,159,7823,15,19,7768,7781,4895,87,4808,12,8,4772,4779
"n294185","294185",8,0,8,0,2,6,8,3,0,3,0,2,1,3
"n294062","294062",1400,187,1213,6,302,913,1199,987,167,820,4,201,615,810
"n292043","292043",4270,136,4134,28,180,3940,4080,3160,106,3054,15,113,2925,3021
"n291082","291082",5691,817,4874,157,372,4397,4695,4204,694,3510,118,248,3140,3361
"n390006","390006",2398,1604,794,28,80,596,664,1786,1273,513,18,42,373,408
"n670016","670016",692,570,122,3,49,41,90,527,431,96,3,40,26,66
"n4393177","4393177",3323,2528,795,161,148,393,536,2664,2117,547,109,105,265,367
"n2630201","2630201",46,45,1,0,0,1,1,31,31,0,0,0,0,0
"n2850311","2850311",1375,951,424,7,71,347,397,1061,787,274,5,44,216,251
"n3390049","3390049",3240,2240,1000,198,86,618,692,2417,1770,647,124,57,401,455
"n3490304","3490304",1161,931,230,9,33,131,163,929,766,163,7,24,83,106
"n4010405","4010405",1808,1155,653,30,187,390,573,1345,911,434,22,126,249,371
"n4230013","4230013",2676,47,2629,8,1658,972,2611,1940,33,1907,2,1328,572,1893
"n850154","850154",1699,1258,441,60,88,250,324,1246,969,277,37,58,150,203
"n850031","850031",2619,1928,691,236,164,244,397,2005,1540,465,165,106,164,263
"n1132140","1132140",3776,299,3477,711,1041,1743,2749,2699,278,2421,456,810,1156,1948
"n1134625","1134625",4399,1437,2962,458,756,1754,2448,3457,1286,2171,383,554,1201,1718
"n1131743","1131743",6906,2357,4549,575,1495,2376,3830,5256,2031,3225,434,1108,1579,2671
"n2150190","2150190",1025,186,839,10,6,819,821,721,175,546,8,2,528,530
"n450003","450003",348,242,106,2,6,85,90,273,194,79,1,3,61,64
"n710009","710009",565,351,214,77,19,96,114,445,286,159,58,15,67,81
"n850014","850014",8369,1734,6635,5628,554,382,910,5905,1453,4452,3716,426,257,675
"n890304","890304",670,555,115,2,14,87,98,563,478,85,1,5,65,69
"n1134656","1134656",284,35,249,59,19,171,187,205,33,172,52,10,108,117
"n1133921","1133921",12272,3199,9073,95,2362,6530,8823,8336,2625,5711,59,1585,3955,5520
"n325004C","325004C",4168,829,3339,23,70,3209,3249,3100,718,2382,11,49,2288,2322
"n3550100","3550100",2165,450,1715,17,62,1631,1676,1605,388,1217,15,41,1156,1192
"n3950013","3950013",245,222,23,1,0,17,17,188,172,16,0,0,11,11
"n4250004","4250004",2368,1872,496,10,15,397,406,1796,1471,325,4,7,258,262
"n1211047","1211047",5933,2567,3366,385,1896,1007,2817,4139,1941,2198,260,1246,620,1834
"n1350203","1350203",7313,3984,3329,191,575,2469,2978,5809,3327,2482,165,423,1787,2184
"n2090330","2090330",413,227,186,12,24,137,156,338,194,144,10,20,101,117
"n2250012","2250012",171,132,39,0,11,17,27,139,113,26,0,5,10,15
"n2550014","2550014",1736,334,1402,18,47,1320,1360,1312,271,1041,9,34,985,1013
"n2930205","2930205",934,344,590,4,183,396,566,656,282,374,3,131,230,358
"n90003","90003",528,402,126,2,7,99,105,400,328,72,1,4,53,56
"n293020","293020",3332,2413,919,133,63,704,753,2725,2052,673,84,45,522,562
"n294145","294145",26,11,15,5,5,5,10,24,11,13,5,3,5,8
"n291156","291156",4222,1276,2946,228,485,2293,2673,2979,994,1985,152,295,1525,1776
"n950205","950205",293,166,127,3,4,115,118,256,157,99,3,3,89,91
"n1132099","1132099",4330,2819,1511,391,352,683,1011,4094,2757,1337,347,290,599,874
"n4530194","4530194",4066,1541,2525,1014,520,999,1458,3161,1276,1885,775,353,734,1056
"n467003C","467003C",6307,4858,1449,38,251,984,1220,4767,3809,958,31,165,621,782
"n2450086","2450086",2895,1245,1650,164,1261,234,1461,2302,1117,1185,124,888,163,1036
"n3030066","3030066",3202,2402,800,171,126,429,541,2658,2053,605,141,83,304,382
"n3390014","3390014",8970,3674,5296,192,385,4520,4857,6437,2890,3547,144,286,2956,3222
"n3530004","3530004",3426,1275,2151,38,357,1774,2069,2512,1025,1487,23,224,1222,1425
"n4391151","4391151",2565,687,1878,81,1365,411,1758,1916,598,1318,70,951,273,1220
"n4392726","4392726",3993,911,3082,835,1230,1013,2207,2986,758,2228,609,904,688,1576
"n1132042","1132042",3936,2923,1013,298,240,402,632,2961,2256,705,208,174,264,436
"n11332T1","11332T1",0,0,0,0,0,0,0,0,0,0,0,0,0,0
"n1470006","1470006",1005,882,123,6,20,55,73,770,683,87,5,12,30,41
"n1670428","1670428",4592,3635,957,54,52,688,731,3606,2924,682,39,25,483,506
"n2010569","2010569",8985,3995,4990,1832,1296,1762,2983,7904,3646,4258,1543,1085,1498,2541
"n2150230","2150230",1724,222,1502,99,33,1366,1393,1218,178,1040,64,23,947,968
"n1573127A","1573127A",4269,1127,3142,1963,728,450,1168,3360,914,2446,1546,546,331,870
"n2010812","2010812",0,0,0,0,0,0,0,0,0,0,0,0,0,0
"n50025","50025",3654,2568,1086,28,291,705,982,2755,2037,718,17,193,452,642
"n1211039","1211039",1669,420,1249,760,345,129,459,1038,270,768,461,214,71,281
"n390067","390067",5040,847,4193,956,2431,865,3212,3684,661,3023,661,1761,614,2329
"n850232","850232",5369,3017,2352,506,857,841,1678,3690,2175,1515,338,549,521,1065
"n3390009","3390009",2768,2047,721,39,279,309,564,2087,1599,488,29,190,179,368
"n1132008","1132008",1535,1285,250,97,32,82,105,1228,1036,192,73,24,56,79
"n2150222","2150222",10,1,9,0,1,9,9,7,1,6,0,0,6,6
"n370030","370030",3952,2778,1174,38,730,285,1004,3021,2162,859,27,539,181,714
"n4530403","4530403",3810,1503,2307,167,312,1786,2063,3312,1395,1917,142,249,1482,1714
"n3990001","3990001",2489,1413,1076,22,75,926,985,1886,1133,753,15,44,634,674
"n1211065","1211065",2262,1038,1224,56,341,770,1089,1717,872,845,35,239,517,749
"n2450041","2450041",276,205,71,4,3,56,59,218,162,56,4,3,46,49
"n3610022","3610022",1618,1456,162,11,12,98,110,1283,1153,130,8,11,80,91
"n1410134","1410134",2065,103,1962,13,16,1930,1937,1660,89,1571,12,8,1546,1550
"n2011144","2011144",2375,1587,788,178,111,447,538,1707,1197,510,125,77,265,330
"n1133031","1133031",2783,383,2400,17,410,1967,2360,1781,297,1484,6,282,1172,1448
"n2750201","2750201",278,218,60,6,8,45,52,207,182,25,1,2,19,21
"n1133074","1133074",2176,97,2079,8,279,1802,2062,1465,89,1376,3,184,1186,1362
"n2010209","2010209",10921,552,10369,156,3862,6482,10157,7079,413,6666,113,2571,4020,6503
"n670009","670009",1391,1001,390,13,271,45,312,1150,837,313,12,225,29,253
"n4690029","4690029",3463,2017,1446,152,196,1032,1215,2669,1678,991,115,130,694,821
"n2011101","2011101",1990,1178,812,533,75,182,251,1622,977,645,446,58,128,184
"n3550118","3550118",4492,876,3616,59,307,3252,3520,3546,772,2774,41,240,2469,2692
"n292181B","292181B",283,94,189,18,24,141,158,177,62,115,11,13,88,95
"n2010252","2010252",2915,42,2873,13,1932,937,2854,2218,39,2179,11,1585,582,2162
"n293035","293035",1186,468,718,164,74,489,550,977,426,551,121,51,378,425
"n4730417","4730417",0,0,0,0,0,0,0,0,0,0,0,0,0,0
"n1410091","1410091",1200,165,1035,26,113,916,1015,1052,149,903,14,105,789,885
"n1133112","1133112",74,10,64,9,45,17,57,48,8,40,8,26,11,34
"n790306","790306",559,217,342,5,8,332,338,411,178,233,4,4,228,231
"n4610001","4610001",637,425,212,10,21,180,195,458,317,141,9,19,118,132
"n4392618","4392618",84,37,47,3,37,6,43,47,21,26,0,24,1,25
"n2010166","2010166",2013,991,1022,137,135,743,857,1639,863,776,108,100,556,643
"n2650303","2650303",1719,1439,280,27,14,217,226,1565,1352,213,20,7,166,170
"n4391083","4391083",3061,169,2892,42,793,2080,2845,1994,135,1859,25,499,1344,1836
"n1214184","1214184",5623,4295,1328,172,275,708,970,4056,3179,877,110,188,451,636
"n467001D","467001D",2159,1781,378,14,45,215,260,1672,1388,284,9,23,163,186
"n4392450","4392450",4864,908,3956,1065,1439,1458,2843,3537,730,2807,803,971,1012,1957
"n2030022","2030022",3769,1090,2679,33,1633,984,2592,2826,930,1896,27,1191,650,1831
"n730023","730023",1340,1173,167,3,40,94,132,1025,921,104,1,20,58,78
"n610060","610060",2758,175,2583,9,16,2559,2566,1942,147,1795,9,10,1778,1785
"n2450018","2450018",2866,69,2797,17,2642,154,2779,1896,54,1842,14,1753,85,1829
"n2010123","2010123",2511,1317,1194,273,382,529,881,2336,1257,1079,250,354,455,788
"n4530236","4530236",6518,3840,2678,1137,297,1147,1395,5406,3240,2166,961,225,887,1091
"n2450061","2450061",3971,1297,2674,246,644,1803,2399,2950,1110,1840,185,466,1193,1628
"n1410031","1410031",4555,734,3821,192,215,3407,3582,3711,695,3016,167,185,2644,2802
"n292080","292080",2705,347,2358,12,117,2224,2320,2004,306,1698,7,78,1602,1667
"n1910402","1910402",319,180,139,3,15,121,135,241,157,84,1,12,71,82
"n3430303","3430303",1582,1275,307,12,121,116,236,1265,1043,222,7,100,68,168
"n4650013","4650013",2257,1283,974,98,174,718,842,1835,1082,753,85,132,518,626
"n2010063","2010063",3841,2347,1494,41,195,1174,1360,2985,1948,1037,30,138,798,930
"n2010892","2010892",2530,919,1611,207,735,627,1335,2286,873,1413,184,640,539,1160
"n1132005","1132005",1267,893,374,53,60,242,297,987,730,257,38,40,159,199
"n2010001","2010001",1979,1140,839,193,148,454,593,1644,959,685,157,118,369,482
"n291051","291051",3743,516,3227,21,85,3137,3195,2834,460,2374,18,54,2301,2344
"n2010998","2010998",24,0,24,5,6,14,19,9,0,9,5,2,2,4
"n1132316","1132316",2625,1254,1371,114,71,1143,1204,2152,1118,1034,89,55,849,899
"n1219101","1219101",0,0,0,0,0,0,0,0,0,0,0,0,0,0
"n1132116","1132116",323,233,90,29,17,27,44,322,232,90,29,17,27,44
"n4530353","4530353",4436,3483,953,261,114,494,597,3766,3035,731,191,89,375,462
"n1132607","1132607",16,7,9,1,1,8,8,9,7,2,1,1,1,1
"n1131715","1131715",4700,579,4121,38,244,3842,4055,3240,492,2748,33,170,2538,2695
"n510215","510215",910,547,363,6,63,256,311,669,420,249,5,30,182,209
"n2010806","2010806",5838,2365,3473,895,916,1630,2484,3896,1693,2203,588,574,1006,1543
"n410046","410046",830,296,534,6,66,450,515,627,261,366,6,51,300,350
"n4391607","4391607",0,0,0,0,0,0,0,0,0,0,0,0,0,0
"n4530425","4530425",5325,2342,2983,273,504,2200,2632,4731,2232,2499,247,450,1786,2175
"n2010935","2010935",6523,1472,5051,346,2543,2212,4646,4938,1318,3620,261,1804,1571,3306
"n291114","291114",296,11,285,2,5,280,283,183,10,173,2,5,168,171
"n610017","610017",12415,319,12096,33,32,12004,12022,8127,209,7918,24,21,7861,7875
"n1132094","1132094",2098,1139,959,182,413,355,746,1948,1112,836,167,343,299,641
"n1350312","1350312",2556,1113,1443,28,123,1243,1353,1871,882,989,16,95,828,920
"n1870204","1870204",3188,634,2554,65,285,2214,2451,2262,509,1753,46,170,1526,1676
"n2010869","2010869",1265,30,1235,33,656,567,1183,851,24,827,20,447,378,802
"n1890206","1890206",322,19,303,4,28,273,294,250,17,233,4,21,206,225
"n1350109","1350109",397,250,147,2,12,127,136,294,202,92,0,5,80,84
"n4392304","4392304",2844,1839,1005,299,294,338,621,2296,1572,724,226,211,214,422
"n2410021","2410021",2491,1240,1251,29,898,280,1174,1880,1006,874,23,623,191,810
"n3550076","3550076",1759,92,1667,5,33,1626,1647,1313,75,1238,1,29,1207,1227
"n3510007","3510007",237,197,40,2,31,2,32,194,159,35,2,26,1,27
"n292018","292018",1764,71,1693,14,24,1656,1666,1369,57,1312,10,18,1279,1289
"n2570034","2570034",4067,2282,1785,56,422,1205,1622,2952,1755,1197,42,325,745,1069
"n2310322","2310322",2395,1663,732,18,29,504,531,1834,1332,502,9,21,336,356
"n3650003","3650003",1824,1362,462,10,260,167,419,1337,1028,309,5,189,98,284
"n530017","530017",2566,2021,545,33,49,397,439,1981,1644,337,24,31,230,258
"n4530481","4530481",7888,1323,6565,158,794,5609,6297,5431,1119,4312,111,561,3612,4121
"n4391380","4391380",2569,1171,1398,113,762,506,1225,2165,1046,1119,97,608,390,973
"n4393040","4393040",4932,3515,1417,357,268,644,891,3931,2934,997,232,176,457,628
"n2490015","2490015",2609,322,2287,11,25,2260,2265,1877,271,1606,11,12,1588,1589
"n1391044","1391044",847,529,318,12,80,215,288,606,409,197,6,42,143,185
"n2010995","2010995",3698,263,3435,249,1456,1745,3183,2811,223,2588,229,1209,1164,2365
"n550300","550300",1865,376,1489,12,370,1109,1460,1524,334,1190,7,323,857,1164
"n4391749","4391749",0,0,0,0,0,0,0,0,0,0,0,0,0,0
"n3510004","3510004",197,137,60,1,45,6,51,149,121,28,1,20,3,23
"n1391001","1391001",3596,744,2852,29,1772,1019,2727,2443,550,1893,23,1209,613,1812
"n2010952","2010952",2034,186,1848,49,423,1406,1791,1192,134,1058,30,226,813,1024
"n4530422","4530422",6110,1931,4179,576,1415,2101,3450,5348,1678,3670,503,1204,1887,3046
"n3470032","3470032",4881,2951,1930,210,1109,547,1609,4108,2612,1496,163,858,412,1244
"n4710403A","4710403A",2237,1344,893,5,202,622,821,1728,1094,634,5,162,414,576
"n3610002","3610002",2618,961,1657,27,1273,327,1571,2091,818,1273,16,991,234,1211
"n1410028","1410028",591,14,577,3,12,573,576,493,9,484,1,7,480,483
"n610014","610014",6172,193,5979,23,17,5922,5932,4228,144,4084,15,8,4041,4047
"n4393364","4393364",1954,1015,939,158,397,353,732,1526,860,666,114,279,238,507
"n2850231","2850231",2076,1603,473,27,156,274,421,1633,1317,316,20,98,180,276
"n3390061","3390061",6462,4502,1960,683,207,938,1131,4790,3457,1333,456,144,628,769
"n2010826","2010826",582,319,263,98,30,128,154,383,231,152,62,12,72,82
"n4392225","4392225",7694,502,7192,292,2272,4641,6853,5104,426,4678,235,1475,2957,4401
"n2510033","2510033",5687,3572,2115,15,133,1786,1899,4033,2724,1309,12,92,1060,1146
"n2010272","2010272",6545,1582,4963,558,1577,2831,4303,5285,1414,3871,405,1248,2207,3379
"n2450038","2450038",3182,2522,660,96,77,419,482,2440,2026,414,61,49,240,284
"n1230401","1230401",3296,2055,1241,17,285,896,1154,2491,1672,819,11,185,574,745
"n1133054","1133054",2917,121,2796,16,2189,592,2763,2390,103,2287,14,1892,374,2257
"n4391291","4391291",3526,155,3371,18,1776,1593,3319,2491,123,2368,14,1405,945,2326
"n410109","410109",0,0,0,0,0,0,0,0,0,0,0,0,0,0
"n2610003","2610003",78,8,70,2,3,68,69,64,8,56,1,1,56,56
"n1133011","1133011",1924,1121,803,242,261,283,530,1854,1097,757,234,236,261,491
"n590005","590005",164,140,24,2,4,13,17,125,116,9,2,2,4,6
"n1750032","1750032",766,631,135,8,6,101,106,619,525,94,4,3,68,70
"n4530490","4530490",7086,1903,5183,135,813,4202,4930,4949,1598,3351,108,553,2648,3157
"n2010021","2010021",1685,560,1125,189,583,348,921,1481,531,950,162,511,269,773
"n4392360","4392360",5061,3378,1683,330,689,587,1239,3898,2734,1164,205,488,409,883
"n2010103","2010103",5438,1248,4190,547,1155,2499,3573,3638,883,2755,382,782,1579,2329
"n1391027","1391027",3658,2358,1300,63,493,668,1150,2791,1913,878,48,342,430,764
"n291154C","291154C",47,12,35,4,6,24,30,30,7,23,4,1,17,18
"n293015","293015",2876,767,2109,83,158,1893,2008,2197,675,1522,70,96,1362,1436
"n22904NW","22904NW",67,39,28,0,0,23,23,59,39,20,0,0,15,15
"n4391022","4391022",1654,917,737,35,143,507,638,1281,772,509,26,99,339,432
"n1132054","1132054",7401,1745,5656,512,1972,3144,5053,6039,1643,4396,456,1572,2327,3855
"n2011041","2011041",1439,173,1266,172,709,396,1093,1127,157,970,142,525,303,821
"n4530400","4530400",2501,1828,673,202,113,312,417,2451,1802,649,191,111,301,406
"n4530455","4530455",2829,1471,1358,222,173,969,1101,2336,1267,1069,180,120,755,848
"n3550059","3550059",2355,866,1489,65,98,1322,1396,1867,751,1116,47,70,979,1037
"n1870109","1870109",973,640,333,9,33,260,286,763,556,207,5,17,152,168
"n1131408","1131408",22,3,19,0,1,18,19,18,3,15,0,1,14,15
"n291136","291136",493,94,399,20,53,352,386,334,66,268,14,37,228,255
"n3550016","3550016",1521,577,944,66,28,838,861,995,390,605,45,17,542,556
"n292038","292038",1922,561,1361,28,86,1248,1312,1587,501,1086,24,62,1000,1048
"n4590004","4590004",1831,1413,418,14,168,159,322,1282,1020,262,10,128,79,207
"n2250001","2250001",1931,815,1116,21,635,414,1044,1461,690,771,15,450,265,715
"n291094","291094",6156,766,5390,229,690,4537,5110,3932,583,3349,170,396,2786,3137
"n291031","291031",3035,137,2898,16,53,2829,2867,2290,118,2172,12,37,2112,2143
"n1131738","1131738",6499,2269,4230,490,2030,1657,3597,5013,1991,3022,391,1412,1136,2501
"n2390009","2390009",797,595,202,15,19,142,158,642,501,141,11,15,96,109
"n4391207","4391207",4391,1832,2559,102,1441,969,2361,3330,1610,1720,69,957,631,1574
"n4290001","4290001",2014,1339,675,31,60,521,570,1536,1093,443,19,39,326,361
"n1131124","1131124",58,10,48,0,4,44,48,30,4,26,0,0,26,26
"n2450081","2450081",1139,14,1125,10,936,179,1110,834,10,824,8,708,107,813
"n1970001","1970001",881,612,269,16,54,200,242,695,509,186,11,36,128,161
"n3490301","3490301",657,258,399,12,90,248,331,491,227,264,7,53,163,215
"n270214","270214",7589,2757,4832,486,2570,1848,4180,5067,2020,3047,299,1522,1160,2580
"n4391437","4391437",975,400,575,73,153,343,486,759,354,405,56,121,215,332
"n1132505","1132505",3402,1880,1522,289,400,785,1162,2805,1625,1180,253,296,578,861
"n292163","292163",3676,1234,2442,270,236,1929,2127,2951,1045,1906,220,180,1472,1633
"n410066","410066",2192,1135,1057,149,272,607,844,1781,1009,772,113,203,418,611
"n467002B","467002B",2254,1947,307,10,31,189,218,1815,1601,214,8,24,111,135
"n1410011","1410011",5855,825,5030,195,179,4709,4831,4443,700,3743,143,108,3505,3592
"n2010146","2010146",3112,1655,1457,299,320,804,1113,2364,1341,1023,209,239,520,754
"n2510013","2510013",3720,2873,847,44,55,598,641,2941,2338,603,33,38,398,431
"n4393183","4393183",6598,2715,3883,1191,1130,1322,2378,4999,2246,2753,892,727,947,1634
"n1132138","1132138",4095,401,3694,410,890,2406,3268,2933,361,2572,258,700,1616,2302
"n2010978","2010978",385,119,266,34,30,203,225,269,105,164,26,18,120,138
"n2570014","2570014",5334,1959,3375,357,1656,1289,2903,3490,1385,2105,239,997,778,1765
"n4391676","4391676",674,273,401,15,140,238,366,525,233,292,14,102,166,264
"n1870408","1870408",3019,1711,1308,87,130,1034,1143,2144,1290,854,68,82,658,730
"n292100","292100",2282,288,1994,35,88,1882,1948,1671,251,1420,26,53,1333,1378
"n4530350","4530350",6883,3503,3380,1401,381,1476,1834,5567,3002,2565,1064,275,1120,1378
"n3430202","3430202",1340,1131,209,7,87,95,181,1087,953,134,5,56,55,111
"n1310001","1310001",2400,116,2284,18,20,1995,2001,1724,93,1631,14,13,1424,1430
"n2010889","2010889",355,153,202,24,87,97,171,326,148,178,23,70,87,148
"n291091","291091",4267,280,3987,65,108,3825,3894,3023,241,2782,44,78,2652,2711
"n4530394","4530394",4316,2578,1738,896,247,508,731,3171,1957,1214,675,152,308,454
"n4530452","4530452",4367,2046,2321,364,353,1564,1865,3202,1571,1631,264,238,1081,1289
"n2010932","2010932",0,0,0,0,0,0,0,0,0,0,0,0,0,0
"n490105","490105",2427,1839,588,21,93,426,503,1875,1479,396,18,43,285,324
"n1350309","1350309",2354,903,1451,27,160,1246,1386,1728,748,980,17,99,834,932
"n2450058","2450058",807,594,213,37,25,111,135,616,481,135,31,14,64,77
"n1132051","1132051",3538,2492,1046,148,236,596,808,2531,1849,682,101,162,381,530
"n3490205","3490205",1467,1236,231,12,27,146,173,1207,1066,141,7,17,88,105
"n1910301","1910301",187,113,74,1,15,49,62,138,82,56,0,13,37,49
"n4391491","4391491",20,8,12,0,6,9,12,13,8,5,0,3,4,5
"n3550036","3550036",1200,202,998,10,21,963,974,915,171,744,7,12,716,725
"n4392307","4392307",5112,2739,2373,653,885,737,1578,3915,2240,1675,457,620,487,1097
"n2010083","2010083",5966,1364,4602,363,1754,2480,4169,4278,1087,3191,277,1267,1627,2863
"n1410008","1410008",3282,1451,1831,55,47,1700,1724,2563,1196,1367,41,27,1261,1282
"n292015","292015",3683,107,3576,11,65,3529,3560,2652,75,2577,7,26,2546,2563
"n3550079","3550079",2018,180,1838,6,190,1646,1819,1451,158,1293,3,131,1153,1279
"n1410051","1410051",3788,915,2873,165,446,2328,2680,3042,827,2215,138,351,1740,2044
"n2010041","2010041",2770,740,2030,163,880,957,1808,1990,579,1411,109,635,627,1252
"n4392147","4392147",1945,1236,709,61,193,400,576,1531,1047,484,36,150,249,391
"n1132113","1132113",19,9,10,1,3,5,7,17,9,8,1,1,5,5
"n2011104","2011104",3965,1596,2369,576,617,1132,1717,2749,1135,1614,390,377,770,1142
"n610080","610080",5699,1527,4172,109,86,3941,4001,4231,1376,2855,89,47,2674,2712
"n2450101","2450101",14,10,4,0,1,3,4,14,10,4,0,1,3,4
"n410069","410069",5765,3965,1800,754,234,677,892,3756,2653,1103,501,139,376,503
"n291074","291074",52,3,49,0,0,48,48,37,3,34,0,0,34,34
"n4550019","4550019",1688,1196,492,11,134,314,448,1299,976,323,9,95,194,289
"n530014","530014",745,613,132,4,16,77,92,611,515,96,1,10,53,63
"n1214164","1214164",7172,4491,2681,381,610,1521,2087,5660,3707,1953,303,454,1051,1491
"n4391376","4391376",4116,1779,2337,3,1601,767,2333,4086,1779,2307,3,1577,761,2303
"n2570037","2570037",4112,1456,2656,72,1589,939,2495,2550,984,1566,52,947,531,1466
"n1132901","1132901",3666,1280,2386,366,774,1197,1925,3201,1189,2012,326,641,989,1590
"n2010975","2010975",264,115,149,5,52,93,144,202,92,110,5,41,65,105
"n1810410","1810410",3686,2536,1150,110,308,530,824,2920,2132,788,74,187,360,543
"n1131159","1131159",0,0,0,0,0,0,0,0,0,0,0,0,0,0
"n4530265","4530265",2959,1746,1213,282,239,654,863,2613,1568,1045,235,194,582,750
"n3390026","3390026",6826,2887,3939,82,239,3433,3643,4804,2287,2517,66,142,2151,2285
"n2010743","2010743",746,71,675,6,36,627,653,537,65,472,4,18,446,461
"n2330041","2330041",84,67,17,0,5,8,13,63,50,13,0,4,5,9
"n4391133","4391133",2985,1475,1510,39,162,1269,1415,2289,1257,1032,25,109,868,966
"n270401","270401",5169,1991,3178,295,1677,1185,2670,3778,1584,2194,216,1126,797,1808
"n1870227","1870227",943,549,394,4,48,322,364,751,474,277,1,34,223,254
"n292143","292143",3683,971,2712,143,359,2224,2507,2923,847,2076,102,283,1663,1906
"n1133034","1133034",2538,81,2457,15,1214,1248,2446,1826,76,1750,13,960,788,1741
"n37018A","37018A",130,92,38,3,28,3,31,101,65,36,2,27,3,30
"n230004","230004",871,715,156,7,20,102,121,645,559,86,2,9,55,64
"n3390063B","3390063B",73,64,9,0,0,5,5,61,53,8,0,0,4,4
"n2010829","2010829",125,60,65,10,23,41,53,94,47,47,9,15,28,37
"n292058","292058",4294,382,3912,27,63,3831,3874,3268,345,2923,18,39,2854,2890
"n1410157","1410157",960,23,937,7,8,922,930,724,18,706,3,3,698,701
"n4610004","4610004",811,284,527,5,28,477,501,593,244,349,1,18,311,328
"n590002","590002",2747,2266,481,32,83,245,324,2182,1845,337,28,60,165,221
"n2010189","2010189",2458,1668,790,228,73,459,517,1616,1139,477,119,44,299,335
"n1132202","1132202",2357,1968,389,181,32,134,165,1744,1478,266,117,18,99,117
"n2550009","2550009",231,140,91,3,4,84,87,192,127,65,2,1,60,61
"n2011061","2011061",5696,629,5067,170,3104,1836,4831,4125,543,3582,141,2159,1300,3402
"n4392536","4392536",2832,1174,1658,274,868,481,1328,2358,1046,1312,244,664,356,1012
"n430003","430003",488,270,218,3,1,204,204,414,245,169,3,0,159,159
"n1990017","1990017",1620,1474,146,10,18,65,80,1207,1110,97,10,9,37,45
"n4690009","4690009",1536,559,977,29,126,814,909,1136,457,679,23,87,553,628
"n610057","610057",653,35,618,8,11,598,605,481,33,448,8,5,432,437
"n1410094","1410094",4582,576,4006,44,155,3814,3931,3523,509,3014,32,113,2855,2948
"n1250002","1250002",173,132,41,2,2,35,36,123,101,22,2,2,16,17
"n292120","292120",4021,1193,2828,294,442,2155,2545,2745,862,1883,202,280,1406,1671
"n1132032","1132032",3859,1918,1941,662,532,691,1201,3556,1835,1721,594,473,597,1051
"n1391024","1391024",3398,2064,1334,47,197,983,1147,2499,1603,896,33,110,669,770
"n390061","390061",1448,873,575,58,31,453,475,1153,743,410,39,22,326,341
"n2010126","2010126",6344,4215,2129,217,233,1513,1730,4656,3239,1417,141,158,1001,1155
"n4590001","4590001",2360,1871,489,9,185,187,370,1825,1468,357,7,139,121,259
"n3550013","3550013",1497,40,1457,9,23,1442,1449,1147,33,1114,4,15,1104,1110
"n2010060","2010060",4209,2505,1704,521,262,872,1102,3674,2303,1371,421,200,694,882
"n292035","292035",1606,720,886,34,49,801,837,1425,664,761,27,38,690,720
"n1132312","1132312",470,77,393,21,36,335,366,380,64,316,21,35,260,291
"n4650012B","4650012B",432,24,408,1,5,402,406,290,24,266,1,5,260,264
"n3550056","3550056",2610,278,2332,35,188,2131,2271,1695,196,1499,20,88,1378,1452
"n2011038","2011038",4414,2193,2221,193,857,1120,1938,2920,1496,1424,108,580,699,1258
"n1430041","1430041",967,825,142,6,12,99,108,769,663,106,5,11,72,80
"n292077","292077",3297,1002,2295,107,202,1971,2139,2553,850,1703,81,144,1450,1579
"n1132604","1132604",5928,1623,4305,2358,1287,655,1887,4643,1440,3203,1791,896,487,1353
"n2070010","2070010",222,163,59,1,3,43,44,182,141,41,0,2,26,27
"n2450078","2450078",3044,810,2234,124,1525,568,2075,2203,676,1527,94,1021,390,1405
"n4391597","4391597",1419,98,1321,26,120,1176,1284,986,83,903,20,73,805,874
"n4790255","4790255",3733,233,3500,100,148,3275,3400,2886,198,2688,74,142,2490,2611
"n4530330","4530330",5551,3211,2340,575,298,1390,1639,4926,2968,1958,489,240,1154,1353
"n3670111","3670111",2412,1854,558,29,68,366,424,1796,1426,370,25,38,221,254
"n1410114","1410114",8012,423,7589,128,251,7261,7446,6015,346,5669,90,171,5428,5566
"n2011124","2011124",0,0,0,0,0,0,0,0,0,0,0,0,0,0
"n610100","610100",7120,339,6781,138,49,6591,6614,5137,268,4869,97,29,4739,4756
"n710004","710004",5771,4307,1464,181,272,822,1079,4134,3186,948,112,171,518,679
"n2710003","2710003",695,159,536,4,23,497,517,551,134,417,4,20,382,402
"n2010912","2010912",2824,805,2019,174,780,1030,1796,2127,714,1413,136,521,722,1236
"n1132028","1132028",5,0,5,2,0,3,3,3,0,3,2,0,1,1
"n1870224","1870224",275,30,245,0,15,234,243,199,23,176,0,11,166,174
"n2010955","2010955",5179,2981,2198,609,222,1281,1480,3355,1998,1357,352,157,802,945
"n3550098","3550098",2620,91,2529,42,216,2280,2481,1993,73,1920,35,193,1694,1875
"n1410071","1410071",2985,271,2714,23,38,2659,2682,2464,230,2234,15,27,2192,2210
"n1132221","1132221",4804,4251,553,226,26,183,205,3076,2767,309,116,15,118,130
"n1391047","1391047",576,345,231,11,19,179,197,420,274,146,8,12,113,124
"n2490012","2490012",3458,493,2965,25,29,2892,2910,2543,415,2128,16,15,2071,2081
"n1132133","1132133",352,151,201,8,114,78,189,290,151,139,8,69,61,127
"n3390102","3390102",5629,4088,1541,266,305,802,1091,4409,3361,1048,189,211,527,729
"n4391801","4391801",0,0,0,0,0,0,0,0,0,0,0,0,0,0
"n410089B","410089B",2,0,2,0,0,2,2,0,0,0,0,0,0,0
"n2010786","2010786",4029,351,3678,24,82,3583,3641,2863,317,2546,19,57,2470,2510
"n1310004","1310004",157,31,126,0,0,125,125,122,31,91,0,0,90,90
"n2510036","2510036",3253,1297,1956,35,153,1699,1834,2274,973,1301,26,98,1120,1214
"n4391514","4391514",0,0,0,0,0,0,0,0,0,0,0,0,0,0
"n4391679","4391679",0,0,0,0,0,0,0,0,0,0,0,0,0,0
"n4530210","4530210",2347,1928,419,120,22,221,241,1770,1485,285,67,15,155,169
"n3350002","3350002",3837,1362,2475,17,810,1651,2434,3401,1199,2202,13,750,1426,2168
"n2010849","2010849",4645,313,4332,195,403,3795,4105,3513,284,3229,172,316,2781,3029
"n2010106","2010106",865,110,755,12,27,714,737,613,91,522,7,21,490,509
"n2450104","2450104",81,59,22,1,8,13,21,72,59,13,0,3,10,13
"n3390082","3390082",5886,3530,2356,321,357,1550,1890,4510,2862,1648,251,274,1023,1292
"n291008","291008",2587,766,1821,67,139,1614,1721,2167,685,1482,51,100,1306,1392
"n410026","410026",5164,3324,1840,143,608,988,1554,4013,2723,1290,109,404,681,1071
"n3390043B","3390043B",16,8,8,0,1,6,7,10,3,7,0,1,5,6
"n1212102","1212102",11168,2879,8289,949,3722,3569,7141,8588,2575,6013,769,2641,2485,5044
"n4530302","4530302",4755,3631,1124,449,124,434,554,4570,3497,1073,430,120,418,536
"n292061","292061",2015,466,1549,364,165,1027,1166,1563,388,1175,279,117,775,881
"n4392229","4392229",3870,1940,1930,146,759,939,1663,2939,1617,1322,119,495,629,1103
"n1214206","1214206",3054,2548,506,126,61,209,262,2385,2030,355,82,39,151,185
"n490202","490202",2658,1611,1047,19,198,758,936,2040,1329,711,12,131,514,631
"n1132508","1132508",6795,2719,4076,1065,1091,1849,2902,5593,2380,3213,895,879,1352,2202
"n2011018","2011018",0,0,0,0,0,0,0,0,0,0,0,0,0,0
"n291071","291071",3394,579,2815,102,310,2452,2690,2480,477,2003,78,194,1719,1897
"n3470041","3470041",2116,808,1308,60,791,419,1193,1493,661,832,42,513,247,753
"n1131735","1131735",7684,3074,4610,2065,1022,1436,2415,6043,2666,3377,1570,726,979,1688
"n291133","291133",74,6,68,12,18,51,62,49,6,43,4,10,33,37
"n390041","390041",3187,1118,2069,804,734,517,1240,2367,864,1503,577,560,342,897
"n1391004","1391004",0,0,0,0,0,0,0,0,0,0,0,0,0,0
"n610037","610037",4675,114,4561,9,19,4536,4544,3254,80,3174,8,12,3157,3163
"n2011081","2011081",550,15,535,39,92,404,491,429,10,419,38,74,307,379
"n550303","550303",1799,610,1189,21,58,1091,1140,1312,516,796,13,39,722,759
"n2010044","2010044",3799,564,3235,70,229,2924,3140,2980,472,2508,50,187,2253,2432
"n3530002","3530002",1535,1021,514,4,82,391,460,1166,843,323,3,44,243,283
"n4392461","4392461",5779,738,5041,482,2056,2506,4494,4181,628,3553,408,1388,1728,3097
"n3290105","3290105",4000,1135,2865,132,207,2459,2629,2859,923,1936,98,141,1619,1750
"n1410177","1410177",828,268,560,27,18,511,525,708,256,452,17,16,415,427
"n2010018","2010018",1895,1010,885,439,147,264,398,1481,821,660,327,116,194,304
"n4770205","4770205",3852,2765,1087,138,493,401,875,3012,2322,690,106,317,228,539
"n4530375","4530375",4542,3712,830,173,90,429,503,3648,3075,573,128,58,282,337
"n2450015","2450015",2684,164,2520,100,1165,1265,2405,2025,133,1892,80,934,878,1801
"n4570013","4570013",1066,955,111,3,40,44,84,872,794,78,1,35,25,60
"n3550007","3550007",1361,106,1255,15,157,1108,1239,1014,86,928,11,100,827,916
"n4392217","4392217",7309,2174,5135,243,2039,2800,4763,5186,1816,3370,193,1344,1773,3075
"n2010989","2010989",23,0,23,2,11,12,22,7,0,7,1,3,4,6
"n2510027","2510027",3569,2889,680,29,104,438,532,2675,2216,459,25,74,270,342
"n2010054","2010054",2554,1658,896,243,117,502,606,2151,1448,703,186,88,401,481
"n1391021","1391021",2194,1491,703,12,97,531,624,1658,1169,489,8,75,355,429
"n4392353","4392353",2604,605,1999,181,692,1128,1788,1844,514,1330,143,460,711,1152
"n292071","292071",1711,41,1670,8,22,1650,1659,1252,32,1220,3,17,1206,1213
"n2010097","2010097",5131,3200,1931,76,458,1279,1709,3610,2317,1293,55,321,814,1127
"n1990014","1990014",1826,1555,271,10,59,117,176,1328,1142,186,8,41,71,112
"n4630012","4630012",4039,1117,2922,83,45,2782,2802,2917,957,1960,65,26,1849,1862
"n1410065","1410065",4815,1964,2851,274,1008,1447,2303,2915,1306,1609,151,535,809,1288
"n4530449","4530449",5628,2900,2728,226,385,2047,2380,4397,2442,1955,167,272,1442,1694
"n2010929","2010929",0,0,0,0,0,0,0,0,0,0,0,0,0,0
"n1133005","1133005",2012,1094,918,147,455,289,738,1831,1070,761,145,314,270,581
"n291130","291130",7,0,7,0,4,2,6,2,0,2,0,1,0,1
"n3550092B","3550092B",127,42,85,3,7,78,79,87,34,53,0,0,49,49
"n2011032","2011032",497,238,259,51,90,110,196,450,225,225,47,78,90,166
"n410083","410083",22,16,6,0,1,4,5,12,10,2,0,0,1,1
"n2490006","2490006",1809,191,1618,1,10,1421,1425,1348,141,1207,0,6,1061,1064
"n2450012","2450012",662,29,633,0,566,63,628,525,29,496,0,458,33,491
"n3390077","3390077",5280,4507,773,103,87,459,536,4506,3915,591,83,60,346,401
"n1131752","1131752",4952,1997,2955,943,790,1144,1886,3884,1687,2197,741,549,826,1354
"n4530291","4530291",1533,1110,423,192,36,174,208,1158,859,299,132,27,122,149
"n3390038","3390038",5101,4045,1056,155,164,557,715,3932,3226,706,106,107,363,467
"n390075","390075",5590,2779,2811,148,505,2096,2536,4206,2272,1934,95,351,1390,1715
"n2390003","2390003",2818,1862,956,49,143,685,812,2154,1494,660,31,100,459,554
"n270205","270205",9149,2175,6974,489,3845,2703,6212,6646,1820,4826,370,2630,1764,4233
"n291002","291002",1039,171,868,67,107,711,803,777,141,636,52,85,504,578
"n1212073","1212073",6419,4102,2317,378,637,1122,1715,4966,3360,1606,258,444,762,1178
"n2010843","2010843",2620,209,2411,76,824,1554,2340,1970,179,1791,56,688,1075,1736
"n4391076","4391076",1454,1133,321,49,104,150,249,1117,887,230,29,82,107,184
"n4391188","4391188",949,43,906,4,591,304,890,724,37,687,2,468,205,672
"n1131301","1131301",5809,1322,4487,131,1046,3322,4301,4205,1161,3044,99,738,2174,2890
"n390012","390012",5826,2382,3444,357,475,2553,2990,4289,1941,2348,237,316,1736,2039
"n4530391","4530391",4437,3142,1295,570,106,540,636,2886,2107,779,344,69,317,384
"n3290408","3290408",3345,2622,723,121,67,460,521,2508,1990,518,90,39,334,373
"n291088","291088",1646,48,1598,9,32,1567,1590,1241,44,1197,5,16,1177,1190
"n1132048","1132048",8044,3498,4546,561,1936,1981,3835,7069,3367,3702,511,1572,1542,3060
"n4270009","4270009",4347,36,4311,3,18,4297,4303,3115,30,3085,1,10,3074,3079
"n470004","470004",1751,129,1622,10,12,1603,1607,1227,103,1124,8,4,1110,1114
"n4530143","4530143",7037,1306,5731,405,2033,3360,5271,4936,1058,3878,287,1434,2175,3549
"n1131088","1131088",6607,617,5990,27,922,5094,5909,4669,577,4092,20,690,3418,4029
"n4391482","4391482",2393,171,2222,22,300,1924,2207,1599,136,1463,12,226,1230,1451
"n211001","211001",466,365,101,10,17,61,77,387,304,83,10,13,46,59
"n610094","610094",2733,103,2630,9,32,2605,2611,1866,74,1792,4,19,1781,1785
"n4530325","4530325",1463,576,887,702,18,125,142,969,388,581,460,11,80,91
"n410020","410020",12137,6609,5528,1437,816,3526,4014,11872,6517,5355,1393,784,3427,3889
"n2011075","2011075",0,0,0,0,0,0,0,0,0,0,0,0,0,0
"n2450098","2450098",1259,536,723,286,208,221,423,963,444,519,213,151,146,292
"n1870102","1870102",1571,894,677,23,105,555,641,1252,770,482,12,74,384,454
"n4391277","4391277",1943,992,951,81,523,301,810,1641,910,731,71,363,240,599
"n2010140","2010140",5214,1501,3713,542,2438,754,3139,4528,1431,3097,478,2038,600,2599
"n3490202","3490202",2743,294,2449,9,368,2023,2369,1855,229,1626,8,296,1282,1569
"n2010780","2010780",2093,182,1911,25,80,1800,1869,1442,147,1295,23,53,1208,1258
"n3550050","3550050",899,225,674,21,70,594,641,710,200,510,17,44,448,484
"n2450035","2450035",2049,1308,741,140,263,297,555,1692,1083,609,92,245,236,476
"n291025","291025",1416,85,1331,2,9,1323,1324,1005,53,952,2,6,944,945
"n1290301","1290301",401,319,82,5,29,30,56,315,261,54,3,14,21,34
"n3330004","3330004",981,741,240,11,14,177,185,805,624,181,7,11,129,135
"n1810201","1810201",5876,4019,1857,86,586,831,1393,4468,3262,1206,48,363,515,863
"n2011138","2011138",3090,304,2786,717,845,1247,2039,2178,221,1957,566,578,818,1367
"n1213136","1213136",2827,1488,1339,451,315,550,835,2115,1210,905,295,224,365,576
"n3390099","3390099",4812,3841,971,115,135,579,694,3646,3002,644,90,90,373,451
"n1870311","1870311",4711,2212,2499,225,496,1742,2162,3734,1897,1837,163,337,1267,1576
"n2290002","2290002",553,19,534,0,1,532,533,381,17,364,0,1,362,363
"n2570008","2570008",4388,1829,2559,84,671,1723,2363,3113,1474,1639,62,443,1054,1483
"n4391175","4391175",3312,1155,2157,784,689,632,1298,2397,891,1506,567,452,428,868
"n4392606","4392606",44,15,29,2,10,16,24,28,10,18,0,6,9,15
"n1134054","1134054",1501,35,1466,19,57,1400,1439,1079,30,1049,12,42,1001,1029
"n1572021","1572021",982,739,243,12,20,173,188,776,597,179,9,10,134,141
"n2150011","2150011",3259,63,3196,6,9,3161,3165,2287,46,2241,6,6,2224,2227
"n294092","294092",2571,1018,1553,66,419,1116,1463,1994,935,1059,51,278,717,983
"n1134523","1134523",653,188,465,65,267,131,395,521,171,350,46,210,88,296
"n4394493","4394493",2976,2080,896,228,167,429,585,2813,2009,804,206,141,385,520
"n4910391","4910391",2156,1722,434,59,62,265,318,1759,1442,317,39,47,183,227
"n4393570","4393570",5565,2995,2570,784,630,1010,1599,3969,2270,1699,521,417,650,1054
"n293107","293107",1322,795,527,42,34,430,457,1024,652,372,26,19,312,327
"n2150177","2150177",2114,111,2003,1,11,1990,1991,1431,86,1345,1,6,1334,1335
"n4910180","4910180",6939,3049,3890,420,1061,2334,3305,5278,2535,2743,329,696,1615,2276
"n2010473","2010473",2394,1613,781,148,111,430,535,1887,1352,535,101,75,280,354
"n4810103","4810103",4454,1878,2576,29,515,1996,2472,3349,1546,1803,24,400,1332,1715
"n3090033","3090033",2168,1459,709,68,224,383,585,1683,1228,455,49,134,235,366
"n4394191","4394191",2453,1136,1317,179,148,953,1077,1839,964,875,142,74,610,682
"n1574002","1574002",1025,75,950,16,435,496,924,794,61,733,9,367,351,717
"n2010281","2010281",3086,2123,963,450,177,306,469,2127,1493,634,281,123,199,317
"n2970010","2970010",499,313,186,3,4,162,165,404,261,143,3,0,128,128
"n4010302","4010302",1904,708,1196,16,782,384,1149,1370,564,806,13,540,232,770
"n3030050","3030050",6437,629,5808,1799,3576,139,3713,6183,605,5578,1725,3431,134,3563
"n4490016","4490016",4283,2230,2053,53,463,1500,1943,3186,1862,1324,34,330,916,1238
"n2010576","2010576",4225,239,3986,55,2639,1298,3899,3077,180,2897,45,1984,857,2829
"n3030128","3030128",2281,1773,508,38,55,368,417,1860,1516,344,26,37,240,277
"n70002","70002",5697,2818,2879,135,86,2439,2514,4461,2391,2070,109,51,1731,1774
"n4230009","4230009",782,111,671,10,208,450,651,535,84,451,6,159,277,435
"n325003A","325003A",1583,1048,535,8,18,487,496,1292,882,410,8,8,370,375
"n1571104","1571104",8139,4411,3728,1200,1084,1414,2443,6028,3487,2541,826,722,934,1625
"n294029","294029",4311,275,4036,53,565,3496,3990,3219,248,2971,35,445,2536,2935
"n2010344","2010344",2037,41,1996,12,893,1111,1973,1482,33,1449,8,707,738,1434
"n39304-1","39304-1",99,87,12,3,2,4,4,76,69,7,1,1,1,1
"n4910482","4910482",4901,3054,1847,1073,202,488,676,3231,2143,1088,620,131,291,420
"n3750326","3750326",5180,3273,1907,92,166,1456,1599,3930,2684,1246,69,96,920,1008
"n294132","294132",3569,890,2679,218,1312,1221,2430,2614,716,1898,157,938,824,1711
"n2150074","2150074",2342,190,2152,45,36,2100,2112,1542,148,1394,25,10,1369,1370
"n910305","910305",5794,3191,2603,149,234,2085,2271,4148,2362,1786,107,146,1420,1535
"n2150200","2150200",3303,378,2925,165,62,2691,2745,2510,325,2185,133,50,1982,2028
"n10007","10007",2928,493,2435,35,1122,1274,2354,2048,379,1669,30,773,845,1601
"n4850107","4850107",5635,3719,1916,227,763,782,1480,4477,3110,1367,177,536,528,1027
"n4410104","4410104",3281,2639,642,59,146,370,505,2535,2113,422,45,91,229,315
"n970012","970012",1448,1236,212,8,9,119,128,1114,976,138,2,6,69,75
"n1590201","1590201",806,659,147,7,16,91,107,606,506,100,6,5,61,66
"n1670278","1670278",5415,4138,1277,31,60,973,1023,4228,3337,891,21,29,668,696
"n3730016","3730016",3982,2806,1176,60,260,753,994,3008,2219,789,42,165,488,645
"n3790306","3790306",1743,1320,423,20,120,218,336,1376,1064,312,16,94,147,241
"n4890005","4890005",1239,69,1170,3,4,1165,1165,925,63,862,1,1,857,857
"n1650009","1650009",1940,1163,777,18,26,718,738,1246,734,512,14,13,471,482
"n4910381","4910381",3122,2968,154,16,10,74,83,3105,2968,137,16,5,69,74
"n2150114","2150114",6486,1172,5314,123,75,5162,5179,4723,1086,3637,108,47,3504,3519
"n293168","293168",795,283,512,176,52,289,334,603,222,381,135,38,208,245
"n294089","294089",5797,1871,3926,409,1134,2388,3393,4150,1501,2649,282,746,1567,2252
"n2150031","2150031",4145,318,3827,55,35,3750,3770,2882,294,2588,39,30,2527,2546
"n1134520","1134520",2242,340,1902,81,191,1628,1792,1599,279,1320,65,127,1111,1224
"n3850005","3850005",546,403,143,4,16,111,126,443,343,100,3,7,76,83
"n50023","50023",1210,924,286,17,66,174,238,879,699,180,12,35,108,143
"n1572081","1572081",2626,312,2314,346,1002,986,1956,1933,270,1663,280,697,695,1377
"n4450402","4450402",405,284,121,0,0,118,118,260,191,69,0,0,66,66
"n850124","850124",6341,2267,4074,2943,493,510,993,4853,2003,2850,2023,357,367,718
"n1131068","1131068",130,47,83,4,5,76,78,91,41,50,2,3,48,48
"n3130202","3130202",2872,1737,1135,30,425,625,1047,2160,1401,759,27,295,396,688
"n397004E","397004E",4389,2284,2105,177,509,1346,1825,3123,1710,1413,108,339,881,1214
"n3030138","3030138",707,490,217,15,20,153,166,532,376,156,11,12,111,119
"n475004E","475004E",2264,841,1423,17,92,1297,1368,1702,686,1016,8,64,925,979
"n1134072","1134072",791,49,742,9,55,676,717,545,42,503,4,29,455,484
"n2250002","2250002",2021,1263,758,12,456,262,711,1637,1079,558,8,374,152,523
"n850210","850210",2464,979,1485,1090,192,173,360,1671,701,970,698,139,109,245
"n4910279","4910279",172,91,81,22,16,39,55,137,75,62,21,13,28,41
"n3030046","3030046",4613,3127,1486,30,50,1263,1298,3204,2245,959,21,18,803,819
"n2190043","2190043",441,266,175,4,11,147,157,332,213,119,3,9,96,105
"n4394202","4394202",3950,1169,2781,42,73,2624,2687,2896,1002,1894,32,43,1776,1816
"n294046","294046",3955,1925,2030,219,616,1186,1725,3346,1752,1594,178,450,940,1345
"n2010470","2010470",2728,1284,1444,47,94,1242,1326,1973,1038,935,30,66,781,844
"n4190008","4190008",1830,869,961,8,454,483,932,1330,700,630,5,315,290,605
"n294135","294135",0,0,0,0,0,0,0,0,0,0,0,0,0,0
"n21301MN","21301MN",1943,1627,316,14,87,119,201,1622,1366,256,10,73,84,157
"n1410186","1410186",1272,194,1078,27,95,972,1043,965,177,788,18,64,701,760
"n2010642","2010642",2465,1585,880,185,184,482,637,2048,1406,642,139,134,326,452
"n250001","250001",3209,1050,2159,52,101,1973,2065,2467,898,1569,47,66,1427,1491
"n4050002","4050002",411,196,215,9,181,32,207,347,170,177,6,147,25,169
"n1133961","1133961",4215,1794,2421,396,845,1081,1899,3025,1413,1612,273,546,690,1224
"n1810301","1810301",4463,2760,1703,375,613,544,1137,3392,2245,1147,233,411,363,770
"n3650018","3650018",2457,2069,388,11,219,83,296,1935,1639,296,9,172,46,216
"n1573065A","1573065A",8491,2012,6479,4755,1050,673,1682,6403,1601,4802,3526,791,457,1225
"n2010559","2010559",13317,1900,11417,1201,6322,4093,10080,10593,1697,8896,1015,4901,3081,7759
"n110401","110401",196,156,40,2,10,24,30,155,130,25,1,5,14,16
"n850041","850041",5387,3234,2153,756,579,702,1243,3667,2321,1346,490,355,406,748
"n1430020","1430020",2451,1291,1160,16,35,1076,1102,1762,1050,712,6,24,650,667
"n830003","830003",1877,1367,510,19,62,381,437,1452,1119,333,13,36,236,269
"n3090016","3090016",4424,2260,2164,309,730,1040,1728,3323,1838,1485,239,485,678,1147
"n2010516","2010516",4690,1130,3560,703,1292,1562,2802,3583,1011,2572,550,920,1071,1962
"n2010490","2010490",3868,855,3013,264,1601,1185,2710,2974,754,2220,211,1181,835,1977
"n3050009","3050009",101,65,36,2,1,34,35,62,40,22,1,0,21,21
"n4394065","4394065",5963,4258,1705,166,239,1128,1348,4635,3462,1173,124,172,722,888
"n4930415","4930415",4623,3044,1579,69,157,1213,1355,3349,2257,1092,51,130,821,944
"n1750041","1750041",450,367,83,1,11,64,72,366,301,65,0,11,47,55
"n850167","850167",7404,2802,4602,3346,643,533,1154,5460,2199,3261,2352,457,386,828
"n1530002","1530002",1331,631,700,14,46,644,676,1013,540,473,5,29,442,462
"n1134554","1134554",142,13,129,3,55,69,124,96,13,83,1,37,43,80
"n2010427","2010427",4461,405,4056,444,752,2915,3597,3300,341,2959,360,579,2063,2589
"n4230029","4230029",3044,2107,937,35,495,358,841,2247,1618,629,27,334,223,556
"n4790278","4790278",34,8,26,0,0,26,26,33,8,25,0,0,25,25
"n294152","294152",3707,922,2785,89,802,1948,2631,2748,802,1946,64,545,1321,1821
"n850104","850104",5905,1670,4235,433,2133,1626,3693,4686,1463,3223,341,1616,1207,2791
"n1134119","1134119",3,0,3,0,0,2,2,0,0,0,0,0,0,0
"n3090078","3090078",5531,3568,1963,64,384,1379,1740,4164,2842,1322,45,258,909,1161
"n4394397","4394397",833,340,493,8,23,445,463,647,316,331,8,18,284,301
"n1670398","1670398",1027,294,733,33,179,509,674,770,241,529,20,151,349,490
"n1134621","1134621",8997,1396,7601,2143,2702,2714,5325,6523,1155,5368,1430,1945,1959,3846
"n2010364","2010364",4759,828,3931,171,368,3367,3699,3514,744,2770,135,247,2366,2594
"n2310101","2310101",1788,1343,445,8,87,256,334,1327,1070,257,2,44,131,172
"n5050001","5050001",3037,127,2910,9,9,2891,2897,2193,114,2079,6,3,2066,2069
"n4394253","4394253",987,675,312,27,74,195,268,935,656,279,26,65,172,236
"n2050301","2050301",1151,861,290,12,17,246,258,867,678,189,10,12,158,166
"n4394686","4394686",0,0,0,0,0,0,0,0,0,0,0,0,0,0
"n2150157","2150157",2605,54,2551,0,2,2544,2545,1829,38,1791,0,1,1789,1789
"n293127","293127",2822,1480,1342,374,141,828,939,1961,1098,863,225,101,520,606
"n1131125","1131125",5595,1052,4543,174,2225,2141,4308,4187,941,3246,127,1608,1494,3072
"n4530234","4530234",4187,2705,1482,710,120,608,713,3457,2276,1181,587,90,463,543
"n2010761","2010761",2262,1616,646,282,73,266,332,1723,1273,450,200,49,184,229
"n390036","390036",3877,1166,2711,140,166,2360,2500,2710,956,1754,95,123,1492,1603
"n1810205","1810205",5439,4485,954,48,109,372,469,4370,3744,626,34,63,221,281
"n3390001","3390001",4368,1856,2512,86,579,1763,2296,3075,1419,1656,61,351,1141,1486
"n270209","270209",6763,2458,4305,694,2291,1338,3444,4582,1709,2873,464,1561,823,2282
"n2270046","2270046",2280,841,1439,29,168,1245,1370,1591,640,951,22,87,819,889
"n2010718","2010718",4969,2622,2347,1179,242,869,1099,3815,2082,1733,884,175,609,781
"n4350101","4350101",812,163,649,7,3,635,638,599,144,455,5,0,446,446
"n1214182","1214182",171,134,37,9,6,15,18,131,108,23,4,0,10,10
"n1212097","1212097",6409,3107,3302,1483,838,926,1721,4954,2516,2438,1138,590,658,1227
"n3390042","3390042",1629,1033,596,36,29,490,513,1248,854,394,29,21,316,332
"n2010804","2010804",9102,2580,6522,1377,1645,3454,5025,6764,2093,4671,1068,1102,2439,3508
"n2230025","2230025",592,461,131,0,15,91,106,480,385,95,0,8,65,73
"n4230075","4230075",4034,3563,471,47,105,242,340,3313,3021,292,31,62,136,197
"n4530300","4530300",2956,1854,1102,400,170,484,642,2800,1787,1013,376,151,447,588
"n1213140","1213140",6021,3635,2386,1625,191,450,623,4132,2602,1530,1035,131,274,392
"n4530121","4530121",4435,508,3927,92,1675,2207,3816,3008,431,2577,67,1139,1374,2496
"n4391377","4391377",6849,3210,3639,418,2052,1157,3129,5559,2834,2725,318,1494,861,2318
"n410001","410001",3047,2232,815,45,142,486,616,2179,1626,553,27,100,334,428
"n1310002","1310002",1366,50,1316,10,8,1289,1295,1089,45,1044,3,2,1029,1030
"n3430203","3430203",1546,952,594,17,354,190,538,1189,777,412,11,251,118,367
"n4530395","4530395",3660,2654,1006,105,82,702,767,2994,2265,729,82,61,473,523
"n1131305","1131305",4116,773,3343,36,451,2851,3268,2831,663,2168,26,274,1847,2109
"n410088","410088",4329,2968,1361,228,304,743,1022,3709,2637,1072,197,219,574,784
"n1830016","1830016",7103,4723,2380,91,820,1309,2104,5314,3785,1529,66,542,802,1338
"n4391081","4391081",4168,1751,2417,856,1078,447,1522,4040,1656,2384,853,1072,440,1509
"n2010890","2010890",3511,2021,1490,216,587,632,1196,3206,1967,1239,198,469,514,965
"n2310320","2310320",4802,3686,1116,45,80,743,816,3738,3026,712,36,47,433,477
"n3270006","3270006",102,94,8,0,0,8,8,90,83,7,0,0,7,7
"n1910302","1910302",517,277,240,3,60,173,227,396,253,143,2,40,94,133
"n1350310","1350310",3193,967,2226,29,184,1968,2136,2241,798,1443,18,116,1268,1377
"n291092","291092",2744,135,2609,18,132,2474,2578,1736,100,1636,9,75,1550,1614
"n1870406","1870406",1687,1306,381,16,37,294,321,1313,1066,247,10,18,192,207
"n291049","291049",5228,379,4849,25,81,4745,4784,3916,318,3598,18,56,3526,3556
"n4530351","4530351",6208,3192,3016,971,238,1723,1938,4927,2669,2258,792,197,1196,1376
"n2010847","2010847",7037,649,6388,170,2509,3721,6161,4733,507,4226,136,1687,2397,4046
"n410044","410044",170,124,46,0,3,36,39,125,95,30,0,2,24,26
"n1810411","1810411",357,281,76,4,7,29,36,270,212,58,2,4,21,25
"n390019","390019",4802,1273,3529,23,507,2987,3449,3508,1060,2448,20,342,2071,2391
"n1131713","1131713",2766,797,1969,29,158,1737,1878,1999,689,1310,19,103,1139,1238
"n2390007","2390007",158,130,28,3,2,26,26,127,107,20,1,1,20,20
"n270108","270108",2482,1878,604,12,94,416,502,1870,1469,401,8,45,282,324
"n4530174","4530174",1526,749,777,171,214,362,562,1171,594,577,124,153,273,414
"n2010744","2010744",3130,1666,1464,344,322,755,1040,2416,1353,1063,271,219,519,722
"n1574173","1574173",1970,389,1581,632,538,392,917,1415,299,1116,471,347,276,619
"n130017","130017",3226,526,2700,5,34,2645,2666,2360,412,1948,3,13,1906,1916
"n325002A","325002A",1257,502,755,37,217,476,689,950,396,554,32,170,329,499
"n4230049","4230049",2011,1546,465,9,77,331,401,1444,1157,287,7,35,205,237
"n2150154","2150154",6207,242,5965,15,38,5915,5932,4279,194,4085,13,20,4050,4055
"n1134615","1134615",470,100,370,8,13,346,359,359,87,272,8,9,252,261
"n310401","310401",2934,2218,716,18,43,593,633,2400,1893,507,14,35,418,450
"n2210415","2210415",1237,830,407,11,152,215,357,817,597,220,8,75,123,194
"n3290305","3290305",4297,343,3954,84,1177,2714,3825,2881,256,2625,37,812,1765,2558
"n910302","910302",4180,2200,1980,46,154,1691,1829,3165,1822,1343,40,118,1122,1235
"n2270011","2270011",3081,739,2342,51,332,1958,2244,2258,604,1654,31,237,1350,1580
"n4410101","4410101",6315,3356,2959,109,843,1943,2692,4632,2746,1886,78,482,1217,1681
"n2010510","2010510",8083,2427,5656,634,2878,2177,4913,6554,2124,4430,503,2261,1674,3837
"n4530100","4530100",3863,1761,2102,209,819,1040,1819,3361,1612,1749,183,712,802,1495
"n1190003","1190003",765,507,258,13,132,87,209,553,391,162,7,94,36,126
"n1790004","1790004",898,757,141,2,12,101,112,709,615,94,1,8,67,75
"n2010616","2010616",4677,2380,2297,364,580,1297,1838,3563,1956,1607,285,394,866,1241
"n10004","10004",2306,2004,302,6,91,131,219,1821,1605,216,4,63,82,145
"n3090010","3090010",5334,573,4761,26,2491,2347,4689,3614,461,3153,13,1661,1498,3102
"n50020","50020",5324,654,4670,53,2374,2230,4555,3947,539,3408,43,1811,1521,3312
"n1670185","1670185",3993,2806,1187,230,350,540,876,3314,2420,894,188,245,386,626
"n2150217","2150217",610,8,602,1,0,601,601,422,8,414,1,0,413,413
"n3110003","3110003",151,116,35,2,3,32,34,122,92,30,2,3,27,29
"n2010573","2010573",3163,38,3125,40,2483,644,3080,2065,37,2028,31,1618,394,1988
"n3090072","3090072",1415,1028,387,5,126,214,336,1100,828,272,2,106,140,244
"n4090120","4090120",960,666,294,16,17,229,241,812,589,223,9,12,175,183
"n2010701","2010701",1780,200,1580,55,54,1482,1522,1292,177,1115,37,40,1048,1081
"n397004B","397004B",7129,4206,2923,169,720,1868,2550,5023,3103,1920,127,473,1196,1644
"n294172","294172",2498,877,1621,89,187,1345,1505,1939,723,1216,60,126,1004,1123
"n270402","270402",8273,2683,5590,514,2937,2139,4844,5701,2090,3611,316,1898,1354,3131
"n390062","390062",7585,2353,5232,654,2394,2173,4447,5454,1874,3580,473,1646,1424,3011
"n4070008","4070008",1651,1297,354,25,153,125,273,1358,1108,250,14,114,79,188
"n2450059","2450059",1730,36,1694,10,1556,139,1673,1225,23,1202,5,1120,83,1192
"n1132003","1132003",3329,2289,1040,251,212,524,726,2690,1920,770,177,157,394,544
"n1213123","1213123",9795,3327,6468,2022,2539,1727,4172,7961,2932,5029,1627,1899,1338,3183
"n1214224","1214224",2858,1803,1055,144,301,550,826,1912,1259,653,89,169,332,493
"n1131162","1131162",0,0,0,0,0,0,0,0,0,0,0,0,0,0
"n1870202","1870202",2313,422,1891,5,231,1672,1861,1652,331,1321,2,179,1140,1297
"n510207","510207",654,347,307,4,201,98,290,524,287,237,4,163,64,225
"n990310","990310",1187,918,269,5,27,206,233,967,786,181,4,19,135,154
"n1131113","1131113",605,20,585,2,164,416,578,427,17,410,1,118,289,406
"n4394649","4394649",5479,3077,2402,279,353,1677,1998,4032,2406,1626,200,240,1091,1317
"n4490009","4490009",893,525,368,4,108,214,315,649,412,237,2,72,126,198
"n1350104","1350104",5864,1751,4113,23,108,3909,3998,4182,1406,2776,11,73,2624,2686
"n410107","410107",507,406,101,6,27,58,83,418,342,76,5,22,38,58
"n2450036","2450036",2691,1974,717,82,157,420,569,2121,1631,490,53,104,262,366
"n4391434","4391434",0,0,0,0,0,0,0,0,0,0,0,0,0,0
"n4510434","4510434",2294,836,1458,46,131,1268,1368,1718,691,1027,28,78,886,955
"n1211034","1211034",1996,1054,942,330,308,275,564,1344,731,613,219,200,171,364
"n2010656","2010656",2004,65,1939,15,179,1757,1919,1264,55,1209,11,130,1072,1195
"n325001B","325001B",3404,2382,1022,26,37,891,914,2698,1998,700,14,19,623,635
"n1230302","1230302",1869,1048,821,1,88,713,786,1401,856,545,1,60,464,519
"n2010867","2010867",3222,266,2956,97,820,2050,2840,2267,236,2031,72,616,1351,1949
"n4391278","4391278",4178,636,3542,145,2764,640,3363,3176,586,2590,113,2025,441,2451
"n291154A","291154A",2873,936,1937,270,432,1240,1651,1993,685,1308,187,292,814,1097
"n1212077","1212077",6988,2110,4878,819,1251,2675,3868,4861,1626,3235,613,815,1681,2465
"n2010698","2010698",2795,57,2738,113,1539,1091,2608,1879,43,1836,87,1048,701,1743
"n370029","370029",555,475,80,1,10,33,42,452,392,60,0,9,16,25
"n3290302","3290302",8796,2259,6537,37,145,6238,6344,6210,1829,4381,21,82,4177,4245
"n1132134","1132134",2450,881,1569,223,555,765,1312,2149,847,1302,210,491,577,1064
"n130013","130013",4248,1795,2453,22,41,2313,2349,3080,1394,1686,17,23,1576,1598
"n4530260","4530260",3029,1834,1195,476,149,527,653,2657,1615,1042,410,128,466,579
"n390059","390059",3877,1204,2673,1223,973,487,1409,2729,898,1831,818,685,300,971
"n1131406","1131406",687,59,628,54,309,262,568,483,53,430,42,214,170,384
"n2330031","2330031",2291,1828,463,7,42,290,332,1722,1416,306,6,16,183,199
"n229003S","229003S",311,29,282,0,5,280,280,244,21,223,0,0,222,222
"n4930312","4930312",3541,2514,1027,53,74,803,866,2705,2006,699,31,55,522,573
"n3390059","3390059",2100,1622,478,167,46,222,268,1611,1270,341,123,35,155,190
"n4270013","4270013",6530,110,6420,6,13,6388,6395,4374,76,4298,3,13,4283,4290
"n4530331","4530331",2474,1559,915,96,117,663,765,2023,1350,673,85,80,474,545
"n1213120","1213120",4740,1750,2990,94,636,2197,2802,3427,1504,1923,76,402,1381,1771
"n1090001","1090001",533,72,461,10,9,441,446,440,62,378,6,5,363,365
"n1670389","1670389",1311,302,1009,34,406,536,932,929,238,691,19,304,335,632
"n1950007","1950007",56,47,9,0,0,8,8,49,44,5,0,0,5,5
"n294129","294129",206,71,135,2,3,126,129,174,66,108,2,3,99,102
"n1870225","1870225",39,9,30,1,1,29,30,32,9,23,0,1,22,23
"n291029","291029",3653,138,3515,27,100,3402,3476,2761,107,2654,23,67,2571,2619
"n4391603","4391603",4,0,4,1,1,1,2,0,0,0,0,0,0,0
"n3090030","3090030",3654,1601,2053,49,715,1286,1931,2721,1359,1362,33,477,814,1264
"n4230006","4230006",1406,1004,402,9,109,236,337,1100,848,252,6,74,133,204
"n4910471","4910471",447,263,184,3,11,167,175,334,208,126,1,4,116,118
"n3390043C","3390043C",8,1,7,3,1,2,3,7,1,6,3,0,2,2
"n4030007","4030007",255,112,143,1,124,5,127,189,90,99,1,87,3,90
"n1131043","1131043",4318,2080,2238,451,897,851,1723,3195,1700,1495,268,614,571,1169
"n270212","270212",1558,912,646,107,218,274,477,1249,777,472,71,157,198,348
"n4530151B","4530151B",0,0,0,0,0,0,0,0,0,0,0,0,0,0
"n1710001","1710001",2653,2194,459,25,27,348,368,2200,1865,335,11,19,246,264
"n1131309","1131309",1407,88,1319,8,849,470,1301,993,86,907,8,561,335,889
"n4530237","4530237",3568,2555,1013,281,110,545,638,2955,2196,759,204,81,424,489
"n2150197","2150197",6620,69,6551,18,17,6529,6532,3734,42,3692,8,12,3672,3675
"n211008","211008",1803,951,852,67,99,616,708,1479,840,639,48,72,447,519
"n294192","294192",2,1,1,0,0,1,1,1,1,0,0,0,0,0
"n1650005","1650005",340,210,130,1,2,122,123,244,156,88,1,0,84,84
"n1131095","1131095",3529,166,3363,3,421,2939,3342,2459,153,2306,3,336,1963,2288
"n291009","291009",3048,727,2321,150,358,1846,2134,2077,538,1539,108,220,1201,1400
"n2150091","2150091",2053,73,1980,3,1,1967,1967,1443,62,1381,2,1,1375,1375
"n1670275","1670275",413,363,50,4,3,29,30,384,341,43,3,2,24,25
"n294149","294149",1085,228,857,25,96,741,813,829,200,629,16,58,542,590
"n1134639","1134639",2548,339,2209,194,372,1626,1971,1782,288,1494,141,243,1094,1322
"n970008","970008",1456,1173,283,4,26,158,181,1131,934,197,4,17,98,113
"n291072","291072",3382,552,2830,126,535,2227,2693,2611,471,2140,104,392,1654,2016
"n4230079","4230079",5649,3984,1665,106,884,526,1389,4099,3000,1099,73,567,339,898
"n49902-2","49902-2",6080,4369,1711,39,305,1182,1461,4688,3564,1124,24,189,759,940
"n1214165","1214165",12019,4769,7250,381,3633,3170,6641,9406,4195,5211,310,2549,2217,4708
"n4150008","4150008",1646,878,768,18,80,653,718,1170,701,469,11,47,391,433
"n223003A","223003A",2945,2042,903,37,264,547,793,2332,1718,614,32,177,356,526
"n4910372","4910372",6822,3808,3014,1710,327,821,1130,4585,2775,1810,997,224,508,719
"n1211014","1211014",4128,2030,2098,191,976,883,1817,2951,1572,1379,147,611,570,1167
"n1870106","1870106",5108,2774,2334,135,271,1861,2078,4031,2350,1681,100,179,1320,1478
"n1132052","1132052",1684,1346,338,97,59,136,190,1287,1065,222,74,26,76,100
"n370009","370009",4844,2510,2334,71,1390,723,2089,3616,2019,1597,40,998,438,1426
"n2450016","2450016",1141,70,1071,39,372,654,1018,815,58,757,35,266,446,708
"n4391019","4391019",2162,265,1897,14,205,1669,1860,1524,224,1300,14,166,1110,1264
"n4391199","4391199",424,288,136,22,46,55,101,369,261,108,19,44,35,79
"n390016","390016",4049,1986,2063,65,226,1699,1911,2913,1566,1347,48,140,1082,1221
"n329101A","329101A",31,7,24,2,2,14,15,21,5,16,2,1,6,7
"n2450079","2450079",2915,1437,1478,214,979,254,1210,2278,1280,998,169,635,154,779
"n110202","110202",119,108,11,2,2,3,4,101,92,9,2,2,3,4
"n1131736","1131736",2300,1355,945,231,290,388,665,1944,1240,704,184,230,260,484
"n2170001","2170001",2861,1686,1175,53,321,743,1053,2102,1347,755,32,199,467,663
"n1810208","1810208",2352,1832,520,18,180,212,382,1785,1440,345,12,119,133,246
"n1410006","1410006",3160,1035,2125,79,59,1987,2027,2360,850,1510,37,40,1416,1445
"n4550017","4550017",716,179,537,12,459,63,520,522,134,388,8,338,37,374
"n4090117","4090117",934,348,586,1,9,551,557,721,284,437,1,7,412,416
"n3510023","3510023",188,139,49,0,31,2,33,135,103,32,0,19,1,20
"n2010973","2010973",3304,1183,2121,212,200,1706,1887,2164,845,1319,127,122,1070,1182
"n3090091","3090091",2421,1912,509,53,144,256,387,1879,1553,326,33,92,157,243
"n2010593","2010593",9264,1239,8025,1650,866,5538,6312,6908,1077,5831,1289,620,3918,4489
"n2510012A","2510012A",4589,3462,1127,38,106,836,924,3388,2671,717,26,60,517,569
"n2010039","2010039",4889,3112,1777,631,304,794,1080,4375,2847,1528,527,262,678,928
"n4970011","4970011",957,795,162,4,9,119,127,753,649,104,4,6,68,74
"n4510225","4510225",119,111,8,0,0,5,5,99,91,8,0,0,5,5
"n1670460","1670460",4359,3444,915,153,104,543,642,3362,2713,649,123,68,369,435
"n294212","294212",7,1,6,0,0,4,4,7,1,6,0,0,4,4
"n294109","294109",2567,529,2038,154,843,1103,1877,1739,412,1327,109,547,695,1212
"n5030022","5030022",4509,3585,924,29,65,709,762,3462,2874,588,27,34,426,459
"n1211057","1211057",2134,693,1441,18,243,1157,1388,1379,513,866,13,148,678,823
"n90013","90013",189,179,10,1,3,1,4,152,146,6,1,0,1,1
"n850227","850227",6417,3417,3000,1349,743,824,1538,4385,2432,1953,878,467,524,982
"n2150237","2150237",1702,28,1674,5,2,1664,1664,1207,22,1185,3,0,1177,1177
"n970004","970004",476,399,77,2,6,49,55,380,327,53,2,5,30,35
"n4230026","4230026",3961,3094,867,27,406,317,719,3096,2481,615,18,285,211,494
"n1212100","1212100",8886,2451,6435,543,3535,2271,5677,7352,2251,5101,473,2766,1743,4437
"n329202A","329202A",6497,3544,2953,43,92,2652,2730,4449,2567,1882,30,42,1681,1718
"n4391672","4391672",0,0,0,0,0,0,0,0,0,0,0,0,0,0
"n3030076","3030076",3392,1799,1593,114,195,1231,1406,2502,1404,1098,77,144,823,958
"n4530450","4530450",6457,2991,3466,293,371,2745,3076,5403,2651,2752,226,301,2144,2420
"n1131116","1131116",3449,598,2851,30,124,2680,2784,2439,512,1927,24,80,1798,1874
"n2270105","2270105",1,0,1,0,0,1,1,0,0,0,0,0,0,0
"n2010636","2010636",3065,2368,697,52,85,446,530,2287,1808,479,32,68,290,357
"n1214185","1214185",1623,1527,96,15,20,41,61,1615,1523,92,15,20,38,58
"n1870205","1870205",2044,1069,975,11,68,863,920,1589,899,690,8,53,591,643
"n1830019","1830019",7183,1331,5852,112,3611,2109,5675,5497,1236,4261,102,2795,1339,4115
"n2010807","2010807",6420,661,5759,380,2714,2792,5346,4996,589,4407,307,2070,2104,4068
"n2010764","2010764",3887,1617,2270,194,907,1127,2002,2769,1208,1561,132,625,754,1371
"n1131716","1131716",3116,1832,1284,127,330,752,1069,2525,1632,893,101,243,489,728
"n3390004","3390004",3314,2003,1311,166,369,707,1061,2627,1681,946,127,258,490,739
"n1573112","1573112",2257,50,2207,11,69,2142,2189,1509,36,1473,11,44,1421,1457
"n2010870","2010870",0,0,0,0,0,0,0,0,0,0,0,0,0,0
"n294066","294066",5945,1178,4767,231,1894,2745,4460,4322,991,3331,185,1310,1853,3078
"n1132030","1132030",2597,2300,297,99,36,128,158,2010,1816,194,65,21,73,94
"n1750022","1750022",338,150,188,6,2,180,180,268,127,141,4,0,134,134
"n2010678","2010678",5221,246,4975,181,3245,1637,4777,3748,209,3539,127,2380,1082,3403
"n1131064","1131064",478,39,439,2,202,234,433,327,33,294,2,126,162,288
"n2310323","2310323",3876,3175,701,46,103,396,482,3060,2595,465,25,54,259,308
"n1134166","1134166",20,4,16,8,1,9,9,12,4,8,4,0,5,5
"n4530263","4530263",5515,2561,2954,1221,537,1160,1646,4558,2269,2289,943,402,908,1274
"n1214162B","1214162B",203,136,67,8,20,41,60,123,84,39,2,14,21,35
"n321001E","321001E",3332,965,2367,49,862,1468,2282,2332,798,1534,45,563,915,1462
"n270317","270317",7330,4465,2865,478,966,1302,2178,5390,3467,1923,323,651,826,1443
"n4190005","4190005",3156,2526,630,29,181,344,520,2419,1977,442,19,121,234,355
"n4430004C","4430004C",36,32,4,1,3,3,4,32,32,0,0,0,0,0
"n1810408","1810408",1465,1125,340,39,75,137,209,1189,955,234,28,56,79,135
"n4391127","4391127",2373,101,2272,39,1375,875,2233,1790,78,1712,32,1115,567,1679
"n2190033","2190033",191,121,70,1,4,65,68,125,89,36,1,2,32,34
"n37014A","37014A",2346,1271,1075,38,799,154,942,1734,1000,734,29,541,97,634
"n230002","230002",870,703,167,6,37,110,136,655,532,123,2,21,83,99
"n4350401","4350401",846,215,631,4,6,608,610,637,177,460,3,3,447,448
"n2250020","2250020",302,258,44,0,10,24,34,241,212,29,0,7,14,21
"n2430001","2430001",497,387,110,3,3,99,101,436,355,81,1,2,71,72
"n4530177","4530177",4851,2212,2639,511,648,1388,1992,3819,1891,1928,391,499,951,1425
"n2010741","2010741",4898,353,4545,183,1083,3329,4332,3411,283,3128,144,799,2209,2965
"n3390062","3390062",3547,2687,860,252,120,406,521,2784,2148,636,186,91,295,384
"n410047","410047",967,324,643,6,73,561,630,682,285,397,4,58,331,389
"n4530326","4530326",4100,3016,1084,591,58,352,404,2915,2199,716,380,41,222,261
"n4530423","4530423",5541,1023,4518,194,849,3487,4249,4180,919,3261,157,641,2478,3066
"n4230003","4230003",3538,2601,937,83,394,384,764,2785,2147,638,67,258,256,508
"n4530373","4530373",2734,2257,477,123,59,217,269,2299,1953,346,81,46,144,186
"n291112","291112",5079,726,4353,165,587,3679,4172,3509,573,2936,118,391,2452,2803
"n1132091","1132091",1459,817,642,59,81,472,539,1070,648,422,37,50,305,348
"n3390100","3390100",7308,4324,2984,487,1009,1300,2226,4739,2872,1867,307,648,780,1388
"n3510005","3510005",551,474,77,5,33,25,57,511,447,64,4,30,21,51
"n2010910","2010910",571,56,515,1,16,494,508,424,53,371,1,11,357,368
"n3470033","3470033",5006,3838,1168,185,486,374,848,4064,3202,862,134,352,264,615
"n4530150A","4530150A",6315,2548,3767,863,1108,1755,2761,4367,1883,2484,606,684,1149,1775
"n1690004","1690004",889,215,674,9,89,582,647,622,170,452,2,46,393,433
"n1131039","1131039",860,47,813,11,523,283,801,587,40,547,11,360,178,535
"n2210404","2210404",3669,2472,1197,25,46,1027,1068,2802,2036,766,20,28,642,668
"n4230046","4230046",1990,1083,907,31,302,522,814,1502,873,629,30,224,334,555
"n1890204","1890204",1732,305,1427,1,51,1350,1389,1204,266,938,1,33,881,909
"n1132026","1132026",3776,3205,571,229,70,234,294,3211,2795,416,164,49,169,210
"n2010784","2010784",1368,27,1341,2,880,463,1336,1050,26,1024,2,725,297,1019
"n2010827","2010827",4810,301,4509,31,137,4362,4468,3283,253,3030,20,84,2924,2997
"n410024","410024",3762,2138,1624,303,396,836,1205,3017,1818,1199,255,251,621,858
"n2150174","2150174",2320,25,2295,3,7,2283,2284,1523,18,1505,2,3,1497,1497
"n211005","211005",1829,1240,589,41,139,408,539,1462,1021,441,29,115,292,400
"n1131151","1131151",80,29,51,0,6,46,51,62,29,33,0,5,28,33
"n370012","370012",3020,2627,393,14,177,102,277,2313,2012,301,10,125,75,200
"n4391119","4391119",6315,1983,4332,385,2647,1313,3871,4853,1690,3163,275,1917,949,2825
"n1230402","1230402",1372,1154,218,4,28,171,198,1079,935,144,4,17,112,129
"n1790001","1790001",682,561,121,5,9,64,71,506,427,79,3,4,39,42
"n4391292","4391292",4292,620,3672,198,1534,1955,3446,3144,548,2596,150,1132,1303,2418
"n1211017","1211017",5094,2761,2333,681,889,641,1494,3351,1934,1417,414,557,356,894
"n1391002","1391002",168,132,36,2,0,26,26,135,113,22,1,0,15,15
"n2410019","2410019",2498,1740,758,24,527,157,681,1966,1438,528,17,380,89,468
"n3330011","3330011",285,235,50,2,15,28,39,201,180,21,0,5,12,14
"n2150257","2150257",829,13,816,4,2,809,810,651,13,638,3,2,632,633
"n2010659","2010659",4756,2678,2078,238,750,1005,1711,3582,2173,1409,151,527,656,1167
"n410004","410004",4399,329,4070,17,1815,2274,4041,3073,277,2796,5,1366,1433,2775
"n3090053A","3090053A",1891,1101,790,25,348,381,704,1642,996,646,21,269,318,576
"n1211037","1211037",3111,1257,1854,919,464,414,858,1972,839,1133,568,290,232,513
"n5011B","5011B",2025,1663,362,9,158,136,288,1463,1224,239,2,92,95,185
"n2010553","2010553",6610,1082,5528,864,1589,3092,4573,4840,907,3933,671,1123,2136,3207
"n1410040","1410040",1628,172,1456,10,38,1413,1437,1346,147,1199,6,27,1164,1186
"n3090047","3090047",723,337,386,15,129,219,343,467,258,209,10,77,111,185
"n4391264","4391264",2533,1497,1036,79,245,648,875,1941,1255,686,48,160,404,561
"n4394053","4394053",2223,1232,991,46,112,770,864,1688,1009,679,33,85,520,593
"n4394730","4394730",4445,2517,1928,362,533,963,1465,3221,1902,1319,257,351,651,983
"n4650022","4650022",5314,1214,4100,84,111,3906,3997,4254,1152,3102,60,91,2949,3026
"n1670168","1670168",12,1,11,4,0,8,8,12,1,11,4,0,8,8
"n1810402","1810402",4201,2984,1217,43,314,549,846,3256,2435,821,27,190,356,545
"n2010298","2010298",4199,1616,2583,481,713,1405,2045,3429,1399,2030,387,569,1077,1599
"n2110202","2110202",46,24,22,1,2,18,19,42,24,18,1,1,15,15
"n2410012","2410012",920,689,231,11,122,63,185,717,544,173,5,93,42,135
"n2510022","2510022",7854,4102,3752,179,486,2440,2835,5921,3301,2620,140,322,1721,1996
"n410097","410097",0,0,0,0,0,0,0,0,0,0,0,0,0,0
"n850158","850158",4428,1480,2948,1943,599,373,956,3218,1148,2070,1412,403,212,610
"n950306","950306",563,330,233,8,13,203,215,433,271,162,8,10,135,145
"n1133014","1133014",11621,1726,9895,71,1324,8482,9718,7392,1357,6035,48,885,5062,5909
"n1410140","1410140",4555,128,4427,3,48,4382,4405,3157,97,3060,0,24,3039,3052
"n1710013","1710013",2578,1976,602,11,18,511,524,2131,1712,419,9,11,343,353
"n2010398","2010398",8765,1816,6949,1016,1599,4351,5843,6447,1533,4914,798,1135,2976,4035
"n2490022","2490022",2886,194,2692,10,29,2631,2646,2098,154,1944,6,18,1897,1907
"n3090024","3090024",1408,809,599,5,375,202,565,973,631,342,3,237,91,321
"n3290202","3290202",4197,2830,1367,16,18,1260,1273,2745,1925,820,13,15,738,751
"n4394116","4394116",2603,2106,497,131,59,226,282,2252,1826,426,121,53,184,236
"n1810108","1810108",3432,2965,467,49,45,220,261,2524,2245,279,17,28,133,160
"n1870303","1870303",1911,1105,806,93,210,472,657,1530,931,599,67,169,322,478
"n2010447","2010447",6495,2861,3634,357,1487,1749,3151,4284,1973,2311,222,972,1075,2001
"n2010275","2010275",4578,227,4351,101,1721,2638,4212,3422,193,3229,87,1327,1878,3117
"n2010938","2010938",2207,72,2135,44,337,1745,2068,1453,55,1398,28,205,1145,1345
"n2010441","2010441",2380,1571,809,388,64,316,369,1744,1182,562,274,36,217,252
"n50038","50038",691,481,210,9,24,167,190,510,363,147,5,18,116,133
"n293124","293124",6704,2777,3927,542,958,2462,3314,5282,2355,2927,413,694,1793,2449
"n390033","390033",2857,1905,952,7,404,471,867,2308,1586,722,4,338,318,651
"n850181","850181",4165,2263,1902,124,612,1061,1646,2846,1685,1161,74,365,630,990
"n990207","990207",7920,4034,3886,439,1745,1485,3056,5968,3223,2745,322,1229,946,2101
"n1133951","1133951",4834,642,4192,53,3096,1057,4101,3429,534,2895,41,2183,654,2819
"n3030043","3030043",1094,699,395,12,22,357,372,800,541,259,5,6,241,247
"n3550104","3550104",1308,60,1248,2,23,1236,1241,919,52,867,1,14,858,861
"n3710002","3710002",3417,628,2789,34,61,2691,2720,2513,531,1982,26,29,1899,1920
"n4391715","4391715",1668,669,999,196,415,385,762,1250,550,700,142,288,251,516
"n4530116","4530116",6507,2163,4344,270,1021,3047,3979,5126,1919,3207,193,788,2177,2924
"n4910116B","4910116B",0,0,0,0,0,0,0,0,0,0,0,0,0,0
"n1391056","1391056",3409,2639,770,52,234,394,617,2532,2031,501,22,177,234,403
"n1770011","1770011",322,230,92,0,9,73,82,259,194,65,0,8,50,58
"n1890108","1890108",238,82,156,0,16,139,153,164,59,105,0,15,88,102
"n2011007","2011007",4844,482,4362,193,1943,2189,4051,3391,385,3006,152,1347,1448,2752
"n2010590","2010590",2732,2059,673,78,102,395,491,2053,1608,445,56,71,243,311
"n2250014","2250014",337,289,48,0,9,32,40,257,220,37,0,4,28,32
"n50011","50011",3071,2623,448,12,77,260,337,2371,2060,311,9,66,159,225
"n292166","292166",2268,687,1581,205,152,1234,1364,1826,592,1234,154,111,957,1057
"n1134086","1134086",6359,593,5766,129,881,4745,5586,4848,535,4313,100,646,3533,4157
"n1131106","1131106",610,21,589,4,108,476,584,429,21,408,3,94,312,406
"n1133616","1133616",1294,78,1216,8,762,454,1207,918,72,846,5,559,285,839
"n1219302","1219302",0,0,0,0,0,0,0,0,0,0,0,0,0,0
"n4790402","4790402",3303,70,3233,12,10,3218,3218,2301,53,2248,10,7,2239,2239
"n4790164","4790164",2484,60,2424,4,19,2406,2413,1726,47,1679,3,12,1667,1674
"n2370001","2370001",2845,1742,1103,19,287,767,1040,2395,1505,890,16,275,580,845
"n3030014","3030014",2809,1433,1376,55,188,1078,1244,2255,1266,989,50,127,757,876
"n4394629","4394629",0,0,0,0,0,0,0,0,0,0,0,0,0,0
"n4391621","4391621",424,96,328,15,212,103,310,293,69,224,14,145,66,206
"n4510351","4510351",481,360,121,3,9,87,95,374,303,71,3,4,45,49
"n4530144","4530144",3985,777,3208,124,999,2133,3040,2712,631,2081,91,610,1390,1963
"n1391030","1391030",3032,1894,1138,15,409,672,1070,2290,1496,794,12,304,435,729
"n1630004","1630004",1895,455,1440,16,10,1397,1405,1381,370,1011,9,9,983,990
"n2011107","2011107",553,107,446,9,87,353,431,361,84,277,5,55,214,266
"n2010567","2010567",11906,1050,10856,1096,2146,7668,9657,8694,888,7806,869,1644,5349,6880
"n2090203","2090203",5038,1796,3242,102,339,2724,3021,3730,1420,2310,68,230,1921,2136
"n2230016","2230016",1571,1308,263,8,25,157,182,1215,1046,169,5,6,100,106
"n130007","130007",3502,930,2572,17,51,2474,2506,2528,737,1791,6,34,1726,1751
"n291100","291100",4440,887,3553,221,450,2944,3314,3243,711,2532,157,334,2062,2356
"n292181E","292181E",146,15,131,30,31,79,105,78,7,71,13,13,43,56
"n1133083","1133083",3232,368,2864,8,452,2383,2830,2205,319,1886,6,349,1506,1855
"n1410120","1410120",4841,324,4517,47,138,4353,4444,3844,292,3552,33,95,3424,3496
"n1572118","1572118",11103,5405,5698,1741,2565,1243,3718,7320,3630,3690,1163,1673,732,2365
"n4550001","4550001",822,672,150,3,43,80,121,640,533,107,0,33,51,82
"n3290409","3290409",4575,2559,2016,151,352,1429,1747,3596,2103,1493,112,247,1068,1298
"n4230040","4230040",5091,4107,984,96,335,412,733,3863,3175,688,67,247,260,500
"n4394342","4394342",3200,2360,840,88,224,453,657,2482,1909,573,59,134,308,439
"n4391549","4391549",0,0,0,0,0,0,0,0,0,0,0,0,0,0
"n4393049","4393049",4034,3099,935,222,172,447,594,3131,2514,617,156,115,263,363
"n4530161","4530161",2954,1015,1939,401,670,844,1485,2261,838,1423,281,516,602,1098
"n1674322","1674322",0,0,0,0,0,0,0,0,0,0,0,0,0,0
"n1930012","1930012",225,198,27,2,5,8,13,180,163,17,1,4,5,9
"n2010212","2010212",3097,110,2987,18,279,2701,2952,2207,90,2117,16,234,1882,2093
"n2010461","2010461",7964,3785,4179,1890,949,1245,2154,6247,3244,3003,1304,727,893,1595
"n2010709","2010709",7824,2957,4867,1359,1403,2060,3375,5672,2241,3431,995,980,1408,2336
"n3030125","3030125",2939,1956,983,129,131,677,785,2298,1628,670,91,84,464,537
"n270203","270203",4727,3553,1174,79,111,844,942,3557,2780,777,55,86,535,613
"n530020","530020",6675,4172,2503,196,227,1866,2067,5127,3438,1689,143,147,1238,1371
"n910208C","910208C",22,14,8,3,3,2,4,15,14,1,0,0,1,1
"n1132613","1132613",9207,2122,7085,5188,977,843,1772,7099,1871,5228,3725,785,646,1407
"n1150017","1150017",160,82,78,3,0,74,74,119,66,53,2,0,50,50
"n1430012","1430012",1929,1565,364,47,47,230,271,1482,1249,233,26,32,146,175
"n3150009","3150009",600,475,125,6,60,27,84,491,403,88,3,45,21,64
"n3550124","3550124",4836,1659,3177,256,199,2685,2859,3822,1443,2379,207,142,1979,2109
"n3670340","3670340",1317,1135,182,13,10,117,126,934,832,102,5,6,62,68
"n4391074","4391074",2544,92,2452,10,438,2019,2426,1774,86,1688,4,331,1348,1664
"n4393554","4393554",3978,3022,956,330,145,355,493,2994,2337,657,224,94,230,323
"n4530313","4530313",3792,2049,1743,906,146,635,765,3412,1854,1558,821,117,572,676
"n1830010","1830010",9793,4441,5352,130,2489,2579,5001,7155,3589,3566,102,1632,1682,3284
"n1870116","1870116",4156,2277,1879,36,96,1648,1730,3309,1991,1318,21,62,1144,1203
"n2010318","2010318",6270,194,6076,104,3168,2827,5924,4620,171,4449,69,2501,1876,4350
"n2150145","2150145",2044,30,2014,5,4,2007,2009,1486,27,1459,2,3,1453,1455
"n2150194","2150194",3953,918,3035,7,22,3010,3017,3106,899,2207,5,14,2183,2190
"n2570023","2570023",2904,1487,1417,16,187,1139,1319,2119,1213,906,9,137,711,845
"n294166","294166",737,120,617,52,178,424,568,514,91,423,40,120,286,385
"n410035","410035",12318,7755,4563,1050,825,2443,3220,11360,7228,4132,979,745,2179,2889
"n990101","990101",9419,4678,4741,388,2302,1826,3926,6543,3559,2984,228,1450,1074,2453
"n1132011","1132011",2531,1926,605,226,65,272,331,1897,1515,382,136,33,175,207
"n1131086","1131086",1698,262,1436,24,442,975,1399,1159,235,924,18,293,605,891
"n1132122","1132122",3971,682,3289,378,1937,959,2878,2919,598,2321,296,1365,651,2003
"n4590013","4590013",952,692,260,6,161,60,214,755,546,209,3,129,50,173
"n4790465","4790465",1696,22,1674,8,3,1668,1670,1233,17,1216,6,3,1210,1212
"n507001A","507001A",1432,87,1345,14,21,1315,1325,956,69,887,11,11,870,875
"n2650314","2650314",4745,2232,2513,127,301,1991,2245,3698,1865,1833,90,216,1416,1619
"n2810004","2810004",1685,1303,382,36,47,248,290,1345,1092,253,17,34,161,190
"n3090004","3090004",147,85,62,1,22,37,54,136,85,51,1,18,27,43
"n3690202","3690202",515,232,283,5,8,274,277,360,184,176,4,6,168,171
"n4392658","4392658",1414,249,1165,71,479,650,1090,1000,217,783,52,304,438,729
"n4391420","4391420",0,0,0,0,0,0,0,0,0,0,0,0,0,0
"n1213131","1213131",7082,3569,3513,741,1186,1505,2647,5555,3054,2501,573,792,1057,1823
"n1391050","1391050",5728,2059,3669,97,2247,1272,3450,4022,1615,2407,62,1471,797,2243
"n1670386","1670386",3624,2265,1359,448,275,596,853,2463,1556,907,309,191,389,573
"n2010758","2010758",6906,4640,2266,698,333,1053,1361,4761,3296,1465,470,213,652,860
"n2011087","2011087",5729,1894,3835,951,1625,1231,2782,4787,1695,3092,743,1307,1007,2259
"n2150002","2150002",4317,429,3888,18,17,3864,3866,3183,413,2770,7,8,2756,2757
"n50017","50017",2127,1938,189,6,29,69,93,1769,1633,136,5,20,46,65
"n294229","294229",4933,555,4378,190,1123,3188,4138,3479,470,3009,134,760,2142,2823
"n292172","292172",669,132,537,31,36,489,517,487,105,382,15,26,347,366
"n730032","730032",1436,1119,317,9,101,170,270,1080,862,218,9,65,110,174
"n850038","850038",4698,1912,2786,1187,881,656,1482,3839,1711,2128,856,676,517,1166
"n1134001","1134001",3571,318,3253,49,110,3094,3189,2576,277,2299,37,89,2168,2246
"n2390001","2390001",3804,1801,2003,80,682,1240,1847,2859,1494,1365,47,427,847,1262
"n3390091","3390091",6245,4390,1855,87,227,1330,1542,4607,3358,1249,52,166,856,1018
"n4030004","4030004",318,299,19,0,6,7,12,250,239,11,0,1,4,5
"n4410205","4410205",7283,2981,4302,161,1396,2689,3940,5366,2439,2927,129,913,1764,2644
"n4510422","4510422",1607,1283,324,11,23,258,273,1238,1007,231,8,15,172,182
"n4790219","4790219",3193,118,3075,95,21,2971,2980,2329,96,2233,70,17,2159,2167
"n1391036","1391036",5459,3540,1919,121,677,967,1610,3777,2577,1200,65,417,583,995
"n2010069","2010069",3430,116,3314,43,61,3224,3265,2540,106,2434,34,42,2360,2392
"n2010695","2010695",5105,1618,3487,119,428,2924,3296,3531,1293,2238,75,241,1871,2103
"n2011150","2011150",0,0,0,0,0,0,0,0,0,0,0,0,0,0
"n2010155","2010155",7397,3387,4010,1668,388,1842,2216,5614,2674,2940,1311,285,1255,1532
"n2270034","2270034",2492,1421,1071,56,185,811,976,1968,1223,745,39,126,559,679
"n294123","294123",199,31,168,7,14,151,162,165,31,134,7,13,118,129
"n293081","293081",3356,1533,1823,161,361,1312,1603,2787,1395,1392,120,256,1003,1230
"n390070","390070",5478,1424,4054,1148,1761,1154,2844,3951,1081,2870,822,1247,780,1988
"n610020","610020",2301,220,2081,7,11,2056,2060,1675,174,1501,6,5,1481,1483
"n1134609","1134609",6371,595,5776,356,1170,4236,5348,4579,508,4071,290,918,2843,3723
"n1214173","1214173",32,11,21,2,8,6,14,25,9,16,2,4,5,9
"n49901-3","49901-3",2876,2485,391,17,35,230,258,2363,2084,279,11,19,159,173
"n3550062","3550062",1754,173,1581,10,66,1508,1560,1341,141,1200,7,53,1138,1187
"n3750222","3750222",5840,656,5184,2771,764,1683,2427,3945,535,3410,1927,378,1080,1449
"n411004A","411004A",1505,970,535,11,112,412,511,1302,852,450,10,111,331,430
"n4391238","4391238",5300,1320,3980,161,1684,2124,3758,3868,1154,2714,127,1140,1399,2522
"n4850301","4850301",1817,1001,816,34,326,432,727,1358,843,515,23,170,284,445
"n4970027","4970027",4841,3962,879,33,43,528,566,3773,3164,609,28,19,334,353
"n1410034","1410034",2331,264,2067,187,291,1613,1870,2115,245,1870,166,262,1458,1696
"n149101N","149101N",3300,1994,1306,15,368,900,1236,2487,1610,877,11,232,596,816
"n2010795","2010795",3143,207,2936,13,55,2867,2905,2311,186,2125,5,32,2082,2107
"n2011044","2011044",442,90,352,93,32,232,259,365,84,281,87,23,172,194
"n2090449","2090449",2890,2022,868,63,50,679,720,2085,1505,580,38,40,436,472
"n2150208","2150208",124,2,122,0,0,122,122,97,1,96,0,0,96,96
"n294023","294023",4053,707,3346,76,163,3135,3239,3074,630,2444,60,104,2273,2355
"n291043","291043",2774,277,2497,50,123,2338,2435,2088,252,1836,49,88,1705,1780
"n293185","293185",409,123,286,35,45,217,251,305,107,198,21,28,154,179
"n490316","490316",290,252,38,3,3,27,30,250,227,23,0,0,19,19
"n1133020","1133020",298,134,164,6,93,61,150,278,134,144,5,87,45,131
"n1211031","1211031",4925,1926,2999,951,1018,943,1928,3554,1523,2031,620,700,642,1325
"n4910369","4910369",5002,2545,2457,366,505,1544,1980,3581,1912,1669,257,324,1045,1326
"n323004B","323004B",4840,203,4637,45,33,4566,4583,3437,147,3290,34,22,3243,3254
"n3610028","3610028",4251,3628,623,98,47,349,390,3091,2690,401,57,26,224,246
"n3650012","3650012",526,447,79,4,35,33,66,407,355,52,3,27,17,44
"n4310003","4310003",331,231,100,3,4,91,94,247,178,69,0,2,65,66
"n4530413","4530413",3230,2191,1039,354,98,530,616,2724,1925,799,226,88,428,504
"n4910264","4910264",5698,2973,2725,270,345,2001,2308,4005,2217,1788,181,212,1282,1472
"n1212074","1212074",2769,2219,550,90,80,259,338,2187,1789,398,54,58,186,244
"n1410183","1410183",0,0,0,0,0,0,0,0,0,0,0,0,0,0
"n2010944","2010944",312,8,304,1,110,195,299,206,7,199,0,75,125,196
"n2010404","2010404",7134,1188,5946,105,315,5541,5785,5252,1071,4181,68,205,3886,4053
"n2010901","2010901",6555,1424,5131,573,2041,2535,4499,4561,1064,3497,413,1378,1683,3030
"n2150108","2150108",4110,150,3960,18,29,3914,3926,3044,100,2944,12,22,2914,2924
"n291142","291142",4503,560,3943,149,446,3435,3774,2954,418,2536,104,257,2202,2417
"n293038","293038",1553,572,981,44,48,872,910,1245,509,736,30,35,651,683
"n610063","610063",2346,188,2158,20,9,2128,2130,1805,163,1642,19,4,1616,1616
"n850095","850095",4495,2339,2156,887,617,568,1170,3253,1792,1461,633,403,372,766
"n1134511","1134511",5138,933,4205,61,457,3653,4069,3684,834,2850,52,341,2407,2732
"n1133115","1133115",3343,466,2877,77,1868,940,2768,2501,406,2095,66,1392,629,2005
"n3370008","3370008",1052,926,126,2,13,65,77,855,766,89,1,9,41,49
"n3550019","3550019",3149,2706,443,60,17,237,249,2772,2411,361,47,10,195,202
"n4391408","4391408",372,128,244,7,15,204,219,311,113,198,5,12,169,181
"n4392643","4392643",5954,1944,4010,594,2340,1064,3344,3905,1357,2548,379,1457,665,2099
"n4590007","4590007",4339,3193,1146,40,348,549,881,3249,2452,797,31,264,329,589
"n4790448","4790448",871,37,834,3,9,827,828,606,26,580,3,7,574,575
"n1571159","1571159",6829,1984,4845,2739,702,1337,2005,4259,1266,2993,1683,399,859,1240
"n1670357","1670357",6183,4461,1722,407,176,1042,1207,4681,3505,1176,280,116,695,801
"n2010752","2010752",3252,1109,2143,100,217,1825,2005,2440,946,1494,83,150,1251,1377
"n2010504","2010504",3003,2035,968,254,118,535,646,2442,1709,733,209,92,384,473
"n2150251","2150251",29,1,28,0,0,28,28,18,1,17,0,0,17,17
"n2450024","2450024",639,439,200,2,100,84,184,487,346,141,1,73,54,127
"n10001","10001",3153,1660,1493,53,914,487,1381,2340,1347,993,40,632,284,911
"n292129","292129",0,0,0,0,0,0,0,0,0,0,0,0,0,0
"n370025","370025",1880,1398,482,19,269,123,390,1412,1094,318,13,179,69,246
"n810004B","810004B",16,9,7,0,0,7,7,16,9,7,0,0,7,7
"n1134048","1134048",12,0,12,0,3,9,11,8,0,8,0,1,7,8
"n1131707","1131707",5209,269,4940,309,897,3753,4608,3393,224,3169,271,558,2347,2886
"n2970004","2970004",998,611,387,10,7,354,360,786,505,281,10,6,252,257
"n3470013","3470013",1861,1513,348,20,109,154,258,1415,1162,253,16,80,102,178
"n397003D","397003D",5459,3924,1535,200,313,809,1111,3952,2963,989,128,221,495,714
"n4392266","4392266",4108,2818,1290,212,403,589,966,3228,2330,898,150,263,404,648
"n4490006","4490006",1967,1154,813,14,120,607,712,1402,911,491,8,73,344,415
"n475001W","475001W",331,47,284,3,7,271,273,257,46,211,1,3,202,204
"n1350407","1350407",7015,1559,5456,15,77,5312,5375,4989,1289,3700,14,39,3612,3644
"n1574164","1574164",2198,452,1746,914,529,315,829,1711,370,1341,703,397,244,632
"n2010653","2010653",3693,124,3569,25,588,3020,3538,2501,100,2401,18,413,2012,2379
"n2010112","2010112",4750,2343,2407,585,554,1224,1725,3604,1914,1690,472,354,821,1156
"n2050102","2050102",564,389,175,3,9,162,168,414,293,121,3,9,111,117
"n2310212","2310212",692,488,204,15,21,148,167,554,406,148,9,17,105,121
"n293084","293084",5175,2206,2969,194,384,2384,2697,4087,1874,2213,152,264,1752,1990
"n294209","294209",72,26,46,1,4,42,46,46,20,26,0,3,23,26
"n291106","291106",0,0,0,0,0,0,0,0,0,0,0,0,0,0
"n530003","530003",3268,1292,1976,26,46,1851,1888,2409,1117,1292,21,18,1197,1214
"n850055","850055",9561,4364,5197,3391,707,1028,1706,8867,4067,4800,3174,629,931,1539
"n1110007","1110007",1668,559,1109,12,38,1035,1070,1200,422,778,11,28,718,744
"n4730103","4730103",557,198,359,4,63,277,337,448,184,264,0,51,203,253
"n4910403","4910403",2947,1396,1551,123,457,982,1377,2060,1065,995,79,276,609,866
"n2270408","2270408",58,48,10,0,0,9,9,52,45,7,0,0,7,7
"n2591050","2591050",3739,2540,1199,82,98,975,1059,2746,1961,785,53,53,644,691
"n3030119","3030119",5526,2059,3467,196,677,2612,3202,3956,1695,2261,157,415,1669,2049
"n3390030","3390030",3962,3095,867,75,170,534,697,2957,2371,586,60,120,344,460
"n4394370","4394370",0,0,0,0,0,0,0,0,0,0,0,0,0,0
"n4530282","4530282",2993,2076,917,72,91,617,691,2422,1747,675,58,75,426,495
"n1134018","1134018",1538,987,551,129,176,238,400,1418,916,502,118,150,222,363
"n1132224","1132224",5812,3842,1970,1054,362,444,801,5255,3495,1760,931,350,396,742
"n2010715","2010715",1950,348,1602,342,713,541,1219,1440,297,1143,245,487,397,868
"n2010384","2010384",4921,1059,3862,246,2415,1222,3558,3593,641,2952,207,1906,839,2693
"n2011047","2011047",2207,752,1455,223,648,579,1200,1844,707,1137,189,488,437,917
"n2150045","2150045",1772,446,1326,9,11,1296,1299,1442,432,1010,7,8,992,992
"n310201","310201",2830,2171,659,26,30,511,535,2393,1910,483,19,23,368,386
"n550108","550108",1574,541,1033,12,100,917,1001,1144,435,709,10,68,622,684
"n850078","850078",7808,3666,4142,1806,1272,933,2160,6990,3369,3621,1611,1078,800,1848
"n1134044","1134044",3107,38,3069,10,465,2591,3044,2157,36,2121,8,378,1731,2103
"n1131058","1131058",3466,1376,2090,56,154,1859,1993,2733,1216,1517,49,101,1331,1427
"n1132405","1132405",4418,2328,2090,527,413,1063,1457,3713,2094,1619,428,322,772,1086
"n2010030","2010030",5736,2232,3504,557,1856,1081,2862,4904,2157,2747,490,1278,941,2167
"n2010361","2010361",2849,982,1867,984,232,520,746,2831,977,1854,982,227,510,734
"n2150022","2150022",1496,45,1451,6,7,1441,1441,1073,33,1040,5,7,1031,1031
"n2270031","2270031",166,92,74,3,11,63,74,112,76,36,0,5,31,36
"n2570017","2570017",2246,1858,388,20,39,273,309,1821,1544,277,7,24,193,217
"n4910456","4910456",4052,1119,2933,51,627,2243,2827,3087,915,2172,35,507,1610,2099
"n1212111","1212111",6788,2778,4010,1545,1153,1220,2332,5264,2351,2913,1196,796,820,1595
"n1410054","1410054",5616,660,4956,129,440,4493,4784,3991,549,3442,97,278,3089,3319
"n1470015","1470015",1408,1169,239,15,41,118,152,1059,906,153,11,25,71,92
"n1670438","1670438",9063,2764,6299,205,3745,2300,5906,6663,2294,4369,155,2584,1527,4057
"n2010692","2010692",5617,3720,1897,256,506,985,1455,4587,3137,1450,196,374,732,1096
"n2011024","2011024",597,395,202,11,27,151,176,451,321,130,7,16,91,106
"n190306","190306",1622,1332,290,8,23,214,229,1397,1181,216,3,9,159,168
"n1134069","1134069",6091,666,5425,43,175,5207,5344,4557,591,3966,26,138,3793,3908
"n1131089","1131089",5137,184,4953,61,2607,2321,4886,3483,159,3324,56,1789,1485,3263
"n1132514","1132514",4587,2086,2501,625,625,1181,1796,3503,1772,1731,488,424,748,1170
"n1134663","1134663",0,0,0,0,0,0,0,0,0,0,0,0,0,0
"n1213134","1213134",2792,1796,996,213,226,499,699,2187,1514,673,142,150,317,458
"n4910309","4910309",4204,3218,986,82,90,659,747,3346,2634,712,61,61,468,529
"n3810301","3810301",2175,1852,323,16,18,193,209,1674,1464,210,13,14,114,127
"n4270007","4270007",1343,29,1314,2,2,1310,1310,939,26,913,2,2,911,911
"n4394159","4394159",4182,1255,2927,531,99,2240,2321,3038,1040,1998,438,67,1437,1493
"n4392315","4392315",3899,931,2968,293,2027,635,2619,3070,819,2251,251,1528,456,1952
"n4530223","4530223",2442,1810,632,153,62,372,428,1955,1471,484,114,50,274,323
"n4690012","4690012",1060,382,678,13,36,611,642,812,292,520,6,25,471,494
"n2010007","2010007",1294,32,1262,9,754,507,1253,987,27,960,9,627,328,952
"n2010670","2010670",4164,3286,878,109,91,570,658,3130,2525,605,85,52,381,430
"n2010338","2010338",10261,785,9476,2730,2667,4152,6705,7730,650,7080,2247,1879,3003,4806
"n2011001","2011001",4029,193,3836,533,1624,1621,3198,3006,176,2830,441,1171,1159,2301
"n2010169","2010169",3793,65,3728,18,2880,840,3691,2701,45,2656,4,2114,538,2631
"n3550025","3550025",908,394,514,2,7,491,496,716,324,392,1,3,373,376
"n1350301","1350301",4465,1107,3358,33,150,3142,3274,3345,941,2404,27,108,2232,2335
"n1410077","1410077",4610,371,4239,84,197,3995,4149,3712,349,3363,68,163,3160,3290
"n1450102","1450102",1423,708,715,8,401,291,682,1076,619,457,4,267,170,435
"n1573098","1573098",5446,949,4497,1245,793,2474,3222,4115,762,3353,985,541,1795,2325
"n1670370","1670370",3871,2707,1164,190,246,637,854,2918,2117,801,132,156,438,579
"n1850006","1850006",3086,1347,1739,29,722,974,1657,2389,1185,1204,21,517,644,1150
"n1134093","1134093",210,31,179,0,132,43,175,174,24,150,0,117,29,146
"n1134632","1134632",5111,694,4417,2092,1330,971,2259,3840,608,3232,1473,1028,693,1699
"n11330T4","11330T4",49,4,45,11,11,26,34,30,3,27,9,5,15,18
"n1131750","1131750",5611,1825,3786,1752,895,1126,1988,4533,1674,2859,1408,630,787,1414
"n1213157","1213157",416,365,51,18,5,24,28,345,308,37,15,2,19,20
"n1330004","1330004",395,312,83,1,5,68,73,337,279,58,1,5,46,51
"n4392411","4392411",1858,211,1647,34,554,1029,1562,1351,190,1161,31,385,721,1094
"n4530251","4530251",5902,1505,4397,1194,1256,1989,3179,4761,1342,3419,984,920,1524,2402
"n4690035","4690035",1308,141,1167,7,123,1050,1137,868,103,765,2,75,685,751
"n4910360","4910360",7993,4202,3791,1332,781,1499,2217,5796,3230,2566,886,513,1028,1514
"n2010855","2010855",3494,704,2790,342,1540,881,2382,2482,551,1931,251,1070,568,1621
"n2010315","2010315",2446,1404,1042,226,238,581,768,1909,1173,736,162,176,389,539
"n2010524","2010524",7462,878,6584,825,2163,3656,5722,5450,752,4698,650,1479,2581,4009
"n2010192","2010192",4010,198,3812,44,1640,2146,3752,2951,166,2785,34,1284,1480,2739
"n4330002","4330002",284,219,65,1,16,42,57,225,189,36,1,12,18,29
"n4394245B","4394245B",0,0,0,0,0,0,0,0,0,0,0,0,0,0
"n1410221","1410221",1324,626,698,209,203,286,426,1303,626,677,207,195,266,406
"n1410100","1410100",5149,504,4645,43,149,4471,4575,4001,435,3566,34,102,3420,3506
"n1573157","1573157",2018,280,1738,1262,322,173,468,1384,217,1167,851,212,98,298
"n1670221","1670221",2330,1965,365,45,40,234,267,2066,1788,278,36,18,173,191
"n1870120","1870120",1693,1060,633,20,53,517,562,1369,914,455,14,36,367,399
"n1990003","1990003",835,784,51,1,5,38,42,655,617,38,0,1,29,30
"n250018","250018",2417,1046,1371,40,84,1227,1294,1876,905,971,30,60,852,908
"n294040","294040",2480,195,2285,147,1167,1049,2113,1727,159,1568,96,838,652,1451
"n632002","632002",3126,2042,1084,37,265,696,953,2475,1764,711,31,163,438,601
"n850224","850224",3525,2578,947,297,279,277,536,2438,1861,577,194,158,166,318
"n1133080","1133080",3430,445,2985,13,813,2154,2931,2318,363,1955,9,550,1379,1914
"n1270002","1270002",2236,231,2005,26,40,1944,1970,1601,172,1429,21,26,1386,1406
"n2890006","2890006",1466,1288,178,6,25,80,104,1201,1094,107,4,10,36,46
"n3510011","3510011",711,658,53,2,17,16,32,552,518,34,2,7,7,14
"n4150005","4150005",143,101,42,2,2,36,36,112,79,33,1,1,27,27
"n4230037","4230037",2401,1816,585,52,252,215,463,1781,1385,396,34,171,137,306
"n4393470","4393470",267,119,148,42,11,94,103,195,99,96,23,7,64,71
"n4550004","4550004",331,290,41,7,8,17,25,280,249,31,7,6,12,18
"n1410123","1410123",5432,320,5112,65,99,4969,5029,4263,272,3991,54,76,3873,3922
"n1670151","1670151",6252,3568,2684,205,199,2098,2277,4959,3131,1828,171,124,1359,1475
"n1870216","1870216",76,46,30,1,1,27,28,54,36,18,0,0,18,18
"n2010547","2010547",4321,2356,1965,195,377,1319,1663,3318,1886,1432,139,240,967,1198
"n2090102","2090102",0,0,0,0,0,0,0,0,0,0,0,0,0,0
"n2150214","2150214",3821,161,3660,22,23,3626,3627,2620,138,2482,11,9,2460,2460
"n213019","213019",6859,1922,4937,38,193,4640,4789,4919,1640,3279,25,140,3038,3153
"n294017","294017",3099,1002,2097,83,219,1776,1964,2810,939,1871,70,204,1579,1759
"n291037","291037",5861,610,5251,86,386,4775,5094,4234,528,3706,68,280,3320,3564
"n292089","292089",1015,30,985,9,24,970,975,744,23,721,4,22,708,713
"n390053","390053",4703,747,3956,613,2283,1116,3309,3143,557,2586,424,1497,688,2139
"n850201","850201",0,0,0,0,0,0,0,0,0,0,0,0,0,0
"n4530461","4530461",6621,893,5728,102,671,4975,5553,4655,776,3879,76,456,3345,3755
"n4530467","4530467",4723,1066,3657,221,516,2944,3384,3607,913,2694,171,393,2122,2473
"n3390094","3390094",7448,3873,3575,448,890,2098,2943,5833,3267,2566,344,667,1421,2065
"n3550002","3550002",4043,1549,2494,76,154,2228,2355,3301,1374,1927,68,109,1706,1802
"n4090114","4090114",3825,1904,1921,66,90,1697,1757,2802,1512,1290,45,56,1127,1171
"n4230060","4230060",2272,551,1721,19,221,1459,1670,1562,435,1127,14,166,926,1087
"n4394101","4394101",3357,640,2717,353,86,2242,2325,2422,527,1895,296,52,1510,1560
"n4393368","4393368",944,742,202,30,14,114,125,809,646,163,28,12,89,98
"n1133057","1133057",4573,197,4376,20,1746,2625,4342,3375,183,3192,14,1430,1753,3165
"n1870309","1870309",5519,2586,2933,371,902,1606,2408,3858,1910,1948,252,599,1030,1595
"n2010570","2010570",3793,1602,2191,850,543,760,1273,3387,1510,1877,688,489,652,1117
"n2090206","2090206",4918,1669,3249,120,374,2726,3054,3709,1383,2326,87,315,1891,2184
"n2450087","2450087",2086,217,1869,23,1429,432,1835,1504,200,1304,19,1016,261,1274
"n2910021","2910021",5031,3796,1235,14,135,908,1039,3769,2980,789,10,95,543,637
"n294163","294163",3210,768,2442,184,1038,1259,2217,2331,583,1748,133,761,844,1576
"n294086","294086",1022,396,626,20,21,574,585,775,313,462,11,15,425,433
"n291060","291060",6077,187,5890,59,113,5751,5827,4147,138,4009,37,67,3921,3962
"n292066","292066",4872,1843,3029,225,286,2542,2765,3697,1472,2225,163,180,1876,2027
"n390030","390030",4522,2781,1741,215,531,884,1403,3760,2323,1437,154,478,704,1177
"n710010","710010",2181,1712,469,13,63,312,367,1626,1323,303,8,46,186,226
"n3810208","3810208",1910,1593,317,20,26,207,230,1288,1092,196,12,11,133,143
"n4070002","4070002",7103,4558,2545,29,606,1704,2277,5198,3488,1710,23,447,1078,1501
"n4393287","4393287",4264,2616,1648,335,236,974,1181,3273,2108,1165,253,156,653,793
"n2150168","2150168",706,12,694,1,0,689,689,531,10,521,1,0,516,516
"n2490001","2490001",1044,154,890,6,20,859,869,814,138,676,4,10,650,658
"n2650417","2650417",2489,1909,580,37,41,435,466,2046,1659,387,32,20,276,290
"n2810001","2810001",2994,1902,1092,145,356,495,814,2343,1577,766,109,271,313,560
"n3270001","3270001",471,196,275,3,9,255,264,381,161,220,2,7,203,210
"n3390072","3390072",4507,3927,580,78,83,302,380,4006,3555,451,66,70,220,285
"n850178","850178",4198,2884,1314,302,266,602,864,2843,2021,822,167,167,409,575
"n1132017","1132017",3597,1503,2094,388,1037,634,1635,3262,1435,1827,357,873,549,1403
"n1134657","1134657",328,15,313,27,65,236,280,263,11,252,22,46,198,223
"n2010838","2010838",0,0,0,0,0,0,0,0,0,0,0,0,0,0
"n2010175","2010175",3876,2488,1388,614,196,515,692,2753,1810,943,402,152,341,485
"n2090331","2090331",1025,701,324,25,54,233,275,889,627,262,22,25,196,217
"n270206","270206",4421,1105,3316,343,1941,1003,2810,3134,883,2251,237,1307,632,1868
"n294186","294186",141,80,61,4,4,50,54,108,69,39,2,4,30,34
"n294063","294063",2146,310,1836,99,335,1467,1727,1617,271,1346,90,245,1046,1246
"n292044","292044",5315,224,5091,72,251,4813,4998,3677,157,3520,48,144,3330,3451
"n291083","291083",4093,1021,3072,145,357,2605,2907,3027,820,2207,90,275,1836,2082
"n390007","390007",5497,1433,4064,31,781,3261,3938,4039,1217,2822,26,504,2244,2721
"n3830001","3830001",859,67,792,19,21,743,759,594,63,531,19,14,491,503
"n4010416","4010416",1676,983,693,13,132,523,655,1292,835,457,8,91,338,429
"n4392383","4392383",4348,1166,3182,370,1360,1480,2772,3192,990,2202,278,938,990,1882
"n2510003","2510003",3634,2763,871,72,120,578,678,2774,2186,588,46,76,370,439
"n2630202","2630202",113,95,18,3,2,17,18,96,83,13,2,2,12,13
"n2850329","2850329",1995,1637,358,11,83,210,287,1559,1337,222,6,50,130,176
"n3290205","3290205",2210,1712,498,24,57,361,409,1663,1320,343,16,34,244,274
"n3390050","3390050",5128,4131,997,88,168,569,723,4179,3478,701,68,97,402,493
"n3490305","3490305",1003,609,394,16,53,267,314,733,485,248,13,34,158,191
"n670017","670017",4343,3272,1071,23,742,197,934,3300,2620,680,16,469,125,590
"n850032","850032",3158,2244,914,240,177,435,590,2522,1831,691,191,123,316,429
"n1131744","1131744",99,31,68,3,23,46,65,64,27,37,3,11,24,35
"n2010861","2010861",4773,233,4540,160,1993,2419,4362,3377,199,3178,152,1468,1578,3014
"n2150191","2150191",902,23,879,9,6,867,867,595,18,577,8,4,569,569
"n2150068","2150068",7750,394,7356,30,83,7253,7312,5209,304,4905,18,38,4845,4869
"n10020","10020",2048,1011,1037,31,307,656,952,1539,853,686,22,203,414,614
"n293159","293159",5165,1350,3815,109,1360,2354,3625,3963,1189,2774,79,961,1699,2621
"n4391463","4391463",5447,1011,4436,146,2940,1414,4241,4167,893,3274,125,2145,1019,3105
"n4630005","4630005",2822,1160,1662,50,67,1510,1567,2271,978,1293,40,62,1159,1211
"n1133305","1133305",7063,2079,4984,482,1828,2581,4356,5297,1798,3499,407,1228,1755,2968
"n2010531","2010531",4307,2278,2029,27,291,1660,1923,3275,1860,1415,23,204,1128,1323
"n2150029","2150029",2447,322,2125,19,31,2084,2100,1652,310,1342,16,29,1305,1321
"n2190024","2190024",1528,727,801,5,23,749,770,1072,554,518,3,12,481,492
"n2450048","2450048",2937,124,2813,91,505,2239,2713,1991,103,1888,73,379,1432,1802
"n3090031","3090031",4300,1971,2329,47,1183,1060,2202,3286,1703,1583,39,791,710,1480
"n30003","30003",4686,1705,2981,38,120,2739,2832,3265,1333,1932,22,87,1753,1829
"n294001","294001",3564,1647,1917,213,258,1360,1592,3425,1618,1807,201,235,1277,1496
"n291021","291021",3139,167,2972,16,34,2930,2941,2240,145,2095,11,24,2062,2070
"n292153","292153",859,203,656,37,138,470,605,664,178,486,31,105,336,438
"n37011A","37011A",2405,2028,377,58,110,89,196,1820,1540,280,35,86,59,142
"n530004","530004",3068,2497,571,35,40,408,447,2585,2192,393,23,28,270,298
"n3030001","3030001",6681,1934,4747,256,777,3762,4422,5247,1767,3480,205,512,2742,3215
"n3210013","3210013",440,283,157,11,103,41,142,360,240,120,6,84,26,110
"n3490108","3490108",772,427,345,3,37,284,318,591,368,223,2,30,170,199
"n3630016","3630016",488,431,57,4,2,23,25,423,380,43,3,2,12,14
"n4391008","4391008",589,40,549,10,184,356,536,421,38,383,7,147,227,371
"n4393648","4393648",6198,3716,2482,613,707,1017,1677,4177,2613,1564,412,407,630,1014
"n890401","890401",668,321,347,5,106,223,326,502,252,250,4,84,151,235
"n1132913","1132913",31,10,21,0,12,11,18,18,7,11,0,6,7,9
"n2010676","2010676",6877,1011,5866,407,974,4517,5399,5007,840,4167,333,680,3137,3766
"n2090120","2090120",3150,994,2156,132,234,1743,1947,2284,834,1450,100,153,1155,1285
"n231215B","231215B",3122,2479,643,31,75,421,483,2220,1811,409,19,49,253,299
"n2570001","2570001",6376,2882,3494,83,657,2635,3253,4558,2243,2315,56,462,1694,2132
"n294150","294150",3066,640,2426,154,963,1364,2224,2316,544,1772,94,716,964,1627
"n293189","293189",1549,606,943,308,115,516,619,1116,451,665,213,81,355,430
"n410101","410101",97,28,69,3,15,47,62,69,23,46,1,8,33,41
"n610047","610047",3837,293,3544,15,26,3510,3522,2902,277,2625,14,17,2596,2608
"n850162","850162",318,247,71,5,11,47,53,271,213,58,4,5,43,43
"n970002","970002",5569,2307,3262,46,515,2545,3035,3983,1889,2094,37,358,1568,1918
"n5030010","5030010",768,621,147,5,8,95,103,568,472,96,4,4,52,56
"n2450008","2450008",1275,119,1156,19,939,196,1128,941,111,830,16,688,124,805
"n2772A1A","2772A1A",1965,710,1255,9,906,288,1181,1505,566,939,6,709,186,886
"n3030020","3030020",2272,109,2163,17,1649,557,2149,1698,83,1615,8,1269,359,1604
"n3450006","3450006",244,178,66,5,8,52,59,196,153,43,3,6,32,38
"n4530417","4530417",2356,1506,850,115,103,619,700,2171,1411,760,102,98,547,625
"n4910277","4910277",5955,4160,1795,628,232,816,1025,4324,3132,1192,428,156,522,667
"n1133018","1133018",2678,92,2586,19,1993,598,2559,2135,87,2048,11,1687,373,2032
"n1211029","1211029",247,25,222,1,14,208,219,159,12,147,1,4,144,146
"n2011154","2011154",0,0,0,0,0,0,0,0,0,0,0,0,0,0
"n2010657","2010657",3894,729,3165,182,1114,1879,2950,3051,657,2394,143,859,1378,2218
"n213004W","213004W",1293,1025,268,20,44,171,211,1015,835,180,14,36,104,140
"n2230023","2230023",415,284,131,10,35,62,95,330,236,94,5,23,44,67
"n294127","294127",212,27,185,1,48,136,182,141,27,114,1,31,84,113
"n292028","292028",3346,637,2709,62,139,2557,2653,2733,602,2131,35,96,2016,2088
"n610024","610024",2908,117,2791,4,7,2769,2772,1992,89,1903,0,3,1884,1885
"n770009","770009",519,463,56,5,1,26,27,406,361,45,5,1,16,17
"n930001","930001",2492,1636,856,26,19,760,772,1887,1363,524,21,13,445,454
"n1131140","1131140",0,0,0,0,0,0,0,0,0,0,0,0,0,0
"n4650031","4650031",5236,1458,3778,146,173,3445,3568,3715,1174,2541,114,111,2287,2376
"n49901-1","49901-1",4354,3559,795,27,212,405,610,3674,3110,564,22,157,248,403
"n3970001","3970001",6097,4619,1478,353,329,632,944,4466,3516,950,222,211,393,596
"n4394067","4394067",3006,192,2814,17,53,2742,2782,2289,155,2134,10,45,2080,2114
"n4391273","4391273",6207,919,5288,108,236,4910,5110,4362,796,3566,88,158,3277,3418
"n4391103","4391103",1881,1139,742,58,222,409,620,1563,999,564,39,185,296,474
"n4394737B","4394737B",49,23,26,11,12,1,12,28,18,10,2,7,0,7
"n4392210","4392210",3693,530,3163,101,251,2781,3017,2558,458,2100,68,178,1826,1995
"n2030012","2030012",4052,3215,837,56,329,316,640,2908,2380,528,42,195,195,386
"n2150175","2150175",2390,92,2298,4,4,2289,2290,1705,78,1627,4,1,1619,1619
"n2250018","2250018",177,114,63,1,36,14,50,143,90,53,1,36,10,46
"n2810008","2810008",3023,2139,884,80,239,450,669,2344,1718,626,63,169,307,463
"n3370012","3370012",208,158,50,0,4,25,29,179,138,41,0,1,24,25
"n3690402","3690402",1865,139,1726,11,27,1695,1703,1237,103,1134,7,17,1113,1119
"n292170","292170",6304,1906,4398,903,500,3042,3434,4854,1576,3278,655,350,2256,2553
"n1134541","1134541",0,0,0,0,0,0,0,0,0,0,0,0,0,0
"n1131711","1131711",6720,1089,5631,81,380,5141,5480,4763,941,3822,45,261,3492,3723
"n1230102","1230102",2250,450,1800,18,575,1214,1748,1645,363,1282,11,403,851,1245
"n1410187","1410187",0,0,0,0,0,0,0,0,0,0,0,0,0,0
"n1630009","1630009",2016,220,1796,6,6,1764,1768,1417,165,1252,3,5,1226,1230
"n4230021","4230021",2159,1654,505,57,157,242,387,1597,1282,315,40,84,147,228
"n4393728","4393728",3974,2202,1772,1305,148,270,408,2749,1633,1116,805,100,168,261
"n4394638","4394638",5656,2875,2781,407,1020,1236,2192,3718,1993,1725,264,615,745,1328
"n4392746","4392746",3443,982,2461,204,835,1433,2213,2479,838,1641,168,593,884,1444
"n4790177","4790177",2458,33,2425,2,8,2418,2419,1702,18,1684,1,2,1680,1681
"n1890408","1890408",1161,518,643,13,46,564,608,871,453,418,12,23,363,386
"n2010942","2010942",1121,49,1072,9,82,985,1067,764,41,723,6,68,651,719
"n2010279","2010279",4003,1172,2831,73,220,2485,2691,2840,932,1908,56,129,1667,1793
"n3170003","3170003",1106,692,414,8,18,374,389,827,555,272,3,8,254,261
"n3730014","3730014",3016,2454,562,9,75,253,320,2281,1922,359,4,42,142,181
"n397004C","397004C",2754,1950,804,56,244,442,672,1929,1413,516,34,158,273,428
"n130011","130011",2789,898,1891,29,43,1783,1811,2049,717,1332,22,28,1243,1269
"n270308","270308",7360,3501,3859,452,1761,1612,3212,5575,3000,2575,337,1100,1022,2070
"n292147","292147",1220,293,927,67,170,718,846,923,244,679,50,131,517,622
"n293163","293163",3738,1882,1856,298,210,1363,1522,2748,1477,1271,194,136,923,1035
"n37006A","37006A",3351,2421,930,97,554,190,725,2641,1989,652,70,363,143,496
"n850185","850185",91,84,7,1,1,4,5,61,59,2,0,0,2,2
"n4530342","4530342",4579,2722,1857,326,254,1235,1451,3750,2342,1408,241,196,911,1094
"n4530165","4530165",4347,1589,2758,323,831,1567,2347,3374,1320,2054,256,601,1138,1718
"n4910207","4910207",4559,3255,1304,95,81,1004,1068,3364,2492,872,64,55,644,691
"n4910322","4910322",2217,1607,610,214,80,272,337,1666,1253,413,156,47,181,223
"n2510020","2510020",3726,1391,2335,28,327,1800,2107,2570,1062,1508,16,249,1147,1383
"n3030047","3030047",4655,2356,2299,184,427,1628,1987,3549,1985,1564,144,263,1075,1303
"n3510018","3510018",379,352,27,1,21,3,24,293,277,16,1,13,1,14
"n3550108","3550108",2317,720,1597,13,24,1562,1576,1953,695,1258,11,22,1226,1239
"n4230044","4230044",6429,3105,3324,112,1674,1451,3077,4784,2586,2198,71,1159,878,2012
"n4392656","4392656",411,131,280,11,83,182,259,312,107,205,8,71,125,193
"n1134515","1134515",6461,673,5788,41,235,5520,5697,4559,574,3985,32,133,3809,3915
"n1410161","1410161",2296,69,2227,4,29,2203,2217,1708,57,1651,3,15,1635,1644
"n1610005B","1610005B",1500,652,848,5,404,436,835,1461,641,820,4,394,420,810
"n1670191","1670191",4333,3114,1219,188,271,705,932,3299,2456,843,130,195,468,640
"n2010302","2010302",7384,1578,5806,60,206,5537,5662,5274,1328,3946,43,119,3756,3843
"n2110101","2110101",839,428,411,9,7,367,371,568,340,228,2,3,200,200
"n293022","293022",2134,1445,689,100,80,504,566,1593,1131,462,57,49,340,384
"n292048","292048",3665,242,3423,27,94,3326,3389,2760,208,2552,25,48,2485,2520
"n390011","390011",4982,2027,2955,661,533,1670,2173,3735,1616,2119,502,366,1148,1506
"n1134157","1134157",853,56,797,10,47,743,760,621,49,572,9,34,527,544
"n1131303","1131303",513,39,474,8,277,193,467,336,33,303,2,180,124,301
"n1133620","1133620",1841,150,1691,26,1385,316,1670,1428,141,1287,22,1058,223,1268
"n3090070","3090070",707,477,230,6,38,121,154,509,376,133,3,16,59,75
"n3330002","3330002",139,117,22,2,0,15,15,106,91,15,0,0,10,10
"n3670330","3670330",3230,2027,1203,24,38,1005,1039,2454,1671,783,16,27,624,649
"n4410302","4410302",3690,2565,1125,89,255,730,963,2853,2141,712,59,153,450,593
"n467004A","467004A",2081,1666,415,22,50,261,307,1617,1351,266,18,23,161,184
"n4790371","4790371",3935,223,3712,67,32,3617,3638,2809,174,2635,52,23,2559,2578
"n1391034","1391034",5466,4049,1417,89,458,698,1144,3873,2932,941,60,317,449,761
"n1830014","1830014",6882,5070,1812,54,565,1028,1561,5097,3907,1190,42,411,608,1007
"n2010985","2010985",525,250,275,51,130,91,216,434,216,218,42,110,68,173
"n2010488","2010488",3930,372,3558,527,861,2211,3014,2942,345,2597,469,577,1562,2109
"n2010322","2010322",4594,430,4164,67,1335,2818,4066,2979,376,2603,48,875,1711,2539
"n2530003","2530003",8512,4446,4066,49,1598,2323,3895,7669,3826,3843,40,1568,2165,3716
"n292070","292070",4060,117,3943,16,85,3838,3893,2841,88,2753,6,50,2682,2722
"n990205","990205",3800,2853,947,50,128,647,754,2849,2211,638,33,88,415,493
"n1133038","1133038",1221,53,1168,14,766,388,1152,956,45,911,12,645,255,899
"n1133940","1133940",6428,1025,5403,26,1831,3512,5288,4447,875,3572,17,1285,2210,3478
"n1133962","1133962",7075,3078,3997,1030,1432,1439,2838,5592,2632,2960,769,1030,1067,2076
"n1290201","1290201",825,686,139,11,41,73,109,617,527,90,9,25,40,63
"n4690019","4690019",4993,1764,3229,215,435,2584,2956,3678,1460,2218,164,278,1750,2006
"n2011134","2011134",4356,2219,2137,741,592,727,1299,3108,1627,1481,530,403,491,883
"n2010962","2010962",8276,2030,6246,50,3999,2243,6190,8172,2021,6151,48,3946,2201,6098
"n3290407","3290407",6003,2896,3107,247,570,2244,2761,4526,2342,2184,171,376,1596,1938
"n3670130","3670130",6110,4419,1691,62,90,1231,1310,4572,3473,1099,44,53,755,808
"n4394195","4394195",4544,273,4271,59,67,4144,4196,3075,213,2862,42,36,2779,2810
"n4450101","4450101",3327,1791,1536,13,161,1333,1479,2480,1428,1052,9,134,883,1013
"n1890104","1890104",1344,304,1040,16,69,920,979,967,267,700,5,45,615,659
"n2010637","2010637",4554,654,3900,83,323,3484,3783,3629,583,3046,67,272,2687,2952
"n2010588","2010588",6645,2779,3866,282,1300,2121,3359,5034,2354,2680,213,911,1400,2287
"n2010422","2010422",5387,64,5323,30,4533,802,5266,3987,43,3944,20,3405,543,3905
"n2010465","2010465",7146,1616,5530,334,2877,2354,5113,5385,1451,3934,276,2016,1622,3575
"n2011128","2011128",5045,2937,2108,452,494,1085,1549,3645,2258,1387,309,326,677,990
"n90011","90011",27,24,3,0,0,3,3,22,20,2,0,0,2,2
"n293146","293146",5620,1944,3676,461,394,2837,3164,4643,1701,2942,391,306,2223,2492
"n610004","610004",4167,748,3419,116,39,3246,3280,3155,634,2521,79,25,2394,2416
"n850205","850205",36,21,15,11,2,1,3,24,13,11,8,1,1,2
"n1133061","1133061",2920,73,2847,8,1990,872,2835,2070,48,2022,7,1478,543,2011
"n1134005","1134005",2656,508,2148,137,231,1794,2004,1995,462,1533,116,167,1246,1408
"n3030072","3030072",5233,2491,2742,196,499,1975,2417,3881,2040,1841,148,307,1285,1582
"n3550128","3550128",4541,1543,2998,398,289,2302,2539,3279,1231,2048,284,200,1539,1711
"n4391170","4391170",5102,1598,3504,203,1239,2012,3198,3750,1386,2364,132,876,1289,2142
"n4392031","4392031",5140,957,4183,824,2209,1144,3290,3597,710,2887,625,1493,744,2212
"n4530142","4530142",4318,1436,2882,225,1043,1613,2587,3236,1167,2069,175,758,1108,1835
"n4910174","4910174",4766,2601,2165,613,427,1082,1447,3981,2280,1701,483,340,828,1126
"n1410018","1410018",4314,1529,2785,235,179,2375,2520,3334,1254,2080,182,125,1769,1870
"n1810203","1810203",2306,1292,1014,26,404,443,821,1708,1037,671,17,297,271,555
"n2010445","2010445",5046,1501,3545,314,414,2808,3169,3797,1314,2483,244,306,1911,2189
"n2010614","2010614",7884,649,7235,1395,2664,3257,5838,5983,541,5442,1157,2036,2275,4263
"n2090424","2090424",3484,2153,1331,120,113,1019,1109,2299,1479,820,70,71,607,673
"n2270042","2270042",1258,451,807,20,74,711,775,912,355,557,11,48,485,530
"n50035","50035",2614,1750,864,54,418,347,757,2071,1481,590,49,262,233,493
"n293122","293122",3459,1726,1733,168,259,1270,1489,2815,1501,1314,129,184,946,1114
"n293169","293169",233,102,131,17,8,106,113,189,96,93,8,7,78,84
"n292182B","292182B",246,89,157,14,54,103,147,182,72,110,7,44,67,105
"n410076","410076",4464,2829,1635,414,434,685,1092,3484,2321,1163,318,298,475,759
"n470003","470003",1299,79,1220,15,10,1192,1198,944,63,881,13,6,855,861
"n4530114","4530114",3048,1756,1292,136,194,922,1100,2636,1578,1058,117,157,736,887
"n4790272","4790272",3811,173,3638,69,43,3513,3547,2807,138,2669,53,34,2572,2598
"n4910230","4910230",6085,3952,2133,232,357,1377,1694,4428,3023,1405,133,228,918,1119
"n2010345","2010345",9177,824,8353,780,2090,5555,7508,6613,691,5922,634,1603,3726,5247
"n2090325","2090325",715,448,267,8,15,229,242,570,371,199,2,8,172,180
"n2410010","2410010",2829,2491,338,10,89,134,220,2169,1949,220,2,48,86,131
"n3030040","3030040",2043,128,1915,16,1046,873,1876,1552,118,1434,11,784,641,1412
"n3110001","3110001",155,69,86,5,6,82,83,126,60,66,3,3,62,63
"n3610012","3610012",2216,1452,764,35,388,303,686,1709,1261,448,16,204,196,400
"n850228","850228",9245,3808,5437,554,1782,2958,4650,6148,2720,3428,362,1117,1846,2910
"n1134114","1134114",3819,185,3634,7,50,3563,3600,2785,167,2618,6,42,2557,2590
"n1391054","1391054",4056,947,3109,40,2161,882,3008,2781,725,2056,27,1434,569,1993
"n1410167","1410167",8042,186,7856,30,80,7780,7818,5857,135,5722,18,50,5675,5703
"n1670166","1670166",3972,2854,1118,169,182,685,841,3187,2393,794,116,126,468,585
"n1810406","1810406",3782,3331,451,18,31,203,229,3180,2864,316,16,15,132,146
"n50015","50015",1606,913,693,9,130,538,655,1287,762,525,6,102,397,496
"n293183","293183",65,18,47,5,17,25,36,44,15,29,5,10,11,20
"n294227","294227",0,0,0,0,0,0,0,0,0,0,0,0,0,0
"n291041","291041",4128,170,3958,37,79,3868,3910,3108,145,2963,27,55,2894,2924
"n292127","292127",3883,1118,2765,164,299,2286,2540,2995,960,2035,137,203,1655,1846
"n1134052","1134052",8452,1069,7383,448,2814,4113,6857,6034,903,5131,353,2016,2728,4716
"n4510420","4510420",953,559,394,52,24,308,327,654,408,246,35,14,183,195
"n4530411","4530411",3344,2621,723,151,82,420,498,3048,2409,639,137,73,362,434
"n4750002","4750002",3002,1394,1608,33,175,1398,1526,2204,1091,1113,27,111,960,1051
"n2010651","2010651",5949,1761,4188,590,855,2702,3507,4490,1460,3030,442,617,1925,2506
"n325001C","325001C",6653,3174,3479,142,334,2925,3201,4986,2571,2415,93,221,1993,2192
"n3470021","3470021",3536,1861,1675,13,353,1243,1580,2604,1526,1078,8,221,783,1000
"n3610032","3610032",2546,2278,268,31,19,144,160,1978,1789,189,16,10,101,111
"n3930002","3930002",182,162,20,2,3,10,12,142,128,14,0,2,6,8
"n4394113","4394113",2506,1345,1161,45,365,673,1024,2398,1280,1118,44,348,649,987
"n1211035","1211035",8079,3411,4668,399,1785,2319,4038,5661,2559,3102,277,1148,1540,2663
"n1330008","1330008",4563,3600,963,39,177,577,746,3558,2891,667,29,147,367,514
"n1870307","1870307",6449,3104,3345,334,1142,1782,2836,4708,2354,2354,253,845,1163,1966
"n2010153","2010153",5556,289,5267,28,334,4945,5225,3973,238,3735,23,243,3489,3702
"n2010402","2010402",5296,181,5115,113,3221,1836,4987,3777,162,3615,80,2429,1112,3515
"n2010899","2010899",2222,1062,1160,692,140,282,415,1566,760,806,484,98,189,283
"n294084","294084",1411,204,1207,17,348,884,1188,1040,158,882,14,261,632,864
"n291146","291146",402,79,323,14,18,286,299,313,64,249,10,7,226,232
"n1131147","1131147",977,803,174,21,33,94,122,706,594,112,17,17,56,72
"n1133600","1133600",3957,533,3424,60,2399,970,3345,3368,496,2872,47,2144,686,2816
"n1214177","1214177",1754,896,858,131,258,404,658,1507,810,697,112,215,315,526
"n1510004","1510004",918,707,211,4,11,190,197,712,554,158,1,5,141,144
"n3750321","3750321",3512,2903,609,19,44,372,413,2623,2242,381,12,27,224,249
"n4394565","4394565",96,32,64,0,0,60,60,75,26,49,0,0,45,45
"n4391255","4391255",5268,1341,3927,367,1873,1683,3489,3908,1161,2747,274,1317,1125,2417
"n4391722","4391722",626,246,380,35,177,160,336,463,193,270,17,127,114,241
"n4590011","4590011",897,728,169,6,35,81,113,676,581,95,1,16,42,57
"n4930104","4930104",1820,996,824,21,35,739,768,1420,818,602,19,30,531,555
"n1573119","1573119",3982,1996,1986,1521,124,293,410,3146,1637,1509,1183,84,215,292
"n2011005","2011005",0,0,0,0,0,0,0,0,0,0,0,0,0,0
"n2010011","2010011",3492,295,3197,62,194,2962,3133,2784,275,2509,49,173,2294,2450
"n2010508","2010508",11162,557,10605,3070,1652,5896,7438,8627,492,8135,2648,1202,4271,5416
"n2890010","2890010",1689,1024,665,11,79,563,633,1224,821,403,7,59,323,377
"n3390037","3390037",5977,3156,2821,287,444,1935,2345,4395,2523,1872,197,300,1223,1508
"n10005","10005",405,335,70,1,14,37,51,325,274,51,1,11,24,35
"n291004","291004",1689,103,1586,4,43,1550,1580,1253,83,1170,0,33,1141,1164
"n37002A","37002A",1910,417,1493,2,1364,96,1452,1401,349,1052,2,969,54,1019
"n490417","490417",2972,2379,593,13,68,400,461,2502,2061,441,13,51,279,327
"n850036","850036",2253,1671,582,279,126,123,246,1795,1366,429,206,99,86,182
"n910208A","910208A",4053,3133,920,65,64,679,737,3341,2656,685,48,42,501,540
"n2370005","2370005",782,699,83,7,3,59,60,619,562,57,3,1,36,37
"n2570021","2570021",4850,2874,1976,17,151,1686,1822,3570,2331,1239,14,107,1010,1110
"n3490400","3490400",2494,1631,863,32,308,483,767,1863,1313,550,25,214,282,482
"n3650009","3650009",887,691,196,4,126,32,158,689,560,129,4,77,20,97
"n4490010","4490010",1426,1045,381,8,28,305,326,1077,827,250,5,12,200,210
"n4530367","4530367",3503,2754,749,217,70,393,451,2521,2037,484,126,53,251,297
"n1134091","1134091",23,4,19,3,6,15,17,14,4,10,2,3,7,8
"n1212072","1212072",5753,3456,2297,290,568,1229,1768,4300,2731,1569,212,376,819,1178
"n2010116","2010116",4229,3231,998,447,54,428,475,3027,2352,675,303,35,271,301
"n2010365","2010365",1445,225,1220,24,930,267,1181,1204,201,1003,21,805,165,966
"n2050401","2050401",1153,665,488,12,16,432,445,909,540,369,12,9,324,331
"n2150112","2150112",2662,74,2588,28,32,2542,2545,1884,53,1831,18,12,1796,1798
"n293128","293128",86,56,30,5,6,19,24,68,48,20,3,4,12,16
"n293042","293042",3735,1702,2033,479,215,1366,1541,2590,1258,1332,303,134,888,1008
"n410082","410082",464,416,48,3,0,36,36,354,314,40,3,0,29,29
"n850099","850099",497,274,223,22,107,96,193,385,238,147,11,74,59,128
"n1132081","1132081",1362,55,1307,7,311,988,1295,1043,47,996,5,265,722,986
"n1132305","1132305",3625,1418,2207,603,922,674,1541,3196,1319,1877,515,781,560,1304
"n3030123","3030123",2704,1807,897,53,194,596,773,2136,1495,641,34,130,427,549
"n3090051","3090051",7850,4790,3060,552,1025,1322,2276,6068,3902,2166,405,715,899,1582
"n4130003","4130003",604,161,443,6,11,422,431,459,138,321,4,10,302,311
"n4393326","4393326",1822,1094,728,67,230,399,615,1492,967,525,56,162,276,432
"n4790460","4790460",1303,38,1265,2,8,1258,1260,917,33,884,0,1,884,884
"n4910122","4910122",682,415,267,37,60,159,216,555,378,177,19,40,102,142
"n1410038","1410038",4379,331,4048,47,124,3921,3993,3508,286,3222,37,93,3124,3180
"n1770015","1770015",462,291,171,1,3,163,166,371,247,124,0,2,117,119
"n2010756","2010756",3418,529,2889,112,1126,1649,2724,2507,455,2052,103,818,1118,1911
"n2010842","2010842",5686,926,4760,352,1469,2984,4359,4284,813,3471,291,1064,2128,3141
"n2150049","2150049",5432,201,5231,110,45,5101,5114,4082,175,3907,87,22,3801,3813
"n2450028","2450028",1164,369,795,18,675,101,765,924,311,613,10,527,73,597
"n550103","550103",3277,1732,1545,53,157,1284,1407,2526,1451,1075,38,96,886,967
"n810003","810003",858,624,234,4,13,181,190,728,552,176,3,10,133,140
"n830004","830004",1870,1565,305,12,42,215,251,1553,1342,211,10,20,149,166
"n850242","850242",5080,2167,2913,1859,619,380,970,3895,1901,1994,1198,449,286,722
"n1430021","1430021",2831,1560,1271,14,39,1138,1174,2130,1267,863,12,15,773,787
"n1430010","1430010",3048,2139,909,30,164,678,834,2623,1925,698,20,143,507,645
"n2310110","2310110",1724,933,791,26,41,656,694,1216,711,505,17,35,407,440
"n2510040","2510040",5257,3689,1568,141,453,891,1292,3725,2724,1001,94,276,550,809
"n4391066","4391066",2444,511,1933,66,497,1369,1843,1776,452,1324,55,381,879,1244
"n4392262","4392262",1728,1083,645,71,136,395,520,1327,894,433,49,83,259,338
"n4392274","4392274",19,0,19,3,11,5,16,12,0,12,0,9,3,12
"n4391079","4391079",2558,117,2441,53,923,1474,2385,1793,100,1693,27,735,933,1663
"n1574162","1574162",1264,420,844,10,42,795,826,919,350,569,7,28,536,558
"n1590101","1590101",1875,1456,419,24,129,227,346,1463,1181,282,12,76,155,226
"n1830008","1830008",7193,4481,2712,231,1438,843,2245,5624,3789,1835,191,934,537,1457
"n2150149","2150149",107,1,106,1,2,106,106,90,1,89,1,2,89,89
"n2150155","2150155",1116,69,1047,11,4,1035,1036,820,56,764,4,3,760,761
"n2310318","2310318",1097,858,239,12,17,179,191,830,683,147,10,11,96,105
"n294170","294170",866,223,643,24,116,519,609,652,192,460,19,74,366,430
"n610067","610067",4678,1797,2881,129,51,2624,2673,3963,1640,2323,119,43,2097,2139
"n650301","650301",928,799,129,3,14,77,90,658,565,93,3,11,51,61
"n1131006","1131006",2163,1823,340,73,72,139,207,1561,1352,209,50,47,73,120
"n1214219","1214219",4413,3395,1018,70,182,598,754,3248,2590,658,46,110,380,478
"n1572134","1572134",7090,1065,6025,1546,2728,1791,4433,5511,913,4598,1242,2081,1278,3307
"n3810302","3810302",4012,2987,1025,73,110,735,833,3027,2276,751,63,80,516,588
"n4391416","4391416",228,117,111,4,17,91,105,181,102,79,2,13,65,75
"n4394362","4394362",17,7,10,3,0,7,7,11,5,6,0,0,6,6
"n4391564","4391564",0,0,0,0,0,0,0,0,0,0,0,0,0,0
"n1572007","1572007",16010,4625,11385,2931,4294,4088,8234,11084,3415,7669,2147,2784,2583,5317
"n1930022","1930022",1372,1205,167,14,13,106,116,1082,977,105,12,10,55,62
"n2011091","2011091",3629,759,2870,861,423,1630,2005,2745,654,2091,665,318,1114,1407
"n2150255","2150255",498,85,413,0,1,412,412,345,85,260,0,1,259,259
"n2210314","2210314",5496,4201,1295,47,49,1032,1077,4286,3403,883,31,40,669,705
"n277001F","277001F",1856,1630,226,3,23,91,113,1450,1298,152,2,17,49,66
"n270414","270414",9210,1757,7453,563,4634,2424,6609,6204,1375,4829,386,2925,1526,4257
"n370022","370022",265,169,96,2,69,20,89,210,142,68,1,50,13,63
"n490307","490307",907,731,176,7,12,138,145,731,608,123,7,5,90,92
"n1132611","1132611",6088,753,5335,4098,621,562,1170,4428,676,3752,2782,487,439,921
"n1131705","1131705",4233,931,3302,820,657,1795,2424,3136,790,2346,626,471,1213,1665
"n1350405","1350405",2483,153,2330,10,133,2195,2306,1824,118,1706,5,94,1615,1699
"n4490004","4490004",893,631,262,4,20,208,227,728,553,175,4,13,128,140
"n4790227","4790227",1903,44,1859,6,14,1852,1855,1267,25,1242,6,8,1238,1240
"n4910379","4910379",4247,3407,840,140,109,492,585,3392,2815,577,92,83,315,394
"n2150106","2150106",4530,421,4109,389,109,3647,3714,3255,326,2929,280,70,2584,2635
"n2570027","2570027",5082,3153,1929,153,709,976,1657,3414,2221,1193,103,453,582,1022
"n2970002","2970002",1452,1094,358,10,26,294,314,1226,952,274,7,18,218,235
"n3650019","3650019",500,406,94,4,21,45,63,381,317,64,4,13,25,35
"n397003BB","397003BB",59,7,52,1,3,45,48,47,7,40,0,2,34,36
"n4393759","4393759",0,0,0,0,0,0,0,0,0,0,0,0,0,0
"n1410181","1410181",9744,1300,8444,344,969,7242,8004,6112,912,5200,222,559,4418,4895
"n1870129","1870129",4617,2658,1959,141,188,1504,1654,3306,2021,1285,92,108,986,1083
"n2010110","2010110",5211,1768,3443,501,1385,1490,2838,4035,1521,2514,387,987,1067,2040
"n2010948","2010948",973,582,391,60,84,247,320,755,474,281,43,59,171,225
"n2010359","2010359",14523,426,14097,564,5359,8349,13451,9869,356,9513,431,3734,5461,9049
"n2030026","2030026",3746,2869,877,51,396,300,680,2585,2075,510,30,211,159,364
"n211003","211003",3183,2162,1021,57,127,732,836,2444,1774,670,38,78,460,531
"n293085","293085",1853,937,916,51,131,727,832,1518,822,696,41,96,542,622
"n410039","410039",2834,1734,1100,324,262,444,684,2087,1355,732,222,171,277,439
"n850142","850142",4917,2396,2521,1466,507,450,943,4187,2079,2108,1323,367,328,684
"n1134613","1134613",2491,237,2254,69,156,2014,2147,1743,204,1539,54,109,1354,1455
"n1132126","1132126",910,367,543,88,306,149,448,754,349,405,61,222,108,325
"n3090008","3090008",2649,944,1705,30,473,1230,1650,1966,781,1185,25,340,808,1133
"n3550066","3550066",2759,631,2128,66,150,1886,2018,2169,542,1627,57,119,1424,1530
"n4230001","4230001",1538,241,1297,7,341,934,1265,1031,203,828,6,225,581,805
"n4393114","4393114",4991,3102,1889,196,211,1351,1548,4134,2730,1404,155,154,965,1112
"n4530227","4530227",5312,2165,3147,169,342,2621,2901,4072,1921,2151,145,255,1735,1952
"n4850305","4850305",843,143,700,14,557,131,670,629,109,520,9,431,74,496
"n1410081","1410081",736,7,729,4,1,725,725,567,6,561,4,0,559,559
"n1690002","1690002",1040,664,376,10,50,327,361,787,537,250,4,25,218,240
"n2010259","2010259",3027,38,2989,8,1948,1050,2980,2392,31,2361,3,1671,700,2356
"n2010799","2010799",3032,263,2769,66,1209,1405,2574,2145,236,1909,57,878,916,1774
"n2150006","2150006",5949,639,5310,49,44,5207,5227,4209,574,3635,31,23,3575,3589
"n2450071","2450071",417,258,159,27,24,102,122,291,189,102,16,7,75,79
"n294067","294067",4026,983,3043,160,1140,1842,2820,2803,810,1993,121,679,1199,1812
"n292133","292133",548,179,369,24,37,307,340,389,139,250,11,26,207,232
"n410019","410019",954,159,795,14,108,670,773,670,137,533,12,78,439,515
"n67013T","67013T",2505,1248,1257,21,1046,124,1167,1904,983,921,11,792,70,859
"n850245","850245",5622,2199,3423,930,870,1521,2356,4293,1828,2465,680,627,1055,1668
"n11330A6","11330A6",0,0,0,0,0,0,0,0,0,0,0,0,0,0
"n4890003","4890003",1447,124,1323,4,32,1306,1317,1043,103,940,2,8,928,936
"n2450091","2450091",923,779,144,12,30,91,118,689,586,103,8,27,56,80
"n2910019","2910019",6999,4008,2991,95,989,1766,2725,5315,3265,2050,69,721,1148,1854
"n323003C","323003C",957,130,827,8,5,807,811,716,117,599,5,4,583,586
"n3530009","3530009",2269,1593,676,13,84,539,612,1744,1299,445,12,44,358,398
"n4510435","4510435",2562,1047,1515,50,99,1342,1411,1887,860,1027,24,65,904,954
"n4570011","4570011",170,138,32,1,1,17,18,131,108,23,1,0,14,14
"n1134630","1134630",2653,1047,1606,292,396,885,1257,2128,921,1207,257,270,635,901
"n1131748","1131748",3918,1056,2862,967,732,1168,1868,3074,920,2154,770,538,829,1346
"n2010574","2010574",818,22,796,2,161,642,793,562,12,550,1,117,436,548
"n2010905","2010905",1934,233,1701,22,72,1612,1672,1468,221,1247,11,54,1186,1230
"n2090219","2090219",905,264,641,21,54,569,612,678,227,451,18,41,392,427
"n2150235","2150235",511,87,424,8,5,414,416,394,71,323,7,5,315,317
"n410042","410042",0,0,0,0,0,0,0,0,0,0,0,0,0,0
"n710014","710014",1144,746,398,5,154,195,344,890,607,283,5,118,124,239
"n910102","910102",5432,3902,1530,93,84,1170,1244,4292,3191,1101,69,62,846,902
"n1132021","1132021",3911,3137,774,346,68,290,347,3059,2546,513,229,44,187,227
"n1134661","1134661",3551,231,3320,83,131,3103,3220,2456,197,2259,66,102,2092,2182
"n11331A4","11331A4",0,0,0,0,0,0,0,0,0,0,0,0,0,0
"n2010551","2010551",3791,2591,1200,483,147,492,631,2732,1935,797,326,110,303,408
"n2090113","2090113",5355,1528,3827,116,493,3223,3635,4070,1293,2777,71,379,2302,2642
"n2150212","2150212",5411,182,5229,20,64,5157,5194,3616,133,3483,19,35,3431,3454
"n2450068","2450068",3537,1806,1731,150,1150,377,1512,2720,1494,1226,113,818,252,1062
"n2890004","2890004",1183,914,269,14,75,148,220,956,751,205,10,63,98,160
"n1350208","1350208",6145,2611,3534,363,455,2640,3047,4661,2142,2519,277,305,1872,2152
"n1430047","1430047",573,455,118,9,13,99,108,447,370,77,5,6,65,70
"n1670363","1670363",5313,3384,1929,318,396,1070,1440,3793,2479,1314,225,269,715,967
"n1870220","1870220",177,54,123,2,25,96,121,149,52,97,2,24,71,95
"n2010219","2010219",4025,514,3511,445,2395,686,3035,3388,479,2909,405,1973,532,2472
"n2010882","2010882",6388,912,5476,1949,1827,1765,3498,4826,738,4088,1519,1305,1293,2533
"n214023","214023",2517,1450,1067,43,97,879,942,1892,1203,689,31,58,538,585
"n294021","294021",2037,432,1605,48,287,1309,1529,1545,384,1161,39,194,941,1095
"n292087","292087",2414,827,1587,100,164,1337,1457,1881,686,1195,70,115,986,1084
"n390051","390051",4445,2881,1564,292,243,947,1173,3556,2401,1155,225,176,670,838
"n610084","610084",3171,509,2662,61,58,2538,2584,2315,447,1868,43,31,1782,1811
"n2510007","2510007",3714,2945,769,46,81,522,597,2912,2404,508,27,53,334,384
"n4392403","4392403",255,52,203,10,106,104,196,189,37,152,6,78,81,147
"n2970008","2970008",127,85,42,2,1,36,36,97,69,28,1,1,24,24
"n3290210","3290210",2621,1334,1287,94,237,927,1132,1984,1080,904,62,177,632,788
"n3550046","3550046",770,60,710,3,27,679,698,596,57,539,2,18,518,532
"n3830004","3830004",836,248,588,11,23,555,571,609,187,422,9,17,396,409
"n4310004","4310004",352,238,114,8,9,97,104,249,169,80,2,3,71,74
"n4394243","4394243",3787,1717,2070,84,229,1672,1873,2954,1490,1464,71,158,1146,1292
"n270103","270103",8657,4159,4498,176,847,3343,4115,6444,3364,3080,117,563,2255,2799
"n294044","294044",2821,726,2095,85,456,1572,1971,2207,637,1570,71,360,1131,1466
"n292110","292110",1468,498,970,86,84,789,853,1211,458,753,72,56,606,654
"n390074","390074",789,274,515,6,11,496,502,563,231,332,5,7,315,321
"n650102","650102",128,109,19,0,1,9,10,90,79,11,0,1,4,5
"n850222","850222",6088,2339,3749,2532,616,499,1099,4297,1758,2539,1665,460,345,802
"n3550023","3550023",3206,1925,1281,46,32,1156,1178,2440,1543,897,32,24,798,817
"n10019","10019",3467,2054,1413,41,673,644,1293,2580,1628,952,30,465,402,858
"n294202","294202",5,3,2,0,2,2,2,5,3,2,0,2,2,2
"n510305","510305",730,559,171,4,56,85,139,609,488,121,3,39,56,93
"n1211010","1211010",5271,4027,1244,64,248,712,940,4004,3167,837,38,152,471,611
"n1212093","1212093",713,233,480,327,71,76,141,586,193,393,272,61,53,110
"n1391012","1391012",6812,2209,4603,69,816,3635,4412,4924,1773,3151,41,623,2396,3001
"n4392174","4392174",4546,2141,2405,322,1079,966,1996,3664,1897,1767,271,777,663,1422
"n4393469","4393469",1450,1193,257,62,74,101,171,1203,1018,185,45,58,71,126
"n4394707","4394707",3662,1369,2293,223,561,1482,1999,2402,991,1411,145,326,904,1209
"n4510124","4510124",3496,627,2869,28,441,2405,2803,2500,503,1997,16,361,1605,1941
"n4530381C","4530381C",144,66,78,43,12,18,29,112,61,51,31,6,10,15
"n4910205","4910205",358,292,66,16,4,41,44,284,242,42,14,3,19,22
"n2010877","2010877",5420,1035,4385,757,1641,2018,3585,3649,765,2884,540,1000,1320,2291
"n2090101","2090101",0,0,0,0,0,0,0,0,0,0,0,0,0,0
"n2870404","2870404",1436,598,838,12,209,594,788,1075,504,571,11,158,375,532
"n3610007","3610007",2566,1810,756,91,356,249,592,1925,1406,519,61,245,166,406
"n4010113","4010113",4942,3324,1618,43,599,802,1374,3695,2625,1070,30,418,467,879
"n4394051","4394051",23,5,18,1,2,13,15,12,5,7,0,2,2,4
"n1810308","1810308",1968,1416,552,14,34,398,423,1467,1112,355,6,19,245,264
"n1870215","1870215",1468,901,567,55,105,373,473,1006,630,376,34,81,242,322
"n2010045B","2010045B",0,0,0,0,0,0,0,0,0,0,0,0,0,0
"n2010377","2010377",970,703,267,25,43,170,207,736,550,186,15,26,115,138
"n2010128","2010128",3148,2033,1115,715,79,259,331,2315,1561,754,484,52,182,232
"n2011123","2011123",2690,781,1909,393,566,963,1489,2017,648,1369,280,396,687,1054
"n291076","291076",5222,815,4407,158,431,3813,4187,3835,690,3145,127,331,2680,2981
"n1132146","1132146",4988,1792,3196,360,848,1950,2762,4223,1713,2510,319,613,1525,2116
"n1410013","1410013",4835,925,3910,274,154,3488,3607,3629,726,2903,199,100,2595,2678
"n1410099","1410099",3046,236,2810,40,91,2689,2757,2184,202,1982,23,48,1895,1936
"n1572052","1572052",4133,130,4003,40,2814,1200,3941,3084,110,2974,30,2184,786,2929
"n1571054","1571054",1078,220,858,38,84,735,803,759,181,578,22,57,498,542
"n4570006","4570006",466,444,22,1,3,11,13,400,380,20,1,2,11,12
"n4610006","4610006",550,160,390,5,21,361,377,404,141,263,4,18,240,255
"n4790356","4790356",7857,396,7461,102,63,7325,7365,5427,291,5136,72,39,5027,5056
"n4870019","4870019",2981,1484,1497,140,455,873,1306,2341,1306,1035,92,324,590,912
"n5010202","5010202",1958,655,1303,25,37,1230,1263,1350,521,829,8,14,788,802
"n2150184","2150184",92,30,62,0,1,59,60,66,25,41,0,1,38,39
"n3730012","3730012",654,100,554,9,9,41,46,469,80,389,4,2,22,24
"n4230019","4230019",6010,4708,1302,115,476,554,1016,4377,3508,869,79,330,335,663
"n4391337","4391337",3264,2515,749,77,144,415,546,2605,2089,516,58,101,274,370
"n4393194","4393194",4272,2296,1976,201,245,1425,1650,3146,1804,1342,166,149,945,1081
"n4530136","4530136",2661,1140,1521,76,449,973,1395,2107,995,1112,66,333,682,1002
"n1730001","1730001",285,197,88,0,3,85,87,221,164,57,0,1,55,56
"n2010191","2010191",7021,560,6461,11,402,6042,6405,4664,449,4215,9,238,3941,4164
"n2011063","2011063",5130,385,4745,860,589,3337,3870,3615,334,3281,664,406,2219,2600
"n2010437","2010437",4267,2413,1854,446,544,833,1332,3194,1847,1347,333,412,578,966
"n2010731","2010731",7734,1439,6295,406,1553,4371,5777,5680,1184,4496,307,1068,3121,4100
"n2010523","2010523",7786,2433,5353,353,1089,3875,4872,5737,2054,3683,283,696,2647,3295
"n270303","270303",8257,3888,4369,119,1715,2494,4052,6211,3256,2955,84,1124,1643,2720
"n292060","292060",2746,382,2364,43,181,2160,2306,2191,344,1847,35,136,1683,1799
"n293204","293204",4,4,0,0,0,0,0,4,4,0,0,0,0,0
"n350006","350006",1690,1458,232,10,32,102,130,1474,1301,173,6,20,74,90
"n1134068","1134068",3841,418,3423,35,89,3293,3360,2902,380,2522,24,77,2412,2473
"n1131316","1131316",2551,497,2054,48,1183,811,1970,1952,434,1518,36,879,575,1445
"n4430002B","4430002B",27,22,5,2,1,1,1,26,22,4,2,0,0,0
"n4770320","4770320",2689,2158,531,33,72,351,418,2171,1794,377,25,58,230,286
"n3090081","3090081",6095,4996,1099,48,100,714,801,4575,3864,711,19,66,446,502
"n3390065","3390065",8296,5541,2755,77,133,2279,2387,6349,4457,1892,49,102,1523,1612
"n3490103","3490103",2831,1785,1046,46,393,563,941,2132,1437,695,36,269,352,617
"n3630014","3630014",279,214,65,5,3,52,55,214,174,40,3,3,32,35
"n4393624","4393624",568,243,325,281,22,23,40,380,194,186,158,16,13,26
"n4410406","4410406",5732,3732,2000,89,869,993,1806,4607,3212,1395,69,597,671,1239
"n1132507","1132507",3011,2129,882,155,211,459,644,2331,1734,597,112,135,311,432
"n1410159","1410159",5107,60,5047,35,33,4995,5017,3536,40,3496,21,20,3467,3480
"n1850005","1850005",4610,2244,2366,27,1024,1303,2305,4165,2093,2072,24,944,1086,2019
"n2010583","2010583",2298,50,2248,12,1279,987,2240,1701,42,1659,7,1038,625,1654
"n2030004","2030004",2603,955,1648,22,703,901,1581,1881,785,1096,16,482,578,1051
"n2150084","2150084",5133,263,4870,139,34,4694,4716,3505,183,3322,94,21,3201,3213
"n291122A","291122A",4489,1335,3154,342,619,2278,2815,3172,999,2173,221,420,1556,1944
"n390046","390046",7502,3869,3633,467,1071,1979,2969,5718,3186,2532,340,733,1327,2031
"n610085","610085",4199,803,3396,18,52,3323,3357,3142,694,2448,10,35,2383,2414
"n850071","850071",2320,1565,755,298,151,240,384,1941,1346,595,249,117,182,292
"n1131057","1131057",4145,956,3189,58,237,2860,3061,3144,869,2275,40,182,2005,2167
"n1134532","1134532",659,125,534,23,29,477,500,491,110,381,18,20,334,351
"n4850103","4850103",8215,5423,2792,566,745,1278,1961,5986,4197,1789,415,440,748,1168
"n2771A3B","2771A3B",6444,4527,1917,100,1012,560,1545,5006,3757,1249,74,662,338,989
"n4090107","4090107",359,156,203,0,8,193,199,293,135,158,0,6,150,156
"n4170202","4170202",774,664,110,6,1,82,82,574,501,73,4,0,52,52
"n4394475","4394475",79,50,29,4,6,21,25,57,42,15,4,1,10,11
"n4391459","4391459",3571,647,2924,219,1330,1406,2686,2532,554,1978,166,919,908,1800
"n4830101","4830101",1233,828,405,9,10,378,385,936,693,243,1,5,226,229
"n1410053","1410053",5225,751,4474,115,500,3947,4327,3995,662,3333,99,346,2906,3201
"n1890316","1890316",1909,708,1201,3,41,1125,1165,1455,588,867,1,34,805,838
"n2010483","2010483",9387,3873,5514,1100,1917,2451,4266,7156,3127,4029,891,1314,1766,3023
"n2090351","2090351",3850,1693,2157,171,551,1459,1959,3313,1578,1735,142,489,1107,1562
"n2430005","2430005",241,200,41,4,2,26,27,227,194,33,3,2,19,20
"n2730011","2730011",1129,228,901,12,49,857,888,801,174,627,10,29,590,617
"n291019","291019",2775,224,2551,33,143,2404,2502,1646,189,1457,25,67,1366,1424
"n292105","292105",1166,50,1116,6,40,1086,1105,852,33,819,5,22,797,811
"n293158","293158",151,40,111,25,23,61,80,101,30,71,10,12,46,55
"n530002","530002",5550,3739,1811,96,193,1363,1527,4405,3089,1316,66,160,967,1109
"n750301","750301",1439,860,579,20,155,398,539,1124,708,416,14,115,282,384
"n850217","850217",4121,2510,1611,386,513,630,1124,2827,1755,1072,278,327,411,724
"n4392158","4392158",3765,1753,2012,275,926,727,1633,3096,1552,1544,210,695,548,1237
"n4393422","4393422",3754,2360,1394,690,213,384,591,2474,1628,846,429,133,215,348
"n4710401","4710401",8392,3823,4569,209,2239,1941,4134,7238,3436,3802,176,1828,1637,3437
"n2510015","2510015",2137,1605,532,9,29,400,415,1709,1345,364,7,18,256,266
"n3210010","3210010",501,378,123,4,13,99,112,401,313,88,3,10,67,77
"n3390107","3390107",57,36,21,9,2,5,6,48,30,18,9,2,4,5
"n3390110","3390110",3235,2018,1217,244,259,641,883,2384,1541,843,179,177,418,587
"n3610001","3610001",739,496,243,5,151,76,226,552,396,156,5,86,54,139
"n4391004","4391004",4000,1571,2429,173,1174,1050,2199,3122,1406,1716,115,818,739,1545
"n1134017","1134017",584,359,225,18,79,126,199,531,353,178,16,62,98,155
"n1132910","1132910",321,87,234,9,4,214,218,228,70,158,7,4,142,146
"n1574037","1574037",6371,1395,4976,42,616,4268,4820,4753,1229,3524,25,426,3022,3419
"n2010629","2010629",1360,77,1283,21,662,615,1257,897,56,841,13,446,388,826
"n2150127","2150127",1952,37,1915,8,4,1897,1898,1378,28,1350,5,4,1339,1340
"n2270405","2270405",639,416,223,7,25,192,206,490,357,133,4,8,117,125
"n150208","150208",818,652,166,0,34,109,142,679,562,117,0,27,70,97
"n293060","293060",2604,1103,1501,106,157,1235,1357,2124,993,1131,76,113,926,1021
"n294099","294099",2395,560,1835,45,149,1637,1759,1851,499,1352,43,110,1182,1280
"n410014","410014",9374,1040,8334,55,1537,6741,8160,6205,840,5365,48,1009,4269,5234
"n610039","610039",2824,132,2692,10,20,2672,2682,1953,95,1858,3,13,1845,1852
"n850117","850117",7053,3471,3582,1307,1002,1112,2088,5284,2806,2478,922,657,772,1413
"n4391296","4391296",4050,2510,1540,226,732,549,1252,3411,2216,1195,192,540,417,944
"n4394232","4394232",7904,2770,5134,1330,1233,2576,3688,5468,2086,3382,1005,732,1602,2277
"n4550021","4550021",652,504,148,5,21,94,114,519,439,80,3,7,43,50
"n2710002","2710002",645,181,464,12,19,440,451,465,146,319,7,7,303,310
"n3030178","3030178",380,295,85,1,17,63,77,277,221,56,1,9,43,50
"n3310210","3310210",764,558,206,6,83,115,192,628,467,161,4,68,83,149
"n3550041","3550041",864,33,831,1,16,804,814,643,24,619,1,12,601,611
"n3730006","3730006",5783,4905,878,63,174,374,537,4678,4041,637,41,104,264,361
"n4170404","4170404",72,60,12,0,2,9,10,53,44,9,0,0,7,7
"n1010401","1010401",349,220,129,2,20,100,116,290,191,99,2,19,76,91
"n1133096","1133096",3725,1919,1806,270,865,636,1450,3449,1859,1590,245,750,548,1263
"n1213150","1213150",3680,2579,1101,272,213,487,690,2716,2011,705,176,115,322,432
"n2010774","2010774",1705,272,1433,99,863,507,1315,1255,251,1004,82,574,361,904
"n213003C","213003C",2782,2212,570,34,301,185,469,2263,1810,453,27,248,129,367
"n2450046","2450046",2917,324,2593,147,629,1823,2429,2139,293,1846,112,461,1266,1718
"n50033","50033",1831,1643,188,8,36,82,116,1391,1269,122,8,24,40,64
"n270306","270306",7788,2752,5036,111,2006,2858,4746,6036,2417,3619,92,1426,1993,3377
"n293120","293120",5039,2160,2879,221,310,2326,2569,3906,1810,2096,162,192,1676,1838
"n292145","292145",503,135,368,41,31,301,323,389,115,274,31,18,221,236
"n350003","350003",1728,1201,527,30,106,375,459,1337,971,366,22,73,254,319
"n410031","410031",6241,3443,2798,482,951,1236,2128,4788,2828,1960,369,603,864,1438
"n4530340","4530340",4692,3254,1438,434,150,745,875,3532,2513,1019,319,95,526,611
"n4770307","4770307",2876,1538,1338,149,589,595,1158,2199,1291,908,115,382,395,768
"n489007A","489007A",1537,108,1429,4,21,1412,1428,1089,96,993,3,17,978,992
"n2010420","2010420",7589,4823,2766,159,176,2249,2388,5641,3805,1836,108,117,1441,1542
"n2011083","2011083",0,0,0,0,0,0,0,0,0,0,0,0,0,0
"n2150247","2150247",346,13,333,1,0,332,332,253,12,241,0,0,240,240
"n4210302","4210302",370,246,124,4,7,113,117,282,199,83,1,5,77,80
"n4392645","4392645",3121,1900,1221,238,524,394,895,2178,1403,775,158,328,241,561
"n4530112","4530112",2840,1003,1837,116,771,922,1657,2322,855,1467,99,652,672,1305
"n850091","850091",3818,2195,1623,503,440,599,996,2963,1798,1165,380,292,434,699
"n1571165","1571165",3851,2428,1423,283,480,603,1061,2734,1796,938,194,304,390,682
"n1890102","1890102",295,59,236,5,21,207,224,204,52,152,4,12,128,140
"n2010917","2010917",0,0,0,0,0,0,0,0,0,0,0,0,0,0
"n2010586","2010586",6267,1878,4389,172,1500,2653,4091,4547,1588,2959,128,995,1758,2727
"n2010088","2010088",3719,2276,1443,60,319,952,1243,2892,1876,1016,39,217,653,858
"n90009","90009",191,181,10,0,0,6,6,174,167,7,0,0,3,3
"n292003","292003",4510,164,4346,14,70,4265,4311,3408,119,3289,9,47,3236,3271
"n292168","292168",2783,940,1843,134,264,1453,1683,2211,821,1390,112,191,1081,1254
"n370020","370020",407,285,122,9,84,22,106,324,224,100,9,69,15,84
"n730025","730025",1827,1450,377,16,199,122,317,1329,1059,270,9,153,76,227
"n1134152","1134152",11,0,11,4,1,7,7,2,0,2,0,1,2,2
"n4530140","4530140",856,178,678,53,153,482,618,604,151,453,43,100,313,406
"n4630003","4630003",550,460,90,2,3,73,75,463,398,65,0,1,52,53
"n4790176A","4790176A",3780,100,3680,3,18,3656,3660,2228,57,2171,3,11,2158,2161
"n1574150","1574150",13209,2368,10841,3235,4833,2909,7559,9358,1844,7514,2365,3183,1986,5083
"n2010563","2010563",5003,3333,1670,224,493,839,1296,4047,2806,1241,168,369,608,958
"n2010065","2010065",5238,205,5033,29,99,4926,5002,3957,172,3785,23,65,3706,3764
"n2010728","2010728",1988,763,1225,72,183,947,1111,1466,652,814,59,116,610,717
"n4394632","4394632",0,0,0,0,0,0,0,0,0,0,0,0,0,0
"n4392744","4392744",898,247,651,71,147,411,551,702,233,469,54,118,271,387
"n1132035","1132035",3499,2136,1363,437,345,510,833,3262,2046,1216,396,299,446,733
"n1131102","1131102",6127,372,5755,23,478,5248,5710,4109,331,3778,13,355,3400,3749
"n1133210","1133210",3768,963,2805,116,1159,1507,2629,2863,836,2027,91,835,1060,1877
"n1133618","1133618",801,42,759,19,578,154,716,606,38,568,16,443,99,531
"n1214195","1214195",685,555,130,35,25,57,78,524,439,85,24,19,33,48
"n1391032","1391032",4774,3596,1178,50,207,759,948,3554,2735,819,35,158,501,648
"n610022","610022",4450,186,4264,9,19,4237,4243,3221,149,3072,8,12,3060,3064
"n1131137","1131137",57,7,50,0,0,49,49,33,7,26,0,0,25,25
"n1132079","1132079",5562,1193,4369,518,1963,1814,3726,4472,1118,3354,449,1478,1350,2796
"n1132903","1132903",4257,2504,1753,466,575,629,1170,4040,2426,1614,434,507,575,1063
"n1211007","1211007",1803,1377,426,24,33,280,313,1471,1174,297,9,29,186,215
"n1214169","1214169",3961,2490,1471,335,322,741,1039,3497,2237,1260,304,262,607,859
"n3550058","3550058",1512,778,734,41,25,639,660,1270,692,578,27,19,501,520
"n38702-4","38702-4",540,475,65,1,36,19,52,458,414,44,1,23,15,35
"n4370009","4370009",40,38,2,1,0,1,1,32,31,1,1,0,0,0
"n4394312","4394312",237,85,152,0,12,132,144,190,74,116,0,10,100,110
"n4650024","4650024",3120,223,2897,19,19,2862,2872,2164,197,1967,11,9,1945,1951
"n1391009","1391009",5427,3192,2235,46,176,1865,2017,3939,2487,1452,32,106,1188,1287
"n1672301","1672301",0,0,0,0,0,0,0,0,0,0,0,0,0,0
"n2090450B","2090450B",674,531,143,16,7,89,94,506,422,84,8,2,51,52
"n2510018","2510018",7429,4857,2572,83,377,1766,2111,5691,3974,1717,52,248,1142,1377
"n2990204","2990204",1019,893,126,10,10,70,79,930,839,91,10,5,46,51
"n3290405","3290405",4673,2533,2140,350,346,1361,1670,3505,2035,1470,213,236,957,1171
"n270116","270116",3016,668,2348,185,1385,800,2054,2166,563,1603,131,915,540,1382
"n294056","294056",5546,2040,3506,278,885,2339,3103,4368,1776,2592,195,641,1695,2266
"n410057","410057",919,154,765,23,312,423,726,637,137,500,19,206,268,469
"n850160","850160",490,404,86,5,8,61,68,363,310,53,3,1,39,39
"n910206","910206",5097,3260,1837,137,204,1373,1540,3672,2441,1231,78,135,925,1042
"n1133016","1133016",2856,1077,1779,102,1023,610,1599,2490,1018,1472,86,832,500,1306
"n4970007","4970007",3897,2990,907,64,81,636,702,2981,2351,630,38,35,451,479
"n2010277","2010277",6433,688,5745,39,234,5485,5676,4468,590,3878,25,173,3673,3824
"n2490017","2490017",2059,242,1817,1,11,1795,1800,1572,207,1365,1,8,1350,1355
"n3310420","3310420",3026,2260,766,20,93,548,634,2365,1829,536,16,75,356,431
"n3550084","3550084",1281,299,982,19,45,909,951,1000,272,728,15,31,673,701
"n4391062","4391062",24,18,6,1,0,5,5,20,18,2,0,0,2,2
"n4530307","4530307",4596,3338,1258,268,168,708,842,3737,2812,925,185,121,524,619
"n1150005","1150005",255,149,106,1,1,99,100,179,106,73,0,1,67,68
"n1410136","1410136",3626,108,3518,20,25,3479,3491,2695,93,2602,13,18,2577,2589
"n1470003","1470003",940,604,336,5,222,51,270,749,498,251,3,163,40,202
"n1870229","1870229",209,84,125,0,13,112,124,191,84,107,0,11,96,106
"n1890406","1890406",1872,259,1613,14,165,1439,1573,1228,194,1034,5,114,902,1004
"n2010940","2010940",50,0,50,0,15,33,48,39,0,39,0,15,23,38
"n294082","294082",4418,330,4088,116,2031,2105,3968,2908,260,2648,91,1298,1309,2555
"n550402","550402",2368,505,1863,36,184,1635,1801,1758,430,1328,26,143,1142,1281
"n710006","710006",2620,1486,1134,41,396,648,1036,1975,1200,775,26,288,417,702
"n1131082","1131082",1039,79,960,4,29,923,951,732,71,661,1,25,629,654
"n1391052","1391052",3718,1255,2463,30,1468,911,2346,2734,1004,1730,15,1041,607,1641
"n1610004B","1610004B",57,38,19,1,6,11,17,34,27,7,0,3,3,6
"n3690303","3690303",113,52,61,0,0,60,60,85,43,42,0,0,41,41
"n4391098","4391098",4597,121,4476,14,1188,3300,4444,3109,106,3003,6,915,2083,2981
"n4391701","4391701",2077,970,1107,335,334,379,695,1502,713,789,255,239,243,472
"n4394528","4394528",6015,3202,2813,761,556,1335,1854,4440,2512,1928,576,371,850,1198
"n4930102","4930102",3277,759,2518,41,68,2372,2431,2379,593,1786,28,47,1687,1728
"n1770007","1770007",736,449,287,2,57,216,266,560,377,183,2,40,129,166
"n2010251","2010251",5216,517,4699,36,2395,2248,4606,3635,376,3259,25,1867,1349,3194
"n2090319","2090319",2459,1373,1086,51,93,929,1004,1737,1013,724,30,53,623,672
"n2310430","2310430",1317,750,567,15,107,390,492,940,592,348,13,70,231,296
"n2470002","2470002",1167,124,1043,6,1,997,997,869,103,766,6,1,734,734
"n3070403","3070403",158,147,11,0,2,2,3,150,141,9,0,1,1,1
"n50008","50008",1703,1429,274,29,72,139,200,1257,1103,154,19,35,68,99
"n50013","50013",1258,514,744,25,348,358,686,885,407,478,7,217,228,443
"n670012","670012",1310,940,370,10,275,34,309,1052,761,291,4,221,24,245
"n1131050","1131050",250,189,61,18,10,33,43,162,136,26,5,3,17,20
"n1219304","1219304",0,0,0,0,0,0,0,0,0,0,0,0,0,0
"n1410016","1410016",5256,675,4581,111,122,4361,4443,4137,591,3546,90,78,3381,3435
"n4510401","4510401",293,131,162,8,52,109,145,218,119,99,6,21,65,85
"n2450006","2450006",2518,516,2002,41,1224,749,1947,1892,462,1430,26,876,514,1383
"n3030017","3030017",6548,2155,4393,73,730,3533,4148,4975,1895,3080,58,485,2451,2887
"n3810420","3810420",5155,3718,1437,62,210,1022,1193,3860,2977,883,40,115,610,712
"n4391623","4391623",0,0,0,0,0,0,0,0,0,0,0,0,0,0
"n4391610","4391610",74,34,40,4,10,26,36,47,23,24,4,10,10,20
"n4392553","4392553",2809,723,2086,185,724,1155,1840,2089,610,1479,161,502,783,1268
"n1630006","1630006",860,376,484,2,31,443,469,670,328,342,1,23,315,333
"n2011109","2011109",89,64,25,5,14,10,23,89,64,25,5,14,10,23
"n2011103","2011103",3278,979,2299,277,510,1489,1946,2499,821,1678,216,362,1053,1400
"n2090423B","2090423B",0,0,0,0,0,0,0,0,0,0,0,0,0,0
"n223001A","223001A",1987,1344,643,14,193,368,557,1467,1032,435,7,133,240,372
"n2370003","2370003",296,198,98,4,13,79,87,204,149,55,4,5,43,47
"n250010","250010",2838,437,2401,32,110,2241,2328,1987,338,1649,29,64,1543,1602
"n292181G","292181G",36,9,27,1,7,27,27,25,9,16,1,4,16,16
"n410074","410074",5221,2237,2984,908,770,1556,2056,5172,2223,2949,898,766,1536,2033
"n910407","910407",3721,2959,762,66,38,579,606,2792,2267,525,38,27,390,412
"n1134112","1134112",1868,1257,611,117,114,312,419,1848,1255,593,113,113,300,406
"n1133321","1133321",0,0,0,0,0,0,0,0,0,0,0,0,0,0
"n3090043","3090043",1244,690,554,32,223,295,500,1008,621,387,28,135,208,337
"n3670120","3670120",3555,2853,702,34,66,436,500,2600,2165,435,24,30,259,288
"n4391518","4391518",2127,503,1624,66,1220,350,1541,1760,472,1288,53,946,293,1216
"n4392464","4392464",569,347,222,66,62,86,147,450,291,159,48,46,55,101
"n4530271","4530271",3374,2486,888,446,53,344,389,2401,1800,601,292,38,230,263
"n4790267","4790267",5019,131,4888,24,62,4795,4852,3458,99,3359,18,60,3280,3337
"n1410116","1410116",7419,677,6742,191,486,6133,6522,5127,484,4643,121,309,4212,4482
"n1870212","1870212",253,79,174,4,26,140,164,208,77,131,2,21,100,121
"n2010543","2010543",3984,259,3725,25,87,3594,3661,3018,242,2776,18,56,2686,2731
"n2010960","2010960",3360,391,2969,223,1934,835,2728,2450,328,2122,151,1400,575,1951
"n2210107","2210107",1257,1106,151,5,9,86,93,941,847,94,3,7,47,52
"n2410008","2410008",1628,678,950,12,824,84,907,1188,550,638,5,561,48,609
"n212015","212015",4581,2941,1640,64,570,887,1434,3582,2457,1125,42,406,581,974
"n293097","293097",24,19,5,0,0,3,3,11,10,1,0,0,1,1
"n410051","410051",0,0,0,0,0,0,0,0,0,0,0,0,0,0
"n610002","610002",905,318,587,13,5,569,573,737,303,434,13,4,416,420
"n950408","950408",1387,786,601,14,73,521,585,1299,752,547,12,67,471,532
"n1410093","1410093",2208,239,1969,16,51,1918,1941,1751,202,1549,12,28,1508,1525
"n4530242","4530242",8429,1961,6468,354,668,5419,5971,6379,1777,4602,309,508,3744,4170
"n4850407","4850407",900,790,110,8,8,61,67,711,636,75,3,4,40,44
"n4910166","4910166",3572,2168,1404,368,288,681,943,3048,1944,1104,293,244,517,737
"n3090068","3090068",1692,1352,340,10,46,222,260,1333,1093,240,8,30,150,177
"n3290204","3290204",6243,4289,1954,140,296,1377,1647,4798,3457,1341,91,196,941,1127
"n3550078","3550078",2490,110,2380,10,351,2041,2361,1908,95,1813,6,267,1547,1803
"n3550126","3550126",7016,2822,4194,514,358,3364,3647,5005,2174,2831,346,263,2212,2440
"n3670320","3670320",2945,2429,516,26,40,359,395,2268,1931,337,12,23,223,245
"n4391165","4391165",415,171,244,2,22,222,238,297,140,157,2,10,145,153
"n1710008","1710008",420,304,116,2,2,91,93,347,261,86,0,0,65,65
"n1870305","1870305",6675,3202,3473,437,979,2068,2944,4917,2488,2429,297,698,1358,2010
"n2010443","2010443",816,610,206,79,25,90,113,613,468,145,59,16,57,72
"n2010983","2010983",5953,2133,3820,881,1126,1805,2888,4327,1679,2648,626,784,1205,1970
"n2450083","2450083",1952,1434,518,82,107,290,390,1463,1146,317,62,56,172,225
"n3090020","3090020",1218,424,794,44,383,374,724,950,378,572,38,277,247,515
"n610065","610065",5553,372,5181,12,35,5140,5153,3749,300,3449,6,16,3422,3427
"n850097","850097",1530,1280,250,63,47,117,157,1236,1068,168,38,26,79,100
"n990103","990103",545,405,140,8,12,104,115,416,321,95,8,2,73,74
"n1132016","1132016",4103,3197,906,302,183,380,530,3430,2745,685,230,121,278,386
"n1214211","1214211",5400,4511,889,151,134,429,554,4107,3521,586,95,96,278,366
"n1410073","1410073",2138,98,2040,10,37,1998,2018,1748,90,1658,9,30,1621,1641
"n3030038","3030038",2977,789,2188,13,302,1882,2123,2144,629,1515,3,202,1287,1474
"n3810204","3810204",6033,4326,1707,270,223,1093,1301,4651,3473,1178,190,157,716,864
"n41901SW","41901SW",1883,1312,571,26,194,318,511,1466,1043,423,16,166,216,381
"n4391388","4391388",7956,1768,6188,1481,3409,1226,4516,5936,1471,4465,1104,2359,904,3191
"n1571148A","1571148A",19438,9052,10386,3273,2445,4407,6743,12547,6081,6466,2047,1487,2753,4190
"n1670353","1670353",7390,3988,3402,300,657,2298,2915,5910,3476,2434,233,491,1589,2054
"n2150004","2150004",5173,201,4972,28,40,4925,4934,3737,169,3568,26,10,3531,3533
"n2150253","2150253",721,129,592,1,5,582,584,576,129,447,1,3,437,439
"n2450026","2450026",3896,2014,1882,266,988,555,1529,3131,1718,1413,215,720,423,1131
"n2650405","2650405",1977,1652,325,16,16,234,249,1689,1472,217,11,8,153,161
"n390009","390009",5764,2177,3587,47,1708,1821,3509,5351,2043,3308,32,1627,1633,3248
"n810001","810001",834,603,231,4,6,189,190,623,467,156,2,3,120,121
"n1134088","1134088",3376,115,3261,27,193,3052,3206,2433,87,2346,18,145,2182,2302
"n1131171","1131171",3451,2276,1175,152,308,616,917,2853,1915,938,124,247,489,730
"n1133612","1133612",4206,436,3770,49,3094,621,3689,3310,392,2918,37,2445,410,2849
"n1350403","1350403",5997,256,5741,14,601,5123,5695,4346,196,4150,7,448,3685,4120
"n3490307","3490307",935,487,448,25,50,341,390,709,422,287,9,33,216,248
"n397003AB","397003AB",96,70,26,1,3,22,24,65,54,11,0,3,8,10
"n4394602","4394602",0,0,0,0,0,0,0,0,0,0,0,0,0,0
"n4392002","4392002",0,0,0,0,0,0,0,0,0,0,0,0,0,0
"n1573139","1573139",2936,395,2541,2109,305,125,424,2215,294,1921,1593,236,91,322
"n2010023","2010023",3628,50,3578,53,278,3257,3510,2510,37,2473,46,236,2193,2416
"n2090205","2090205",5608,2095,3513,165,446,2862,3244,3993,1645,2348,124,289,1891,2153
"n2310108","2310108",3340,1757,1583,30,495,971,1448,2454,1371,1083,21,373,621,983
"n2910009","2910009",4701,4052,649,19,93,433,516,3497,3091,406,9,64,263,321
"n3390046","3390046",6117,3513,2604,527,804,1213,1969,4023,2397,1626,326,502,745,1226
"n130009","130009",5009,990,4019,63,85,3840,3886,3598,823,2775,36,60,2627,2662
"n291102","291102",2115,483,1632,17,69,1528,1586,1594,407,1187,9,50,1101,1148
"n293077","293077",2923,1682,1241,148,72,1006,1068,2392,1451,941,92,53,766,815
"n294119","294119",922,421,501,47,57,400,452,826,392,434,46,56,334,386
"n850134","850134",6806,2717,4089,1900,1214,860,2053,4511,1900,2611,1237,763,519,1270
"n1110003","1110003",36,36,0,0,0,0,0,32,32,0,0,0,0,0
"n4550003","4550003",656,596,60,3,10,18,26,569,527,42,2,10,11,19
"n4850208","4850208",603,396,207,4,33,148,179,471,331,140,2,20,102,121
"n4970022","4970022",1654,1333,321,11,22,239,250,1318,1094,224,2,9,169,174
"n2450063","2450063",1724,73,1651,9,1397,229,1619,1282,68,1214,8,1048,145,1189
"n2750101","2750101",836,561,275,9,30,225,249,667,473,194,4,22,155,176
"n4130001","4130001",592,289,303,7,14,294,298,451,252,199,4,10,192,196
"n4391555","4391555",72,9,63,1,37,25,61,58,9,49,0,32,16,48
"n4391244","4391244",306,138,168,5,39,110,144,205,115,90,4,17,56,70
"n4530163","4530163",4968,1981,2987,625,885,1430,2240,3801,1612,2189,458,657,1008,1629
"n1410036","1410036",3919,422,3497,139,165,3185,3320,3384,397,2987,123,140,2697,2825
"n149301W","149301W",2399,1831,568,31,137,372,491,1922,1545,377,27,84,239,317
"n2010791","2010791",0,0,0,0,0,0,0,0,0,0,0,0,0,0
"n2010214","2010214",2558,1447,1111,650,87,357,440,1935,1161,774,450,59,243,300
"n2011040","2011040",3845,223,3622,253,548,2821,3341,2683,186,2497,222,403,1867,2258
"n2010463","2010463",5293,1166,4127,379,1957,1820,3684,4108,1026,3082,312,1428,1325,2705
"n291039","291039",8087,396,7691,57,284,7431,7624,5413,304,5109,38,156,4945,5066
"n293139B","293139B",134,83,51,19,7,31,31,89,55,34,18,1,14,14
"n410093","410093",0,0,0,0,0,0,0,0,0,0,0,0,0,0
"n550101","550101",1182,449,733,16,103,611,699,896,372,524,9,73,435,498
"n1132401","1132401",5020,2629,2391,329,517,1458,1945,4095,2336,1759,265,383,1031,1394
"n1212070","1212070",273,144,129,43,49,34,81,189,105,84,36,30,13,43
"n3090062","3090062",5637,3720,1917,185,665,975,1604,4588,3188,1400,132,476,690,1161
"n3650007","3650007",1044,760,284,2,234,32,264,786,563,223,0,190,23,212
"n4393363","4393363",5047,3154,1893,227,586,984,1531,3522,2298,1224,147,387,606,979
"n4393720","4393720",2788,2292,496,100,62,221,278,2147,1821,326,59,35,141,176
"n4530405","4530405",5048,1606,3442,189,677,2562,3163,4012,1416,2596,147,512,1870,2353
"n4910150","4910150",8476,3130,5346,244,1125,3921,4911,6573,2689,3884,182,790,2809,3539
"n1810104","1810104",1453,1191,262,21,22,150,168,1153,968,185,15,15,97,109
"n1870119","1870119",2507,1571,936,28,75,807,869,2044,1355,689,23,41,589,630
"n2010854","2010854",383,4,379,1,102,282,379,300,4,296,0,92,208,296
"n2010400","2010400",22,0,22,0,6,13,16,15,0,15,0,4,7,10
"n2150147","2150147",577,27,550,13,9,532,534,352,16,336,9,6,322,324
"n2150061","2150061",6235,205,6030,50,47,5959,5972,4325,148,4177,43,25,4122,4127
"n293040","293040",2806,1295,1511,113,133,1236,1343,2222,1085,1137,76,108,915,1007
"n291138","291138",3243,757,2486,238,490,1771,2193,2578,645,1933,178,389,1346,1695
"n291144","291144",2643,1875,768,118,146,511,627,2454,1851,603,75,105,396,490
"n293034","293034",3053,2431,622,61,46,445,486,2478,2027,451,41,38,305,339
"n1134513","1134513",7997,1179,6818,118,1999,4660,6575,5585,1025,4560,95,1304,3106,4374
"n1134507","1134507",2421,218,2203,39,844,1345,2154,1676,176,1500,21,641,849,1470
"n4530225","4530225",3538,2258,1280,475,132,593,710,2977,1911,1066,388,116,492,600
"n4590009","4590009",2894,2295,599,17,317,165,480,2228,1793,435,6,242,102,343
"n4590003","4590003",2264,1668,596,14,137,359,488,1748,1348,400,6,103,220,319
"n4790457","4790457",87,15,72,1,5,70,70,70,13,57,1,5,55,55
"n2010500","2010500",6754,2936,3818,659,1278,1848,3065,5153,2417,2736,494,924,1276,2163
"n3090006","3090006",2352,195,2157,13,129,2026,2128,1684,175,1509,9,79,1414,1486
"n3370010","3370010",1762,1276,486,12,24,386,409,1319,1001,318,10,11,246,256
"n3370004","3370004",1154,906,248,1,9,187,196,839,677,162,1,6,117,123
"n3550021","3550021",607,310,297,30,24,215,229,531,287,244,29,16,168,180
"n4394551","4394551",7228,3570,3658,344,1074,2120,3118,5089,2749,2340,231,654,1340,1963
"n1133111","1133111",0,0,0,0,0,0,0,0,0,0,0,0,0,0
"n1133117","1133117",108,33,75,0,64,8,72,104,33,71,0,60,8,68
"n2010257","2010257",11527,680,10847,472,3390,7136,10295,7925,562,7363,370,2239,4798,6925
"n2010748","2010748",4479,1590,2889,428,922,1552,2396,3478,1367,2111,329,644,1117,1718
"n2010754","2010754",5145,129,5016,162,2958,1959,4832,3414,112,3302,107,2052,1185,3188
"n2010506","2010506",5861,435,5426,383,2531,2543,4995,4574,384,4190,315,2071,1809,3842
"n294225","294225",915,399,516,44,90,379,455,692,321,371,32,61,277,331
"n292125","292125",5046,1446,3600,433,650,2598,3149,3329,1053,2276,280,405,1607,1974
"n292082","292082",3443,381,3062,45,199,2839,2983,2557,346,2211,35,128,2050,2153
"n1134043","1134043",2893,99,2794,17,532,2251,2761,2043,75,1968,13,450,1499,1939
"n1133982","1133982",5658,2583,3075,1032,605,1292,1870,4059,1998,2061,719,395,824,1212
"n1131703","1131703",7234,1118,6116,1389,823,3890,4672,5248,968,4280,1070,567,2610,3163
"n3390087","3390087",8055,5051,3004,720,783,1351,2066,5297,3397,1900,460,516,819,1298
"n3450004","3450004",270,241,29,3,1,17,18,219,203,16,2,1,6,7
"n3910004","3910004",940,219,721,20,167,548,692,707,171,536,13,119,403,512
"n4490002","4490002",1032,472,560,13,168,365,524,758,382,376,10,129,225,348
"n291111","291111",5452,1131,4321,257,522,3583,4037,4078,930,3148,186,391,2569,2929
"n2010909","2010909",4131,2040,2091,798,384,874,1235,2776,1416,1360,531,245,558,795
"n1132090","1132090",103,41,62,8,15,40,54,81,34,47,7,13,27,40
"n4130004","4130004",644,422,222,11,12,198,202,483,344,139,6,7,120,122
"n3550112","3550112",3306,1021,2285,71,184,2051,2187,2652,903,1749,51,128,1558,1669
"n294188","294188",0,0,0,0,0,0,0,0,0,0,0,0,0,0
"n2010612","2010612",4566,3349,1217,116,191,795,974,3382,2587,795,85,128,486,606
"n1132045","1132045",2651,1805,846,187,159,441,591,2096,1463,633,152,113,313,426
"n1170002","1170002",4598,743,3855,14,67,3743,3773,3185,607,2578,12,40,2490,2509
"n1350303","1350303",4262,973,3289,61,254,2949,3153,3296,844,2452,48,187,2195,2346
"n2410017","2410017",1543,1398,145,13,28,69,96,1157,1081,76,6,17,34,50
"n3410301","3410301",5340,1165,4175,267,164,3664,3809,3811,961,2850,183,101,2483,2577
"n1213159","1213159",8048,4556,3492,240,636,2372,2961,5975,3661,2314,188,421,1487,1895
"n1131732","1131732",2981,667,2314,966,617,734,1337,2309,586,1723,771,434,507,937
"n1890203","1890203",1352,125,1227,10,88,1138,1210,970,107,863,8,55,796,849
"n3490109","3490109",741,359,382,7,46,306,347,529,292,237,4,22,194,216
"n4391012","4391012",3942,1260,2682,143,1096,1425,2482,2945,1100,1845,115,788,913,1684
"n2010737","2010737",71,21,50,0,10,40,48,61,21,40,0,9,31,39
"n291068","291068",5413,988,4425,177,477,3815,4214,3564,733,2831,93,271,2429,2678
"n1870308","1870308",2911,1733,1178,131,245,768,990,2170,1352,818,86,173,507,667
"n2010969","2010969",792,2,790,6,709,74,777,625,2,623,4,567,46,610
"n310102","310102",2768,2043,725,29,34,570,600,2234,1714,520,15,27,404,428
"n4530230","4530230",5522,3929,1593,791,105,570,662,4521,3254,1267,655,75,445,510
"n2010757","2010757",8920,380,8540,1071,3831,3704,7424,6160,314,5846,804,2637,2411,4998
"n530008","530008",1607,1209,398,10,73,265,334,1337,1061,276,8,48,177,221
"n4530345","4530345",4193,2547,1646,451,170,923,1073,3366,2099,1267,335,135,713,833
"n1214178","1214178",3050,1557,1493,229,329,871,1178,2475,1365,1110,193,251,596,834
"n2010800","2010800",7238,2905,4333,406,1508,2437,3852,5448,2383,3065,303,1071,1658,2681
"n510113","510113",1040,742,298,11,91,165,254,824,611,213,8,67,112,177
"n4510421","4510421",5020,3032,1988,220,280,1393,1646,3959,2550,1409,174,191,957,1137
"n2010015","2010015",4111,2954,1157,650,48,390,436,2941,2216,725,395,29,251,278
"n2490009","2490009",1362,132,1230,2,9,1221,1228,921,118,803,2,4,798,802
"n410040","410040",4863,3734,1129,309,115,566,664,3865,3037,828,238,88,402,482
"n1214220","1214220",4131,2742,1389,69,181,982,1144,3014,2102,912,47,108,628,727
"n2550003","2550003",154,119,35,2,4,29,32,127,104,23,1,2,20,21
"n4391586","4391586",32,0,32,6,15,8,23,24,0,24,5,11,5,16
"n4530170","4530170",6411,1931,4480,328,1317,2815,4045,5018,1701,3317,254,985,2015,2958
"n4392058","4392058",62,34,28,5,5,17,22,49,29,20,5,5,9,14
"n1330009","1330009",657,595,62,1,6,41,47,583,535,48,0,3,34,37
"n2010694","2010694",3131,666,2465,526,922,1034,1905,2226,549,1677,410,561,697,1236
"n2330011","2330011",2753,1835,918,21,89,688,762,1932,1421,511,14,36,353,386
"n3290207","3290207",4356,2526,1830,57,442,1230,1645,3415,2055,1360,43,345,891,1222
"n410102","410102",9,6,3,0,1,2,3,4,3,1,0,1,0,1
"n1131328","1131328",45,7,38,4,13,22,34,31,3,28,3,10,14,24
"n2450055","2450055",443,9,434,4,377,51,428,368,9,359,3,312,43,355
"n1910101","1910101",713,308,405,11,98,294,386,523,265,258,3,61,185,243
"n4391117","4391117",2697,1950,747,104,92,453,532,2209,1644,565,80,70,337,400
"n1132309","1132309",3801,1046,2755,1271,887,586,1441,3397,990,2407,1117,777,488,1246
"n570007","570007",3696,1479,2217,541,103,1521,1606,2862,1252,1610,414,82,1057,1135
"n1870221","1870221",45,16,29,0,1,29,29,44,16,28,0,0,28,28
"n1132110","1132110",1295,35,1260,16,244,1002,1235,947,27,920,11,190,719,903
"n4530386C","4530386C",61,45,16,5,0,8,8,43,35,8,1,0,7,7
"n1211053","1211053",785,307,478,31,290,142,427,619,265,354,24,203,115,316
"n610051","610051",3820,126,3694,5,15,3677,3685,2590,101,2489,5,10,2478,2484
"n3390055","3390055",4025,1654,2371,19,90,2211,2290,2692,1277,1415,18,65,1296,1358
"n390055","390055",5246,2679,2567,79,916,1538,2389,3893,2131,1762,53,629,1019,1623
"n2270045","2270045",1494,811,683,42,75,571,630,1082,648,434,30,51,354,397
"n1132025","1132025",3073,2667,406,141,36,183,212,2654,2346,308,103,24,136,157
"n292012","292012",2990,81,2909,22,41,2863,2885,2230,69,2161,16,25,2124,2141
"n2010926","2010926",5572,2151,3421,924,667,1794,2416,3984,1607,2377,651,462,1213,1656
"n2010632","2010632",100,49,51,1,10,39,49,68,35,33,1,10,21,31
"n1410022","1410022",4562,1035,3527,121,144,3251,3357,3680,900,2780,94,105,2554,2639
"n1213116","1213116",9235,2524,6711,4122,1569,988,2495,7056,2089,4967,3074,1154,694,1817
"n2010863","2010863",953,34,919,8,572,346,904,700,32,668,5,430,238,660
"n1830015","1830015",3901,1708,2193,16,692,1406,2080,2818,1332,1486,9,552,856,1402
"n4391351","4391351",0,0,0,0,0,0,0,0,0,0,0,0,0,0
"n1391018","1391018",5611,1525,4086,42,1014,3004,3991,4069,1274,2795,14,739,2000,2735
"n3370013","3370013",1298,1104,194,1,5,105,109,1002,862,140,1,4,72,75
"n4530471","4530471",6879,1761,5118,251,634,4212,4764,5035,1478,3557,173,436,2904,3303
"n390078","390078",4823,1604,3219,84,1308,1780,3066,4056,1401,2655,65,1180,1376,2537
"n1214181","1214181",6650,4165,2485,380,678,1283,1912,4840,3201,1639,259,428,827,1243
"n1212096","1212096",5144,2876,2268,1563,200,401,590,3607,2035,1572,1100,138,257,391
"n2010717","2010717",4185,143,4042,296,1466,2296,3713,3090,124,2966,267,1136,1561,2674
"n291005","291005",1516,80,1436,6,21,1419,1430,1182,62,1120,2,14,1109,1118
"n37008C","37008C",3336,2231,1105,13,613,354,954,2878,1930,948,9,536,299,826
"n4530253","4530253",6169,1323,4846,675,880,3341,4121,4300,1081,3219,539,595,2096,2645
"n2010777","2010777",3785,218,3567,42,189,3325,3499,2487,165,2322,34,104,2164,2264
"n4230074","4230074",961,730,231,97,69,53,122,798,627,171,66,67,31,98
"n150311","150311",2349,612,1737,33,437,1264,1659,1732,488,1244,25,318,876,1182
"n2010675A","2010675A",5997,2681,3316,156,794,2294,3047,4336,2105,2231,117,551,1492,2013
"n270309","270309",1826,1330,496,26,102,324,410,1492,1130,362,18,71,228,292
"n4530173","4530173",2165,1344,821,82,212,492,695,1733,1129,604,57,163,349,510
"n350009","350009",1566,983,583,18,61,444,497,1219,824,395,9,37,301,337
"n1730004","1730004",275,147,128,1,10,121,125,188,106,82,1,9,77,81
"n321001A","321001A",3869,1891,1978,62,181,1695,1845,2897,1562,1335,42,127,1113,1230
"n214024","214024",3724,1650,2074,42,175,1803,1958,2690,1335,1355,27,117,1152,1266
"n2010820","2010820",2742,694,2048,170,660,1207,1830,1988,556,1432,125,478,800,1261
"n4530120","4530120",4494,770,3724,56,995,2713,3656,3429,726,2703,40,868,1809,2647
"n1810204","1810204",166,103,63,0,2,60,62,126,83,43,0,1,42,43
"n4530322","4530322",3891,3149,742,304,51,327,368,2941,2433,508,193,34,224,252
"n1213139","1213139",6383,4325,2058,1097,244,560,791,4889,3446,1443,742,190,378,565
"n4391270","4391270",1289,467,822,30,206,575,775,957,420,537,23,145,356,498
"n291022","291022",1643,49,1594,4,11,1589,1589,1231,34,1197,4,6,1194,1194
"n1230201","1230201",725,447,278,3,47,226,261,555,361,194,3,30,157,181
"n1131304","1131304",3215,755,2460,60,408,1969,2358,2334,662,1672,47,287,1315,1593
"n3390096","3390096",8372,3783,4589,706,1205,2506,3664,5768,2770,2998,496,736,1631,2343
"n1870218","1870218",145,30,115,0,2,114,115,98,19,79,0,1,79,79
"n1050002","1050002",802,348,454,8,5,435,437,594,306,288,8,4,273,275
"n2190016","2190016",2838,1782,1056,13,107,899,997,2199,1465,734,10,91,591,679
"n2010949","2010949",3047,527,2520,390,1212,920,2112,2420,466,1954,310,982,664,1631
"n292094","292094",194,126,68,11,1,47,48,152,108,44,6,1,28,29
"n1950003","1950003",389,231,158,0,3,148,148,300,185,115,0,0,105,105
"n4391739","4391739",223,14,209,3,171,34,201,123,9,114,2,94,18,112
"n610031","610031",595,102,493,2,3,488,488,431,92,339,2,3,337,337
"n1370002","1370002",344,235,109,10,9,93,97,287,208,79,6,9,66,70
"n3550010","3550010",1436,782,654,4,14,598,608,1123,679,444,2,10,412,420
"n1132417","1132417",468,199,269,56,57,152,201,396,190,206,49,38,111,145
"n2450032","2450032",335,261,74,29,23,21,44,304,239,65,27,22,14,36
"n2450075","2450075",1448,233,1215,234,700,282,967,1205,224,981,222,539,220,746
"n291065","291065",4461,708,3753,19,62,3678,3703,3259,595,2664,13,31,2621,2633
"n2010077","2010077",0,0,0,0,0,0,0,0,0,0,0,0,0,0
"n550204","550204",2239,1288,951,12,69,798,861,1663,1068,595,6,31,490,519
"n2010035","2010035",443,261,182,25,14,132,146,349,194,155,20,12,112,124
"n2011012","2011012",4583,169,4414,734,632,3069,3668,3199,145,3054,581,461,2008,2456
"n292032","292032",1158,25,1133,10,47,1075,1120,805,21,784,7,17,757,774
"n4391424","4391424",12,8,4,0,3,3,4,10,8,2,0,2,2,2
"n5030006","5030006",259,198,61,3,3,41,44,213,168,45,3,1,29,30
"n2510008","2510008",7190,2879,4311,52,122,3900,3999,5190,2348,2842,31,66,2550,2613
"n3470024","3470024",3122,1224,1898,46,1269,578,1829,2501,1113,1388,35,943,401,1334
"n1850012","1850012",1472,869,603,6,169,406,567,1174,749,425,4,140,263,403
"n1410002","1410002",6502,468,6034,44,116,5818,5907,5043,429,4614,32,89,4426,4504
"n231214B","231214B",1875,1448,427,16,23,329,351,1481,1225,256,13,9,183,192
"n2010906","2010906",6467,3179,3288,1409,577,1209,1751,4212,2209,2003,846,371,714,1068
"n4530446","4530446",4546,2767,1779,191,267,1245,1487,3835,2438,1397,158,213,948,1145
"n3270005","3270005",88,79,9,0,0,8,8,71,65,6,0,0,6,6
"n470001","470001",1764,118,1646,13,12,1623,1632,1292,97,1195,13,9,1173,1182
"n3390017","3390017",7532,4460,3072,67,210,2582,2772,5453,3511,1942,44,154,1577,1724
"n2230024","2230024",1096,924,172,5,19,88,107,853,737,116,4,10,61,71
"n291127","291127",1082,50,1032,4,16,1023,1027,814,42,772,4,10,766,769
"n4391009","4391009",2252,1350,902,57,283,521,792,1748,1144,604,33,169,351,515
"n1214198","1214198",3834,3189,645,73,56,402,449,2839,2414,425,58,32,250,279
"n4510146","4510146",7641,2010,5631,85,391,5056,5383,5944,1787,4157,57,283,3705,3957
"n3510019","3510019",256,216,40,0,28,3,31,197,168,29,0,19,3,22
"n2010883","2010883",6668,298,6370,157,2321,3958,6187,4670,256,4414,123,1658,2670,4276
"n4410207","4410207",516,403,113,13,9,76,80,386,313,73,7,4,43,46
"n1131111","1131111",4933,362,4571,68,767,3725,4457,3223,287,2936,42,558,2327,2868
"n4530370","4530370",6206,3753,2453,297,142,1825,1948,4722,3043,1679,208,83,1231,1308
"n410060","410060",146,110,36,2,12,15,27,110,85,25,2,9,9,18
"n3390074","3390074",5440,2596,2844,98,240,2365,2582,3976,2102,1874,58,164,1527,1681
"n390035","390035",2487,1687,800,16,39,659,698,1949,1375,574,15,27,457,484
"n1131729","1131729",4355,528,3827,366,687,2734,3399,3107,464,2643,261,497,1832,2321
"n1211033","1211033",4402,3084,1318,491,304,436,716,2814,2007,807,301,209,258,450
"n2450009","2450009",5296,3911,1385,323,208,778,961,4155,3141,1014,238,173,534,691
"n270208","270208",7450,2038,5412,563,2921,2013,4642,5429,1679,3750,394,2014,1289,3174
"n1131007","1131007",490,424,66,27,4,29,33,373,320,53,24,3,21,24
"n1132130","1132130",6785,701,6084,150,909,5041,5896,4801,648,4153,120,741,3293,3999
"n4230022","4230022",1726,952,774,38,449,344,720,1568,934,634,30,392,267,588
"n4391641","4391641",5623,1879,3744,664,1917,1141,3004,4157,1518,2639,474,1360,758,2094
"n2650118","2650118",884,634,250,25,49,169,214,797,596,201,20,45,129,173
"n50037","50037",845,555,290,6,104,169,271,595,423,172,4,51,107,158
"n1350103","1350103",5252,1498,3754,21,93,3582,3648,3631,1143,2488,14,64,2364,2409
"n1670384","1670384",1827,1209,618,50,67,446,504,1413,1007,406,35,45,279,319
"n990206","990206",6931,2926,4005,435,1690,1789,3312,4402,2022,2380,267,969,1029,1924
"n410106","410106",831,281,550,23,265,259,506,630,255,375,19,175,172,341
"n4530281","4530281",4060,3174,886,100,88,563,638,3347,2713,634,74,64,392,446
"n4690023","4690023",2299,1510,789,12,75,666,724,1744,1198,546,5,53,446,493
"n1890409","1890409",1593,426,1167,19,115,1025,1126,1163,357,806,11,83,698,775
"n3390058","3390058",2995,2429,566,160,48,302,346,2273,1922,351,98,27,185,210
"n1214201","1214201",3014,2193,821,216,160,350,503,2113,1566,547,147,106,222,327
"n4391477","4391477",3863,157,3706,32,727,2981,3676,2599,141,2458,21,563,1890,2438
"n1132107","1132107",64,18,46,4,18,27,42,50,17,33,1,14,17,30
"n1131402","1131402",7574,1223,6351,48,1586,4706,6227,5139,1027,4112,34,1060,2979,4020
"n2150213","2150213",511,47,464,0,0,461,461,368,37,331,0,0,330,330
"n4550012","4550012",159,141,18,0,9,9,18,128,111,17,0,8,9,17
"n4391346","4391346",2536,98,2438,10,1294,1142,2409,1629,85,1544,2,874,665,1530
"n1270007","1270007",1084,162,922,10,7,909,912,814,149,665,10,4,652,655
"n292009","292009",6076,1416,4660,1501,904,2288,3104,4607,1152,3455,986,651,1808,2410
"n3390020","3390020",5612,1487,4125,66,409,3602,3971,3951,1228,2723,47,285,2349,2615
"n2010840","2010840",3372,530,2842,78,1045,1712,2716,2466,466,2000,63,776,1156,1901
"n270101","270101",9266,6534,2732,407,673,1491,2089,7294,5325,1969,292,510,1032,1493
"n2270037","2270037",0,0,0,0,0,0,0,0,0,0,0,0,0,0
"n4530202","4530202",3721,2419,1302,520,188,547,724,3460,2299,1161,457,176,484,651
"n390032","390032",4104,2752,1352,35,289,938,1209,3196,2243,953,27,208,624,826
"n410063","410063",2501,1944,557,44,97,346,441,2092,1662,430,33,76,259,335
"n2010866","2010866",0,0,0,0,0,0,0,0,0,0,0,0,0,0
"n2450095","2450095",1069,429,640,214,189,229,407,843,374,469,165,144,151,288
"n1410045","1410045",6273,1157,5116,261,800,4120,4803,4620,948,3672,188,573,2902,3425
"n130012","130012",2271,591,1680,22,44,1606,1635,1679,499,1180,15,25,1136,1153
"n291150","291150",4615,1046,3569,296,579,2762,3246,3235,816,2419,203,385,1838,2184
"n1810404","1810404",5824,4929,895,76,131,299,424,4561,3979,582,48,76,177,251
"n4530474","4530474",2221,491,1730,78,69,1555,1603,1611,414,1197,58,40,1063,1099
"n3510001","3510001",1252,967,285,7,191,45,225,963,778,185,5,124,27,143
"n1131709","1131709",7567,865,6702,684,1615,4405,5973,5462,701,4761,526,1218,3017,4204
"n1870127","1870127",9,7,2,0,0,1,1,9,7,2,0,0,1,1
"n1132085","1132085",329,245,84,14,17,48,62,298,228,70,10,17,39,53
"n291108","291108",2852,775,2077,136,418,1574,1930,2069,622,1447,108,303,1052,1326
"n1391041","1391041",3491,2716,775,65,217,394,592,2659,2154,505,43,134,252,378
"n292052","292052",2037,137,1900,11,39,1856,1873,1561,117,1444,10,27,1404,1418
"n2010992","2010992",2237,578,1659,91,283,1280,1529,1649,492,1157,65,193,893,1068
"n2310216","2310216",3040,2141,899,24,138,625,761,2236,1648,588,16,82,399,479
"n1830012","1830012",7174,5745,1429,67,390,688,1052,5188,4275,913,25,244,407,647
"n2210310","2210310",3007,2728,279,31,17,124,139,2545,2337,208,25,8,85,92
"n1890111","1890111",2082,500,1582,6,68,1504,1542,1522,425,1097,6,46,1033,1062
"n4230042","4230042",5607,4069,1538,106,632,589,1199,4440,3399,1041,72,422,372,787
"n1132022","1132022",891,711,180,66,21,72,86,678,562,116,45,9,50,56
"n3430101","3430101",1236,388,848,17,602,201,798,910,311,599,15,440,125,561
"n2010886","2010886",1653,762,891,493,98,281,377,1466,704,762,411,84,247,330
"n3550030","3550030",239,32,207,4,74,127,199,192,30,162,1,65,92,155
"n1132152","1132152",3304,1136,2168,218,879,1069,1908,2785,1094,1691,194,653,840,1463
"n1770013","1770013",505,331,174,2,3,158,161,390,263,127,2,3,114,117
"n4590017","4590017",3721,2495,1226,52,651,403,1033,2750,1938,812,31,427,252,676
"n4170406B","4170406B",11,9,2,0,0,2,2,2,2,0,0,0,0,0
"n2250016","2250016",399,333,66,4,8,30,38,329,277,52,4,4,24,28
"n410017","410017",6878,2367,4511,81,1205,3154,4308,5293,2013,3280,58,870,2273,3120
"n4530418","4530418",5335,2177,3158,424,434,2250,2639,4608,2074,2534,374,354,1747,2072
"n4391108","4391108",2676,2058,618,119,96,353,446,2193,1733,460,95,77,250,324
"n530011","530011",563,501,62,7,9,32,41,451,413,38,2,5,17,22
"n2450052","2450052",663,17,646,7,569,72,637,528,16,512,6,458,46,504
"n1131060","1131060",5123,4014,1109,189,153,623,758,4094,3326,768,134,84,451,528
"n1132520","1132520",6298,2504,3794,1235,1542,902,2406,4833,2091,2742,937,1051,650,1674
"n270312","270312",3358,2272,1086,35,108,852,944,2451,1758,693,17,62,523,580
"n3290411","3290411",4536,3334,1202,173,90,800,876,3237,2463,774,113,57,512,560
"n2010823","2010823",5872,1549,4323,873,947,2493,3372,4364,1287,3077,663,633,1735,2346
"n1350306","1350306",3805,631,3174,109,309,2713,2994,2758,534,2224,81,215,1893,2090
"n4530256","4530256",4939,2561,2378,1134,350,813,1138,4178,2236,1942,936,294,643,922
"n292114","292114",5527,781,4746,67,492,4233,4640,3959,681,3278,52,311,2923,3197
"n1670167","1670167",4892,3510,1382,201,320,723,1011,4183,3127,1056,161,229,543,755
"n1213156","1213156",1252,1011,241,49,35,112,143,977,824,153,35,22,65,85
"n4391723","4391723",2899,917,1982,338,1244,437,1650,2091,746,1345,231,849,289,1114
"n4330001","4330001",326,248,78,4,9,63,67,257,200,57,4,5,43,47
"n2410014","2410014",3990,3104,886,5,567,191,754,2956,2379,577,2,371,108,475
"n4530348A","4530348A",4355,2527,1828,886,122,761,860,2714,1618,1096,542,73,443,505
"n1670436","1670436",4588,510,4078,59,3361,683,3979,3505,417,3088,46,2621,429,3012
"n1990011","1990011",2450,2157,293,7,61,110,171,1906,1720,186,5,32,56,88
"n291045","291045",7715,446,7269,76,214,7003,7152,5349,377,4972,60,124,4774,4880
"n1131144","1131144",4327,3020,1307,122,539,588,1106,3133,2219,914,72,406,379,776
"n2010760","2010760",3175,2521,654,142,129,287,409,2400,1958,442,111,93,182,270
"n1230301","1230301",1986,1267,719,6,65,650,700,1573,1033,540,6,45,487,525
"n4391418","4391418",0,0,0,0,0,0,0,0,0,0,0,0,0,0
"n1890105","1890105",653,173,480,9,66,406,465,466,154,312,9,49,254,298
"n1132019","1132019",2064,1661,403,187,56,138,182,1600,1329,271,123,43,84,121
"n2010903","2010903",5251,2730,2521,434,290,1678,1954,3697,2027,1670,271,208,1119,1317
"n3470015","3470015",2674,1915,759,32,356,277,622,1989,1480,509,20,243,165,402
"n2010860","2010860",4887,1796,3091,724,524,1808,2300,3775,1496,2279,619,393,1227,1601
"n4530415","4530415",4391,2434,1957,265,179,1474,1623,3647,2200,1447,180,149,1052,1185
"n2450029","2450029",2748,2114,634,16,73,494,562,2052,1640,412,9,52,311,359
"n2450072","2450072",7626,2697,4929,567,3495,821,4262,6052,2367,3685,446,2595,576,3149
"n1132082","1132082",5793,1538,4255,174,485,3563,4007,4539,1330,3209,138,416,2604,2996
"n3390093","3390093",10936,4662,6274,248,559,5336,5827,7237,3434,3803,179,342,3163,3473
"n4391576","4391576",998,29,969,41,283,651,928,655,18,637,34,196,410,604
"n291105","291105",2673,245,2428,52,121,2274,2366,1775,212,1563,27,71,1458,1519
"n4530365","4530365",2997,2338,659,187,41,337,376,2158,1733,425,108,30,218,248
"n1930023","1930023",1455,1170,285,17,9,236,243,1131,932,199,14,5,162,166
"n550201","550201",1816,758,1058,23,129,914,1005,1332,645,687,14,66,586,649
"n1391038","1391038",5469,3711,1758,104,796,748,1524,3940,2814,1126,68,505,453,951
"n1132306","1132306",2157,937,1220,110,84,998,1068,1667,789,878,90,54,707,752
"n293132","293132",3373,939,2434,128,456,1903,2288,2834,871,1963,109,344,1545,1839
"n1330006","1330006",504,400,104,2,5,86,89,397,327,70,1,3,54,57
"n292029","292029",3279,76,3203,90,188,2955,3111,1954,43,1911,33,81,1808,1878
"n410099","410099",7,1,6,0,0,5,5,5,0,5,0,0,4,4
"n850043","850043",5649,2435,3214,382,1457,1286,2685,3989,1874,2115,254,918,845,1736
"n2890014","2890014",327,243,84,3,37,37,74,273,207,66,3,30,28,58
"n1133604","1133604",4276,557,3719,64,2958,687,3606,3322,509,2813,58,2247,491,2717
"n4393331","4393331",4065,3146,919,483,135,213,343,3062,2434,628,320,101,146,242
"n610008","610008",1137,24,1113,2,5,1104,1108,788,22,766,1,5,761,765
"n2010263","2010263",6513,3341,3172,902,838,1365,2133,4779,2614,2165,666,535,915,1412
"n1132127","1132127",8276,1753,6523,1537,3173,1845,4935,6115,1450,4665,1186,2186,1281,3435
"n3670415","3670415",5142,4034,1108,188,167,583,737,3629,2932,697,112,109,365,464
"n1430023","1430023",1011,600,411,6,5,377,381,761,486,275,5,3,246,248
"n67020E","67020E",286,209,77,0,48,10,58,256,186,70,0,47,9,56
"n1350409","1350409",3201,443,2758,13,47,2680,2715,2230,350,1880,11,31,1829,1857
"n3490404","3490404",1780,1182,598,13,103,422,519,1339,943,396,8,71,270,337
"n2011112","2011112",4932,2797,2135,256,396,1388,1751,3781,2288,1493,188,259,961,1197
"n4550006","4550006",286,246,40,0,10,22,31,231,206,25,0,7,10,17
"n2670002","2670002",788,525,263,23,2,224,225,638,461,177,22,2,143,144
"n2010177","2010177",3362,2012,1350,525,259,510,755,2967,1809,1158,458,223,431,647
"n3550087","3550087",2379,424,1955,27,103,1831,1900,1814,372,1442,19,70,1346,1402
"n3550024","3550024",1657,183,1474,10,137,1343,1458,1256,163,1093,9,97,989,1081
"n292046","292046",2445,396,2049,31,38,1976,2005,2026,351,1675,24,32,1609,1635
"n475004W","475004W",98,60,38,1,1,36,36,74,49,25,1,0,24,24
"n1133085","1133085",1051,243,808,3,108,703,794,743,228,515,2,76,441,505
"n4590012","4590012",1058,896,162,3,26,99,125,787,687,100,2,26,53,79
"n3570001","3570001",2321,717,1604,14,17,1545,1554,1612,559,1053,8,5,1022,1026
"n293003","293003",2239,794,1445,122,127,1220,1307,1669,639,1030,92,81,856,919
"n4790231","4790231",3319,101,3218,24,16,3169,3179,2387,70,2317,21,10,2280,2286
"n730037","730037",891,428,463,6,134,289,422,652,364,288,3,91,164,255
"n3650020","3650020",543,464,79,6,18,28,45,397,335,62,5,12,20,31
"n293046","293046",1672,1035,637,80,38,500,529,1365,886,479,55,28,375,399
"n467004B","467004B",2994,2335,659,38,83,421,497,2182,1786,396,27,46,242,286
"n4393152","4393152",71,51,20,6,3,11,14,52,39,13,2,3,7,10
"n4690020","4690020",1894,1242,652,8,49,567,605,1480,1028,452,6,34,390,419
"n610068","610068",6177,116,6061,16,20,6016,6020,4126,79,4047,13,6,4020,4021
"n1410082","1410082",3361,81,3280,44,35,3217,3240,2691,69,2622,32,27,2569,2588
"n4392488","4392488",4017,776,3241,857,1591,788,2331,2945,647,2298,653,1109,503,1595
"n2592120","2592120",2582,2088,494,21,30,374,401,2029,1693,336,16,22,250,271
"n4392029","4392029",3604,2027,1577,253,646,609,1232,2691,1600,1091,192,446,389,827
"n3610013","3610013",2726,1423,1303,56,830,376,1187,1985,1150,835,48,502,234,734
"n1490110","1490110",1265,1046,219,4,31,144,170,1025,885,140,1,17,90,106
"n2730032","2730032",1207,150,1057,31,175,855,1008,844,121,723,18,125,576,693
"n292131","292131",846,314,532,43,54,438,489,785,303,482,41,51,392,441
"n2010306","2010306",2092,1475,617,271,67,224,284,1718,1250,468,217,48,155,201
"n2030013","2030013",3338,2762,576,69,178,226,400,2404,2024,380,42,118,151,266
"n4392581","4392581",4123,1242,2881,371,1260,1225,2443,3054,1018,2036,273,904,823,1705
"n2010114","2010114",4157,2536,1621,216,452,893,1296,3013,1944,1069,143,309,553,845
"n2830003","2830003",1301,118,1183,5,4,1172,1173,948,99,849,2,1,842,843
"n2010012","2010012",1786,373,1413,21,264,1104,1360,1259,291,968,15,172,757,926
"n293069","293069",4562,2008,2554,306,221,2023,2215,3623,1764,1859,201,129,1484,1607
"n2011049","2011049",1021,52,969,139,155,684,824,787,49,738,119,123,500,614
"n2530001","2530001",3580,1910,1670,33,252,1334,1558,2652,1547,1105,12,176,870,1032
"n1410145","1410145",5360,201,5159,24,94,5067,5122,4069,158,3911,10,58,3836,3883
"n2090225","2090225",124,86,38,0,3,35,38,100,70,30,0,3,27,30
"n1410042","1410042",4995,132,4863,37,58,4809,4829,3528,100,3428,20,35,3386,3405
"n2010946","2010946",1232,320,912,131,120,670,775,942,275,667,107,80,475,547
"n292049","292049",5639,517,5122,120,512,4601,4989,4214,455,3759,72,318,3393,3671
"n1132410","1132410",3854,1279,2575,182,748,1611,2323,3096,1193,1903,141,582,1139,1698
"n2010074","2010074",4281,2906,1375,293,176,785,949,3531,2512,1019,235,117,546,658
"n4650041","4650041",3693,222,3471,15,29,3431,3449,2585,168,2417,7,18,2393,2407
"n4590015A","4590015A",3178,2563,615,9,84,374,453,2360,1975,385,6,39,225,264
"n3550027","3550027",1260,140,1120,5,15,1094,1105,909,124,785,3,11,766,775
"n292006","292006",80,9,71,0,2,69,71,71,9,62,0,2,60,62
"n292091","292091",5619,1487,4132,417,864,2921,3664,4744,1326,3418,359,687,2391,2994
"n1132149","1132149",2812,1299,1513,130,412,918,1315,2383,1163,1220,116,358,700,1049
"n4550009","4550009",744,650,94,4,36,44,77,574,511,63,3,26,23,47
"n2370006","2370006",1948,1499,449,25,28,342,363,1443,1166,277,11,19,204,218
"n2090128","2090128",971,234,737,15,48,651,694,706,186,520,9,34,454,486
"n1410210","1410210",0,0,0,0,0,0,0,0,0,0,0,0,0,0
"n1870124","1870124",10,0,10,0,1,9,10,9,0,9,0,0,9,9
"n610071","610071",7582,224,7358,26,28,7309,7321,5258,198,5060,22,15,5031,5040
"n1410085","1410085",4017,133,3884,24,34,3831,3843,2937,107,2830,18,17,2799,2810
"n2011095","2011095",5065,1873,3192,547,225,2382,2587,3914,1544,2370,446,169,1711,1874
"n2450049","2450049",1556,82,1474,125,218,1128,1342,1123,76,1047,105,168,771,937
"n2510005","2510005",4060,3005,1055,74,235,613,825,2990,2313,677,45,127,374,498
"n2010032","2010032",6382,3359,3023,814,780,1271,1988,6076,3282,2794,779,725,1176,1852
"n293026","293026",1863,1408,455,49,26,337,358,1389,1079,310,30,16,225,238
"n1133103","1133103",4901,507,4394,80,3351,989,4272,3517,444,3073,58,2357,656,2980
"n4730208","4730208",3032,1356,1676,25,425,1172,1564,2201,1103,1098,17,312,718,1016
"n2010200","2010200",5683,3863,1820,599,249,863,1093,5183,3629,1554,492,214,740,941
"n1133022","1133022",3716,69,3647,14,2483,1171,3606,2593,55,2538,13,1797,743,2514
"n2650107","2650107",1409,952,457,7,12,383,390,1183,836,347,7,10,276,283
"n3630024","3630024",436,299,137,11,22,94,115,328,242,86,7,14,56,70
"n1410128","1410128",8230,867,7363,193,620,6651,7129,5351,618,4733,112,386,4235,4588
"n4391631","4391631",477,140,337,13,265,62,320,358,127,231,9,168,50,218
"n1990008","1990008",1072,962,110,5,8,56,60,862,790,72,3,2,31,33
"n4630006","4630006",213,154,59,1,1,55,55,186,142,44,0,1,41,41
"n1410039","1410039",1824,184,1640,26,110,1514,1599,1521,169,1352,17,70,1259,1318
"n4392268","4392268",2990,799,2191,391,686,1119,1777,2252,688,1564,337,450,758,1202
"n291042","291042",1667,55,1612,5,26,1595,1604,1277,42,1235,1,17,1224,1230
"n2011052","2011052",0,0,0,0,0,0,0,0,0,0,0,0,0,0
"n3030005","3030005",1932,448,1484,8,292,1172,1461,1728,430,1298,8,274,1012,1284
"n292174","292174",3566,1232,2334,300,269,1791,2016,2856,1111,1745,230,178,1340,1493
"n610088","610088",6214,212,6002,58,52,5905,5940,3950,144,3806,35,25,3745,3765
"n1410102","1410102",4389,352,4037,57,176,3813,3946,3315,307,3008,42,126,2828,2935
"n1133800","1133800",7245,248,6997,52,5679,1302,6914,5152,215,4937,43,4053,840,4875
"n2010326","2010326",2135,184,1951,10,35,1896,1923,1553,173,1380,6,20,1344,1363
"n1391055","1391055",3731,2512,1219,64,547,506,1032,2890,2046,844,43,413,317,721
"n1410059","1410059",4644,558,4086,62,240,3826,3999,3480,474,3006,44,169,2790,2927
"n2011006","2011006",2698,125,2573,215,2013,337,2330,1955,105,1850,184,1430,227,1644
"n2010220","2010220",8597,1922,6675,83,214,6378,6530,5868,1642,4226,51,121,4015,4106
"n2011069","2011069",0,0,0,0,0,0,0,0,0,0,0,0,0,0
"n293150","293150",55,5,50,7,2,45,47,35,4,31,5,0,29,29
"n1134009","1134009",4230,207,4023,25,86,3908,3979,3085,174,2911,10,59,2829,2882
"n4392419","4392419",0,0,0,0,0,0,0,0,0,0,0,0,0,0
"n2570025","2570025",2032,1114,918,15,285,562,843,1480,869,611,8,199,356,554
"n1133202","1133202",3359,567,2792,72,1545,1184,2690,2572,513,2059,63,1200,786,1967
"n4393214","4393214",4911,2694,2217,521,535,1025,1527,3920,2277,1643,390,378,752,1115
"n4393667","4393667",180,104,76,36,24,16,34,145,82,63,32,20,10,26
"n277002E","277002E",796,707,89,0,19,40,59,620,558,62,0,10,26,36
"n2510024","2510024",5728,3676,2052,72,304,1465,1750,4253,2894,1359,47,184,947,1122
"n291085","291085",4158,439,3719,57,202,3484,3639,2934,390,2544,47,134,2360,2482
"n1133065","1133065",3826,73,3753,14,2251,1501,3731,2773,65,2708,11,1777,927,2694
"n4790128","4790128",4179,59,4120,8,20,4100,4107,2681,32,2649,5,19,2636,2643
"n550104","550104",1007,497,510,10,54,435,485,682,365,317,7,16,280,294
"n4391472","4391472",419,328,91,25,18,46,64,396,319,77,20,15,42,57
"n2010157","2010157",4367,136,4231,39,2128,2057,4153,3184,115,3069,26,1712,1336,3026
"n670001","670001",4393,3208,1185,27,735,257,986,3574,2700,874,20,557,167,720
"n2450092","2450092",1681,1041,640,41,372,203,568,1337,841,496,36,294,149,439
"n291147","291147",4408,880,3528,251,460,2882,3266,3128,667,2461,177,321,1969,2249
"n3550044","3550044",2089,97,1992,10,35,1962,1986,1564,86,1478,1,22,1456,1473
"n2010094","2010094",1978,74,1904,86,50,1755,1799,1358,71,1287,65,40,1173,1208
"n1131749","1131749",6954,2040,4914,1807,1500,1554,3008,5455,1751,3704,1460,1089,1086,2152
"n293089","293089",4720,2732,1988,167,168,1595,1732,3606,2197,1409,116,122,1118,1224
"n2870203","2870203",578,461,117,3,18,83,100,455,376,79,2,18,51,68
"n3550070","3550070",5698,1036,4662,181,404,4100,4410,4109,864,3245,126,253,2857,3077
"n4392660","4392660",743,181,562,27,40,493,531,541,156,385,20,27,332,359
"n610025","610025",1819,116,1703,2,6,1695,1696,1307,89,1218,0,2,1214,1215
"n4790407","4790407",1284,23,1261,6,1,1244,1244,923,19,904,1,1,898,898
"n4391257","4391257",3649,857,2792,127,999,1685,2625,2587,725,1862,84,709,1061,1740
"n2010389","2010389",4236,1328,2908,1383,765,755,1513,4131,1326,2805,1378,694,726,1417
"n277003D","277003D",1309,1145,164,1,25,49,74,1076,954,122,1,19,29,48
"n1133088","1133088",191,21,170,0,59,114,170,117,19,98,0,38,63,98
"n293006","293006",1342,603,739,52,34,625,654,1086,534,552,39,20,467,485
"n2011158","2011158",0,0,0,0,0,0,0,0,0,0,0,0,0,0
"n3630002","3630002",16,16,0,0,0,0,0,16,16,0,0,0,0,0
"n730043","730043",2913,1038,1875,15,501,1316,1796,2064,854,1210,6,350,822,1168
"n850247","850247",2873,2039,834,300,161,255,415,1982,1457,525,182,99,160,258
"n390039","390039",6573,2997,3576,149,379,2935,3262,4832,2374,2458,81,250,2005,2233
"n4490012","4490012",487,278,209,3,14,182,193,369,228,141,3,9,120,126
"n317003A","317003A",193,137,56,0,3,52,53,143,108,35,0,1,31,32
"n4290002","4290002",2084,1556,528,20,47,411,450,1628,1295,333,11,27,254,277
"n1213143","1213143",2465,1518,947,518,116,263,368,1730,1117,613,325,79,180,254
"n4394572","4394572",63,2,61,1,26,34,59,41,2,39,0,15,24,39
"n4410304","4410304",5675,3481,2194,483,601,1023,1561,4640,2992,1648,360,436,735,1136
"n4530124","4530124",6441,448,5993,94,1319,4626,5863,4402,406,3996,69,1001,2941,3895
"n1212080","1212080",5170,1899,3271,2114,570,530,1074,3405,1360,2045,1269,391,336,715
"n3290103","3290103",6997,3220,3777,305,588,2743,3257,5111,2600,2511,198,377,1792,2151
"n2010596","2010596",7848,1965,5883,208,2369,3274,5539,5580,1649,3931,152,1530,2193,3676
"n150415","150415",2324,1229,1095,13,302,765,1044,1763,1004,759,9,200,528,714
"n4391084","4391084",0,0,0,0,0,0,0,0,0,0,0,0,0,0
"n30002","30002",4589,2444,2145,56,82,1918,1983,3186,1832,1354,34,46,1203,1242
"n37002C","37002C",2512,376,2136,11,1705,408,2096,1813,314,1499,4,1200,278,1474
"n930007","930007",596,360,236,1,4,225,228,471,314,157,1,3,148,150
"n1134667","1134667",0,0,0,0,0,0,0,0,0,0,0,0,0,0
"n3390024","3390024",4983,2871,2112,210,738,1048,1755,3755,2308,1447,141,523,690,1200
"n490109","490109",394,341,53,6,10,32,40,320,285,35,6,5,17,22
"n270105","270105",2732,2019,713,48,42,531,561,1958,1501,457,35,24,318,336
"n1070027","1070027",1371,655,716,9,53,675,699,1032,550,482,4,26,451,466
"n1214205A","1214205A",4538,3323,1215,476,120,490,608,3319,2531,788,306,87,320,406
"n1131092","1131092",13127,607,12520,65,4906,7603,12388,8964,508,8456,55,3433,4973,8346
"n1670230","1670230",5357,1592,3765,34,2066,1665,3655,3998,1323,2675,21,1496,1135,2589
"n410067","410067",759,276,483,8,34,437,470,491,230,261,5,21,230,251
"n2010721","2010721",3816,2444,1372,583,129,600,719,2955,1989,966,432,84,397,474
"n291006","291006",4005,190,3815,27,45,3760,3776,3089,153,2936,13,26,2894,2908
"n1610007B","1610007B",95,68,27,2,20,7,26,81,57,24,2,18,5,23
"n1870222","1870222",24,3,21,0,0,21,21,16,0,16,0,0,16,16
"n2010953","2010953",1414,344,1070,20,59,980,1033,1092,305,787,16,44,712,755
"n294215","294215",375,105,270,0,0,259,259,284,96,188,0,0,179,179
"n3390080B","3390080B",200,115,85,13,34,35,68,143,83,60,5,26,28,53
"n4530206","4530206",3069,2253,816,272,108,388,484,2738,2027,711,257,85,328,402
"n1134024","1134024",4604,232,4372,310,2905,1176,4021,3035,203,2832,266,1772,789,2537
"n1211011","1211011",2175,1813,362,35,35,222,249,1671,1432,239,21,17,138,155
"n1212094","1212094",6135,1638,4497,2853,905,689,1542,4564,1366,3198,1955,688,491,1150
"n1391013","1391013",3310,1316,1994,13,194,1740,1922,2502,1118,1384,5,139,1194,1326
"n38713-1","38713-1",808,672,136,2,80,29,109,611,512,99,1,55,20,75
"n4010114","4010114",2281,1575,706,15,339,268,601,1725,1223,502,12,264,156,418
"n4394711","4394711",4222,1497,2725,1011,556,1091,1619,3049,1183,1866,738,355,717,1060
"n4391005","4391005",1471,65,1406,20,791,595,1378,1037,56,981,17,578,381,955
"n4530381D","4530381D",71,34,37,14,4,19,23,61,31,30,11,2,17,19
"n4530272","4530272",7177,4752,2425,1324,197,745,923,4828,3351,1477,832,102,436,534
"n1810309","1810309",1590,929,661,29,36,466,499,1131,699,432,13,16,311,327
"n2010046","2010046",5033,471,4562,76,949,3531,4453,3810,425,3385,62,542,2767,3301
"n2010378","2010378",4114,2218,1896,200,430,1206,1591,3069,1752,1317,150,282,823,1086
"n2010129","2010129",4423,3011,1412,351,357,649,989,3415,2322,1093,266,304,472,770
"n3010004","3010004",9,7,2,1,1,0,1,2,1,1,1,1,0,1
"n3610008","3610008",3711,2853,858,88,498,209,693,2760,2231,529,58,277,138,406
"n291122B","291122B",186,43,143,13,65,67,131,142,39,103,12,52,41,92
"n293101","293101",3644,1576,2068,282,220,1541,1736,2880,1340,1540,203,173,1140,1296
"n1132043","1132043",2908,2232,676,221,115,310,405,2125,1669,456,149,80,204,274
"n1133304","1133304",5361,1893,3468,436,1129,1810,2898,4124,1628,2496,352,817,1225,2025
"n1410060","1410060",3392,1019,2373,138,352,1914,2201,2772,922,1850,107,280,1459,1702
"n1470007","1470007",707,570,137,1,14,83,97,562,471,91,1,8,51,59
"n3550088","3550088",3723,1089,2634,107,174,2319,2476,2838,928,1910,68,118,1688,1797
"n4394478","4394478",0,0,0,0,0,0,0,0,0,0,0,0,0,0
"n4391153","4391153",3099,135,2964,33,1530,1415,2918,2254,115,2139,23,1161,956,2105
"n4392727","4392727",804,564,240,75,72,83,153,629,445,184,59,59,56,115
"n4392556","4392556",2526,1769,757,153,228,319,544,1986,1451,535,119,166,210,374
"n4910429","4910429",4152,1691,2461,72,441,1900,2290,3112,1431,1681,45,296,1297,1567
"n1573047","1573047",1143,348,795,641,63,86,146,895,290,605,487,44,74,118
"n1670429","1670429",3545,1793,1752,303,552,892,1399,2548,1372,1176,210,365,579,920
"n2010815","2010815",0,0,0,0,0,0,0,0,0,0,0,0,0,0
"n2010484","2010484",7458,3091,4367,1087,1490,1767,3165,5873,2661,3212,812,1071,1245,2284
"n3030067","3030067",3802,1841,1961,78,275,1532,1786,2899,1535,1364,54,177,1063,1230
"n3390015","3390015",5053,3726,1327,158,202,823,997,3959,3027,932,112,125,564,679
"n450004","450004",365,311,54,2,3,49,51,305,264,41,2,1,37,38
"n850015","850015",3499,1359,2140,532,385,1186,1556,2726,1179,1547,449,263,802,1059
"n1133922","1133922",151,2,149,3,57,84,141,105,0,105,3,48,50,98
"n1211048","1211048",6361,2400,3961,390,2502,1064,3450,4484,1876,2608,288,1585,679,2221
"n2010092","2010092",2945,2071,874,259,103,447,533,2291,1693,598,190,71,284,347
"n2010424","2010424",2282,859,1423,225,266,909,1166,1726,724,1002,166,179,635,808
"n2150085","2150085",6984,188,6796,20,29,6752,6767,4723,137,4586,14,23,4554,4565
"n2310431","2310431",794,452,342,2,69,245,312,613,361,252,2,53,176,229
"n4430003","4430003",197,112,85,5,5,73,75,157,93,64,0,2,57,59
"n4530436","4530436",3089,1765,1324,134,145,959,1078,2656,1577,1079,106,113,789,882
"n4530343B","4530343B",71,43,28,17,0,12,12,47,29,18,13,0,5,5
"n4770406","4770406",3577,1854,1723,74,959,633,1555,2999,1626,1373,56,818,448,1243
"n1050003","1050003",762,371,391,1,6,361,366,602,314,288,0,5,263,267
"n1132147","1132147",2571,2006,565,105,71,326,384,2058,1650,408,70,58,221,273
"n1410014","1410014",6038,1577,4461,599,320,3526,3803,4269,1179,3090,415,214,2443,2634
"n1572055","1572055",1662,22,1640,10,1114,530,1628,1282,18,1264,4,899,370,1256
"n1571057","1571057",8892,3893,4999,1080,1980,1828,3754,6255,2887,3368,743,1318,1201,2496
"n1730002","1730002",283,181,102,1,6,100,101,213,135,78,1,4,77,78
"n4870020","4870020",2680,1190,1490,61,206,1173,1360,1945,968,977,32,133,763,891
"n4970008","4970008",2421,1737,684,27,36,527,559,1886,1403,483,12,25,365,387
"n5010303","5010303",974,334,640,3,8,623,629,673,228,445,1,3,434,435
"n2010732","2010732",3618,1619,1999,508,260,1192,1421,2779,1323,1456,387,192,834,1014
"n2011064","2011064",4776,575,4201,2317,638,1285,1898,3443,414,3029,1681,478,897,1364
"n4391339","4391339",4710,2790,1920,178,890,795,1622,3914,2459,1455,153,658,569,1200
"n4393196","4393196",2739,2085,654,144,104,334,430,2226,1764,462,104,74,229,298
"n4570007","4570007",711,636,75,2,14,42,55,560,506,54,0,9,30,39
"n4790359","4790359",7156,309,6847,80,70,6704,6749,5319,251,5068,79,52,4937,4976
"n291020","291020",2933,294,2639,24,45,2575,2596,2200,266,1934,18,32,1880,1895
"n292106","292106",1479,242,1237,32,120,1090,1188,977,192,785,21,64,693,750
"n750401","750401",1358,961,397,30,43,301,340,1016,739,277,24,27,205,230
"n850218","850218",6414,2516,3898,2820,517,450,951,4483,1897,2586,1835,374,288,657
"n1132911","1132911",988,196,792,546,91,144,232,673,163,510,341,69,92,161
"n1131727","1131727",608,129,479,10,27,442,466,432,112,320,5,13,303,313
"n4910206","4910206",3133,2440,693,61,71,451,517,2304,1844,460,38,43,296,336
"n2090115","2090115",3851,1443,2408,151,423,1843,2215,3099,1276,1823,117,329,1378,1676
"n2150131","2150131",39,2,37,0,1,36,37,32,2,30,0,0,30,30
"n3210012","3210012",552,249,303,8,6,274,279,376,189,187,5,2,166,168
"n3390111","3390111",4289,2088,2201,20,81,1985,2049,3008,1610,1398,16,40,1238,1269
"n4392180","4392180",5167,587,4580,265,2068,2297,4286,3546,466,3080,197,1422,1493,2864
"n4510137","4510137",4723,1648,3075,75,233,2767,2944,3703,1428,2275,50,147,2036,2168
"n1410206","1410206",1958,31,1927,0,7,1918,1918,1396,19,1377,0,3,1375,1375
"n1410200","1410200",834,78,756,13,47,698,740,549,52,497,10,28,460,484
"n1574039","1574039",1357,426,931,545,185,196,371,1056,351,705,432,137,138,268
"n1574072","1574072",125,70,55,2,1,52,53,109,69,40,2,0,38,38
"n2010630","2010630",9022,406,8616,402,6398,1968,8197,6425,361,6064,309,4507,1304,5718
"n2010878","2010878",2818,1694,1124,275,286,534,798,2075,1317,758,179,181,369,541
"n294146","294146",80,20,60,2,16,43,55,62,19,43,2,11,27,38
"n610086","610086",3978,135,3843,40,31,3771,3790,2853,107,2746,32,24,2686,2705
"n11320A8","11320A8",145,25,120,9,51,54,104,117,22,95,9,44,35,79
"n1134533","1134533",2196,273,1923,142,278,1489,1756,1562,234,1328,106,188,1015,1200
"n1134539","1134539",0,0,0,0,0,0,0,0,0,0,0,0,0,0
"n1214196","1214196",5903,4403,1500,282,269,771,1012,3833,2922,911,170,154,456,599
"n3770007","3770007",1583,666,917,20,28,860,883,1322,604,718,13,11,680,689
"n4391460","4391460",7568,1137,6431,233,4658,1531,6091,5579,1023,4556,178,3289,1065,4297
"n4530200","4530200",4754,3553,1201,366,162,580,724,4283,3246,1037,320,125,505,616
"n4530186","4530186",5857,1541,4316,1153,1415,1825,3114,4567,1359,3208,949,930,1342,2214
"n4830201","4830201",1227,795,432,5,11,395,401,934,665,269,2,4,243,244
"n4850104","4850104",5310,3580,1730,230,684,668,1286,4443,3045,1398,195,559,521,1023
"n1890317","1890317",222,139,83,0,3,74,77,166,115,51,0,0,47,47
"n2010238","2010238",3012,32,2980,14,1449,1522,2943,2247,25,2222,9,1190,1023,2193
"n2010778","2010778",799,124,675,24,243,412,648,559,87,472,22,165,290,449
"n2010232","2010232",2719,1648,1071,538,142,361,495,1945,1241,704,365,91,219,308
"n2150231","2150231",981,109,872,37,7,828,828,689,100,589,28,5,554,554
"n2730012","2730012",2891,1076,1815,96,39,1638,1665,2187,871,1316,78,31,1163,1190
"n270304","270304",506,311,195,11,37,146,172,399,277,122,9,27,89,107
"n293205","293205",0,0,0,0,0,0,0,0,0,0,0,0,0,0
"n350007","350007",829,697,132,11,7,85,92,683,595,88,6,7,54,61
"n430006","430006",756,498,258,7,11,196,206,674,471,203,7,10,143,153
"n890305","890305",2401,1631,770,13,223,512,719,1947,1406,541,12,160,342,499
"n1131323","1131323",0,0,0,0,0,0,0,0,0,0,0,0,0,0
"n2550015","2550015",237,66,171,4,5,158,163,187,59,128,3,4,117,121
"n2930206","2930206",554,414,140,2,59,68,126,441,348,93,2,39,45,84
"n3490107","3490107",3258,1189,2069,10,156,1864,2006,2211,903,1308,8,103,1156,1258
"n3630015","3630015",1143,964,179,11,14,102,114,912,784,128,9,11,68,77
"n4393647","4393647",6657,3912,2745,793,809,997,1762,4990,3025,1965,574,564,720,1258
"n4910318","4910318",532,221,311,211,34,65,95,384,176,208,135,26,43,66
"n1350204","1350204",5437,2649,2788,99,282,2291,2530,3992,2106,1886,85,188,1511,1676
"n1850014","1850014",2270,1471,799,17,64,633,694,1736,1221,515,11,40,396,435
"n2010924","2010924",0,0,0,0,0,0,0,0,0,0,0,0,0,0
"n2010675B","2010675B",0,0,0,0,0,0,0,0,0,0,0,0,0,0
"n2030005","2030005",1095,851,244,8,146,51,194,961,768,193,6,117,30,146
"n231215A","231215A",8475,5330,3145,197,565,2097,2632,5889,3946,1943,119,351,1260,1604
"n150309","150309",860,679,181,4,21,130,143,674,552,122,1,15,86,98
"n293061","293061",3682,1065,2617,138,384,2102,2448,2848,952,1896,109,246,1520,1753
"n294100","294100",1368,408,960,140,246,574,801,1007,330,677,95,176,391,559
"n410015","410015",2478,1937,541,58,145,272,403,2153,1724,429,42,105,216,313
"n610040","610040",4865,585,4280,29,24,4228,4236,3548,554,2994,20,8,2956,2960
"n850118","850118",6370,3967,2403,1179,345,708,1029,4711,3088,1623,790,242,463,691
"n4170405","4170405",274,240,34,6,3,26,29,218,193,25,4,0,20,20
"n5030007","5030007",166,139,27,0,2,17,18,124,107,17,0,1,7,8
"n213003M","213003M",2331,1839,492,22,64,335,396,1815,1486,329,12,48,210,255
"n2190021","2190021",3783,1344,2439,16,154,2222,2352,2754,1089,1665,8,103,1503,1595
"n2450047","2450047",3377,464,2913,165,704,2035,2725,2374,382,1992,140,500,1341,1829
"n2773C7G","2773C7G",3500,2080,1420,79,856,345,1176,2702,1696,1006,65,606,216,811
"n3050001","3050001",1239,393,846,5,69,731,797,878,315,563,2,44,485,529
"n3550042","3550042",545,326,219,13,21,182,199,457,276,181,9,19,150,166
"n1030001","1030001",1178,451,727,5,9,701,707,870,395,475,2,4,460,462
"n1133097","1133097",206,10,196,1,125,71,196,146,10,136,0,99,37,136
"n1213151","1213151",4717,2843,1874,938,328,497,810,3420,2180,1240,623,235,324,551
"n1990009","1990009",3970,3061,909,60,591,185,765,3062,2407,655,49,415,126,536
"n2011070","2011070",733,36,697,1,32,671,691,513,29,484,0,21,465,480
"n2010530","2010530",2549,85,2464,20,73,2392,2439,1971,73,1898,10,52,1845,1881
"n294126","294126",3263,1349,1914,158,587,1169,1687,2311,1058,1253,111,389,722,1089
"n292027","292027",2028,312,1716,44,83,1589,1655,1672,288,1384,39,55,1277,1326
"n610023","610023",566,63,503,4,2,493,495,399,55,344,1,2,336,338
"n770008","770008",1245,1088,157,17,14,83,95,958,854,104,13,8,43,51
"n910408","910408",4129,3179,950,84,56,684,731,3483,2759,724,60,42,510,547
"n1132904","1132904",50,6,44,7,15,15,27,38,6,32,7,5,11,15
"n4650030","4650030",3712,622,3090,67,131,2888,2980,2722,536,2186,46,77,2033,2098
"n4970030","4970030",3029,2120,909,71,127,612,729,2192,1599,593,47,84,384,463
"n2410009","2410009",2718,2469,249,13,88,71,159,2113,1933,180,8,64,57,121
"n2510019","2510019",6209,4630,1579,79,265,1006,1248,4758,3729,1029,60,175,610,778
"n2990205","2990205",958,834,124,10,11,56,67,819,732,87,8,1,39,40
"n3090044","3090044",5660,4284,1376,138,376,759,1109,3984,3137,847,94,227,437,654
"n3390108","3390108",5062,3006,2056,675,388,831,1200,3586,2158,1428,451,277,588,851
"n4394737A","4394737A",2230,1157,1073,142,316,592,878,1631,916,715,102,201,395,583
"n1133325","1133325",3322,478,2844,204,1787,877,2616,2260,376,1884,159,1144,570,1693
"n1131139","1131139",36,9,27,11,4,8,10,28,7,21,9,2,4,6
"n2010301","2010301",6246,763,5483,17,111,5384,5452,4461,646,3815,13,78,3739,3793
"n2010798","2010798",889,211,678,18,67,591,648,689,203,486,12,50,421,466
"n2010135","2010135",5096,3395,1701,533,390,662,1040,4458,3025,1433,438,333,549,874
"n2090451","2090451",2307,1773,534,123,58,296,349,1543,1237,306,61,28,168,195
"n90010","90010",1088,964,124,15,10,75,84,821,736,85,10,9,49,57
"n292004","292004",6181,304,5877,68,314,5529,5797,4438,220,4218,38,219,3963,4166
"n292169","292169",2069,619,1450,78,84,1274,1335,1691,573,1118,61,44,991,1024
"n370021","370021",407,299,108,1,64,17,81,330,249,81,0,50,13,63
"n730026","730026",1631,875,756,14,419,300,719,1189,667,522,8,311,181,492
"n1131103","1131103",1310,95,1215,9,119,1097,1209,953,87,866,3,95,774,863
"n4630004","4630004",421,291,130,2,0,118,118,366,263,103,2,0,91,91
"n4790176B","4790176B",135,0,135,1,0,134,134,70,0,70,1,0,69,69
"n3450005","3450005",154,116,38,7,4,27,30,119,92,27,5,2,17,19
"n391001A","391001A",801,245,556,10,50,498,540,638,200,438,8,39,389,424
"n4394634","4394634",1848,1294,554,193,120,213,331,1801,1269,532,188,110,207,317
"n4392030","4392030",7433,1667,5766,621,3563,1643,5067,4842,1216,3626,489,2101,1057,3084
"n4392745","4392745",248,188,60,30,11,18,29,223,167,56,29,10,16,26
"n4530141","4530141",7876,2236,5640,1507,1524,2566,4012,6091,1943,4148,1145,1114,1825,2894
"n2011153","2011153",0,0,0,0,0,0,0,0,0,0,0,0,0,0
"n213004B","213004B",2750,1755,995,30,355,566,888,2150,1469,681,28,228,371,590
"n2230020","2230020",883,741,142,1,16,89,105,688,590,98,1,9,53,62
"n2450007","2450007",2544,900,1644,33,1032,558,1547,1959,781,1178,23,758,378,1104
"n2771A5A","2771A5A",1496,790,706,43,370,245,606,1102,647,455,26,242,145,387
"n3030019","3030019",3296,445,2851,18,370,2480,2798,2419,387,2032,13,264,1743,1984
"n270307","270307",7247,1717,5530,70,2394,3061,5345,5309,1434,3875,32,1800,1973,3726
"n292146","292146",255,27,228,5,17,204,218,177,25,152,5,12,132,143
"n410032","410032",1140,700,440,32,83,314,385,920,614,306,22,56,218,263
"n850184","850184",5903,2519,3384,1468,911,771,1653,5009,2267,2742,1169,734,645,1364
"n1134514","1134514",3591,795,2796,49,346,2361,2674,2553,686,1867,35,225,1562,1778
"n1214218","1214218",636,456,180,38,33,101,129,465,348,117,23,27,59,81
"n4770311","4770311",1598,1263,335,24,122,140,257,1308,1055,253,22,98,88,184
"n3550107","3550107",6814,3197,3617,161,132,3253,3349,4933,2452,2481,96,79,2224,2293
"n3690401","3690401",559,369,190,1,5,180,182,409,275,134,1,4,129,131
"n4391704","4391704",3982,2548,1434,162,387,761,1124,2720,1801,919,112,252,466,706
"n4393626","4393626",1031,828,203,66,46,64,108,898,746,152,45,34,52,85
"n4392655","4392655",2343,783,1560,102,691,764,1429,1915,730,1185,80,535,547,1069
"n4530341","4530341",3601,2196,1405,158,203,945,1124,2845,1794,1051,116,151,689,832
"n1410160","1410160",4944,114,4830,35,60,4763,4794,3644,93,3551,21,39,3503,3529
"n1610005A","1610005A",3728,2244,1484,16,640,780,1408,2814,1829,985,7,471,458,926
"n1890103","1890103",1215,159,1056,3,63,991,1043,864,123,741,2,30,703,729
"n2010587","2010587",7025,950,6075,298,2840,2956,5693,4981,813,4168,209,1958,1956,3872
"n2010918","2010918",38,14,24,0,21,4,24,38,14,24,0,21,4,24
"n2810007","2810007",1303,772,531,10,34,437,469,976,641,335,8,15,274,287
"n270117","270117",0,0,0,0,0,0,0,0,0,0,0,0,0,0
"n293139C","293139C",202,89,113,16,13,87,100,144,67,77,8,13,57,70
"n610046","610046",7171,365,6806,44,30,6728,6741,5110,312,4798,30,21,4741,4750
"n850161","850161",443,316,127,16,18,74,90,353,267,86,10,11,55,64
"n1133017","1133017",1320,189,1131,6,886,249,1117,1124,186,938,5,747,190,926
"n1410137","1410137",2790,75,2715,24,133,2577,2686,2214,53,2161,21,108,2050,2146
"n4910276","4910276",2526,1745,781,196,97,415,503,1761,1248,513,135,68,257,318
"n3330001","3330001",1111,850,261,5,8,224,232,896,716,180,4,7,150,157
"n3550085","3550085",1010,65,945,5,25,927,940,753,50,703,5,17,686,698
"n3730013","3730013",479,425,54,0,4,20,24,388,349,39,0,4,12,16
"n4230020","4230020",1726,249,1477,25,304,1142,1435,1233,211,1022,16,200,792,989
"n4391064","4391064",0,0,0,0,0,0,0,0,0,0,0,0,0,0
"n4393725","4393725",3806,2412,1394,306,282,736,1000,2957,1973,984,225,203,491,683
"n1890407","1890407",2048,1090,958,30,87,824,895,1592,943,649,24,50,553,596
"n2010278","2010278",6757,768,5989,43,191,5787,5932,4803,671,4132,31,136,3982,4086
"n2010941","2010941",2447,1070,1377,208,323,826,1120,1978,937,1041,175,246,587,816
"n2490018","2490018",677,63,614,1,19,601,609,489,51,438,0,10,428,434
"n2530002","2530002",3942,2389,1553,41,239,1192,1411,3099,2005,1094,33,162,842,998
"n3170002","3170002",1277,454,823,9,50,758,800,817,296,521,4,30,482,508
"n292182A","292182A",172,98,74,10,25,47,64,120,76,44,7,10,28,37
"n37005C","37005C",6379,4626,1753,389,833,349,1163,4990,3730,1260,281,590,254,833
"n410081","410081",95,56,39,0,12,24,36,81,50,31,0,8,21,29
"n410075","410075",6856,3531,3325,447,1326,1457,2718,5675,3154,2521,393,883,1134,1980
"n850135","850135",7146,2465,4681,3341,713,524,1220,5084,1975,3109,2177,504,351,842
"n1134113","1134113",4604,176,4428,54,181,4230,4362,3330,153,3177,40,107,3046,3126
"n3290406","3290406",3792,2157,1635,345,178,1032,1195,2972,1756,1216,259,140,751,881
"n3670125","3670125",4278,3344,934,23,66,616,676,3293,2667,626,13,28,390,415
"n38703-1A","38703-1A",1350,496,854,18,677,134,796,1049,411,638,13,513,81,591
"n4230043","4230043",2019,1395,624,29,227,331,539,1588,1170,418,22,144,212,351
"n4391543","4391543",2046,239,1807,76,1164,583,1717,1350,183,1167,64,709,394,1094
"n4790268","4790268",1094,24,1070,5,5,1060,1064,642,13,629,4,5,621,625
"n1391010","1391010",3205,1848,1357,58,327,899,1211,2411,1531,880,41,221,549,763
"n1410117","1410117",4650,417,4233,97,128,4057,4144,3681,370,3311,70,89,3170,3242
"n2011127","2011127",2577,274,2303,286,1473,564,1998,2003,263,1740,229,1068,448,1499
"n2010961","2010961",5037,128,4909,340,1651,2982,4556,3417,107,3310,281,1092,1960,3020
"n2010464","2010464",4602,1994,2608,265,727,1583,2282,3471,1600,1871,201,507,1125,1620
"n2210112","2210112",3127,2338,789,17,56,561,613,2470,1921,549,12,36,366,401
"n293021","293021",2911,2396,515,75,19,383,395,2140,1818,322,49,11,238,248
"n292047","292047",2541,341,2200,22,106,2073,2154,2051,308,1743,18,79,1636,1709
"n390010","390010",1483,912,571,7,36,479,509,1142,753,389,4,20,321,341
"n1134153","1134153",327,59,268,5,178,86,259,292,58,234,5,170,62,227
"n1134004","1134004",3446,738,2708,157,254,2276,2514,2783,687,2096,131,226,1712,1930
"n1133619","1133619",1079,161,918,2,267,640,888,699,142,557,1,164,393,543
"n4790370","4790370",3887,180,3707,115,44,3550,3587,2595,129,2466,93,31,2344,2368
"n2011110","2011110",3036,1691,1345,573,315,444,748,2341,1366,975,433,209,309,513
"n2010613","2010613",5137,272,4865,392,1750,2750,4445,3777,245,3532,326,1305,1920,3190
"n2090423C","2090423C",0,0,0,0,0,0,0,0,0,0,0,0,0,0
"n2370004","2370004",1022,861,161,3,7,115,121,753,654,99,2,4,67,70
"n4410301","4410301",5281,3143,2138,169,600,1322,1860,4038,2561,1477,120,414,873,1258
"n467003D","467003D",4294,3713,581,43,76,311,383,3369,2970,399,28,61,198,255
"n1133613","1133613",1054,203,851,0,547,304,842,790,192,598,0,391,206,589
"n1131302","1131302",5115,1390,3725,158,2209,1354,3508,3926,1291,2635,121,1557,937,2466
"n1230101","1230101",3771,1802,1969,29,488,1445,1897,3190,1584,1606,14,407,1148,1548
"n1391033","1391033",2737,1936,801,52,281,410,680,1886,1361,525,27,204,249,451
"n1410017","1410017",2646,590,2056,176,44,1843,1877,2037,506,1531,120,27,1386,1406
"n1630008","1630008",2432,386,2046,3,21,1996,2005,1683,314,1369,0,13,1340,1347
"n50034","50034",3313,2238,1075,203,453,367,811,2735,1905,830,169,352,263,614
"n293121","293121",5045,2251,2794,561,310,1918,2177,3696,1732,1964,371,199,1350,1525
"n550404","550404",4424,774,3650,19,91,3514,3589,2840,639,2201,13,57,2093,2149
"n1133037","1133037",771,23,748,1,351,403,747,547,21,526,1,287,241,525
"n1131083","1131083",4589,487,4102,37,299,3762,4028,3327,443,2884,17,228,2621,2836
"n1214212","1214212",722,528,194,43,34,92,125,540,400,140,34,23,60,82
"n4530113","4530113",3375,1664,1711,119,434,1130,1528,2672,1390,1282,87,354,799,1142
"n4690018","4690018",5893,3501,2392,29,208,2055,2233,4587,2889,1698,17,154,1424,1562
"n489008A","489008A",937,37,900,2,5,894,896,694,27,667,1,4,662,664
"n2470003","2470003",1207,111,1096,3,1,1061,1062,884,100,784,2,0,758,758
"n3030039","3030039",2412,1699,713,14,38,585,616,1860,1366,494,9,25,387,408
"n3550101","3550101",5449,1724,3725,66,149,3473,3579,4042,1452,2590,42,78,2414,2475
"n4391099","4391099",2246,378,1868,44,621,1184,1785,1597,331,1266,36,450,765,1207
"n4391719","4391719",3917,2831,1086,171,286,536,793,2991,2223,768,134,201,363,540
"n4394531","4394531",4676,2748,1928,117,254,1401,1645,3551,2227,1324,78,165,955,1114
"n1391053","1391053",2771,1448,1323,47,651,557,1180,2112,1195,917,33,480,343,811
"n1770008","1770008",559,306,253,1,19,229,242,411,249,162,1,15,142,153
"n2010421","2010421",3964,1277,2687,291,1311,1090,2331,2949,1013,1936,196,970,752,1677
"n2011084","2011084",694,361,333,40,91,188,275,522,288,234,29,61,136,195
"n2090320","2090320",2611,2010,601,32,29,447,469,2124,1702,422,29,17,298,315
"n2250017","2250017",2861,1065,1796,10,982,806,1779,2762,979,1783,10,980,796,1767
"n293145","293145",5442,2428,3014,714,314,1955,2231,4052,1921,2131,497,208,1395,1584
"n410100","410100",3027,1947,1080,488,172,372,529,2161,1437,724,327,111,251,355
"n610003","610003",9059,784,8275,47,73,8163,8191,6212,599,5613,23,36,5545,5563
"n850204","850204",468,295,173,51,58,61,116,355,236,119,34,33,46,79
"n970001","970001",403,345,58,5,4,39,43,348,306,42,2,4,30,34
"n1133060","1133060",1653,21,1632,3,1339,291,1622,1252,19,1233,2,1064,164,1225
"n3090069","3090069",2479,2011,468,22,88,272,350,1908,1569,339,15,67,178,242
"n3550127","3550127",1949,1020,929,99,53,764,805,1409,742,667,60,36,561,590
"n3670325","3670325",2494,2061,433,7,16,293,309,1913,1627,286,5,8,189,197
"n4391167","4391167",2368,1126,1242,84,202,913,1092,1811,963,848,52,138,627,756
"n4910173","4910173",3487,2265,1222,225,176,748,899,2708,1864,844,143,121,528,632
"n1410143","1410143",3820,72,3748,15,27,3714,3729,2997,57,2940,10,9,2920,2926
"n1810202","1810202",6604,4811,1793,86,476,828,1292,5197,4000,1197,61,300,533,829
"n1870306","1870306",5091,2744,2347,275,715,1329,1974,3920,2197,1723,201,571,923,1443
"n2010321","2010321",5352,383,4969,39,115,4829,4919,3822,343,3479,27,92,3367,3444
"n2010984","2010984",1263,47,1216,35,387,744,1124,765,37,728,29,244,420,658
"n2010444","2010444",6144,1931,4213,373,298,3513,3751,4593,1644,2949,307,219,2378,2567
"n292021","292021",5490,153,5337,36,105,5208,5270,3927,117,3810,23,68,3714,3763
"n293078","293078",4001,2013,1988,182,207,1570,1746,3183,1720,1463,126,138,1158,1281
"n1132303","1132303",4278,1587,2691,81,112,2440,2536,3355,1404,1951,73,80,1747,1817
"n1134612","1134612",544,210,334,6,29,297,324,443,192,251,4,29,217,244
"n1133504","1133504",923,569,354,189,62,80,137,680,427,253,135,43,57,98
"n1214176","1214176",3801,2648,1153,209,333,509,821,3055,2250,805,173,219,327,532
"n3390036","3390036",6723,3707,3016,60,179,2651,2809,4762,2884,1878,46,119,1605,1711
"n3550065","3550065",5241,2279,2962,179,754,2041,2712,4558,2001,2557,134,732,1689,2348
"n3750225","3750225",4613,915,3698,73,192,3409,3553,3245,742,2503,48,99,2296,2382
"n4130002","4130002",611,230,381,4,7,361,365,474,198,276,2,6,259,263
"n4391251","4391251",5256,780,4476,308,2917,1274,4112,3537,631,2906,228,1907,770,2638
"n4392466","4392466",2052,493,1559,131,517,907,1408,1522,427,1095,106,388,587,964
"n1410037","1410037",6797,452,6345,31,138,6235,6319,5227,412,4815,18,88,4734,4796
"n1510001","1510001",875,672,203,4,20,163,177,654,530,124,2,11,89,99
"n1670165","1670165",3972,2452,1520,314,358,772,1098,2749,1772,977,206,216,477,683
"n2010544","2010544",580,25,555,3,168,388,552,448,25,423,3,148,275,420
"n2890009","2890009",516,436,80,2,8,41,46,428,370,58,2,4,28,31
"n3090050","3090050",3757,1260,2497,88,1059,1328,2323,2848,1107,1741,70,731,874,1588
"n50014","50014",3034,1732,1302,43,575,624,1181,2268,1419,849,33,375,383,756
"n294226","294226",228,128,100,19,23,56,74,167,112,55,10,16,23,38
"n292126","292126",3263,616,2647,95,169,2398,2524,2463,535,1928,73,116,1734,1829
"n670014","670014",3443,2734,709,39,442,114,548,2684,2222,462,27,280,65,343
"n730035","730035",1617,970,647,10,265,336,595,1276,806,470,7,217,211,427
"n1134090","1134090",270,33,237,5,49,185,232,220,32,188,4,44,139,183
"n4730420","4730420",4419,2807,1612,359,338,821,1132,3158,2121,1037,223,206,525,724
"n2270041","2270041",29,13,16,0,6,14,16,17,10,7,0,2,5,7
"n3490308","3490308",418,374,44,2,7,25,32,386,346,40,2,6,24,30
"n3930001","3930001",232,195,37,6,9,17,24,167,150,17,0,5,6,11
"n397003BA","397003BA",5070,3509,1561,202,488,750,1212,3801,2748,1053,143,312,492,791
"n4392003","4392003",1253,840,413,55,104,231,325,990,707,283,32,60,161,216
"n4510402","4510402",5429,2759,2670,217,383,1964,2296,4319,2348,1971,177,300,1392,1663
"n1330007","1330007",2933,2473,460,34,40,305,338,2314,2022,292,28,19,177,192
"n1350404","1350404",4315,807,3508,10,34,3451,3464,3005,623,2382,4,14,2340,2347
"n1573140","1573140",4150,1779,2371,1485,395,444,829,3321,1466,1855,1187,290,331,615
"n2010152","2010152",8138,534,7604,34,772,6804,7515,5890,468,5422,21,538,4856,5364
"n2011147","2011147",197,17,180,3,15,168,177,119,15,104,2,6,98,104
"n2010650","2010650",5347,2743,2604,885,534,1140,1648,4281,2355,1926,676,345,847,1182
"n294169","294169",495,261,234,17,33,187,210,410,240,170,9,32,129,152
"n294083","294083",1373,391,982,84,408,513,878,890,287,603,51,247,297,529
"n293041","293041",637,322,315,22,15,272,285,506,279,227,20,10,196,205
"n850098","850098",3201,1318,1883,98,220,1546,1744,2494,1212,1282,73,182,1011,1180
"n990104","990104",7204,3878,3326,354,1415,1366,2638,5351,3067,2284,256,936,887,1760
"n1132119","1132119",1435,178,1257,57,173,1043,1197,986,140,846,47,135,673,796
"n4910119","4910119",5802,3106,2696,304,440,1907,2293,4286,2472,1814,201,292,1259,1534
"n4930103","4930103",2738,1102,1636,13,44,1535,1566,2078,894,1184,10,30,1113,1134
"n2011004","2011004",1163,563,600,33,47,503,547,916,485,431,25,30,362,391
"n2450027","2450027",2428,802,1626,83,947,591,1516,1811,698,1113,69,631,402,1022
"n2650406","2650406",4368,3199,1169,43,66,966,1017,3525,2713,812,34,41,644,676
"n4394563","4394563",0,0,0,0,0,0,0,0,0,0,0,0,0,0
"n4393325","4393325",1763,1056,707,47,97,474,564,1372,896,476,34,51,312,359
"n4790458","4790458",8225,244,7981,51,55,7874,7910,5581,168,5413,35,27,5336,5359
"n1410074","1410074",4336,186,4150,34,91,4061,4107,3449,167,3282,22,62,3211,3247
"n1770014","1770014",168,95,73,1,3,55,57,119,70,49,1,2,32,33
"n2010841","2010841",7726,772,6954,194,3336,3416,6599,5378,651,4727,153,2263,2269,4456
"n2010010","2010010",3587,385,3202,68,143,2991,3115,2902,332,2570,55,127,2379,2497
"n2010755","2010755",7122,764,6358,320,989,5079,6000,5268,664,4604,253,761,3602,4322
"n2011090","2011090",829,223,606,155,131,315,432,600,194,406,118,81,198,276
"n291040","291040",5427,206,5221,29,58,5165,5184,3979,170,3809,24,34,3769,3778
"n410094","410094",0,0,0,0,0,0,0,0,0,0,0,0,0,0
"n550102","550102",1126,638,488,8,24,436,457,864,535,329,5,15,295,308
"n910207","910207",2866,2185,681,90,121,392,500,2180,1710,470,55,83,258,334
"n1132402","1132402",5407,1790,3617,1765,566,1229,1773,4448,1584,2864,1476,409,907,1302
"n1150011","1150011",339,204,135,4,4,130,134,217,133,84,4,4,79,83
"n4530410","4530410",2970,2118,852,195,69,518,567,2622,1898,724,159,52,445,489
"n4530366","4530366",4348,3652,696,83,47,428,458,3481,2985,496,49,30,291,313
"n2570020","2570020",3034,1560,1474,123,140,1143,1272,2229,1255,974,100,101,715,810
"n3090063","3090063",5802,4633,1169,253,272,523,783,4197,3449,748,149,186,318,497
"n3550121","3550121",2838,578,2260,60,224,1980,2165,2199,521,1678,44,173,1449,1603
"n3610031","3610031",2659,2305,354,38,36,179,214,2033,1808,225,20,20,108,128
"n3650008","3650008",335,274,61,5,35,18,53,243,207,36,3,27,6,33
"n4393562","4393562",183,147,36,5,4,25,26,135,116,19,4,1,11,12
"n1212071","1212071",5759,4141,1618,341,390,727,1080,4339,3255,1084,239,261,461,705
"n1810105","1810105",1405,1266,139,9,13,80,91,1056,963,93,7,7,51,58
"n2010401","2010401",3653,62,3591,21,1884,1709,3552,2702,59,2643,15,1466,1179,2614
"n2150062","2150062",4106,797,3309,193,71,3011,3077,3327,701,2626,150,59,2377,2434
"n2150148","2150148",335,7,328,2,3,327,328,214,7,207,2,2,206,207
"n2150111","2150111",4022,506,3516,59,46,3420,3444,3221,472,2749,52,39,2664,2685
"n130010","130010",958,266,692,12,21,623,637,753,228,525,11,9,474,481
"n650201","650201",1457,1232,225,15,29,141,167,1121,957,164,15,22,99,120
"n850141","850141",4447,2252,2195,1077,507,520,1016,3477,1867,1610,780,373,375,745
"n1131004","1131004",2706,1471,1235,98,746,359,1089,2000,1113,887,70,552,239,784
"n1132080","1132080",622,114,508,9,16,477,488,451,95,356,8,8,332,338
"n1572128","1572128",4777,2966,1811,747,383,633,995,3562,2265,1297,558,280,413,682
"n3030122","3030122",2978,1468,1510,40,243,1200,1416,2208,1222,986,35,149,774,912
"n4394350","4394350",1896,1402,494,77,78,295,371,1607,1227,380,57,57,226,283
"n4391559","4391559",369,63,306,17,130,158,286,267,59,208,9,105,93,196
"n4393072","4393072",3497,2761,736,271,100,276,367,2718,2203,515,194,74,177,244
"n4530164","4530164",4599,1830,2769,636,717,1402,2072,3629,1506,2123,489,564,1042,1570
"n1690001","1690001",856,536,320,9,45,279,313,672,448,224,3,34,189,218
"n1930017","1930017",292,211,81,1,3,62,65,240,187,53,1,3,38,41
"n2010215","2010215",3370,1874,1496,888,116,440,545,2567,1544,1023,601,89,296,377
"n2210313","2210313",4079,3419,660,70,51,433,473,3483,2999,484,42,30,303,328
"n2450070","2450070",4591,970,3621,848,1824,973,2734,3330,836,2494,605,1238,648,1854
"n277001E","277001E",1072,924,148,3,6,76,82,817,711,106,3,6,58,64
"n292083","292083",1043,207,836,7,37,790,821,856,186,670,7,23,640,657
"n3810228","3810228",6442,4957,1485,267,192,890,1061,5179,4094,1085,205,134,635,757
"n4270005","4270005",181,3,178,0,0,178,178,133,2,131,0,0,131,131
"n1131725","1131725",635,353,282,9,68,190,251,553,347,206,4,46,136,180
"n2090336","2090336",3943,2350,1593,117,262,1138,1351,3430,2101,1329,95,211,950,1137
"n2150258","2150258",34,0,34,0,0,34,34,26,0,26,0,0,26,26
"n2490005","2490005",301,32,269,5,4,261,262,239,27,212,1,1,205,206
"n2930304","2930304",1130,723,407,6,131,251,377,862,595,267,4,86,160,244
"n3270004B","3270004B",6,1,5,0,4,1,5,4,0,4,0,4,0,4
"n291126","291126",0,0,0,0,0,0,0,0,0,0,0,0,0,0
"n294230","294230",4075,693,3382,146,1565,1751,3176,2787,538,2249,101,1033,1102,2086
"n850082","850082",4935,2407,2528,297,888,1272,2125,3599,1940,1659,236,534,822,1340
"n850076","850076",5145,2910,2235,1090,513,506,997,3881,2357,1524,727,368,330,690
"n1132409","1132409",5428,754,4674,174,174,4302,4436,4005,656,3349,152,126,3039,3141
"n1213115","1213115",5519,1623,3896,2019,1181,645,1785,4227,1329,2898,1541,835,462,1282
"n2650101","2650101",3807,2760,1047,64,86,828,896,3159,2370,789,49,60,611,662
"n3390054","3390054",5263,1771,3492,43,182,3158,3301,3491,1393,2098,26,107,1856,1944
"n4030002","4030002",1711,1579,132,6,29,55,81,1539,1435,104,4,22,38,59
"n4392571","4392571",0,0,0,0,0,0,0,0,0,0,0,0,0,0
"n4530321","4530321",2567,2031,536,188,25,268,292,1765,1463,302,92,15,151,166
"n4910436","4910436",1926,1215,711,35,61,591,643,1432,984,448,18,44,353,394
"n1573045","1573045",2999,986,2013,612,538,825,1345,2255,807,1448,438,369,606,963
"n1571122","1571122",5103,3550,1553,567,180,713,872,3773,2721,1052,390,125,455,570
"n2010736","2010736",2384,1506,878,206,102,511,605,2022,1321,701,156,74,407,478
"n2010073","2010073",3305,1522,1783,162,264,1328,1577,2576,1259,1317,123,211,954,1162
"n2150066","2150066",2209,112,2097,7,20,2072,2082,1723,99,1624,5,11,1603,1610
"n2150072","2150072",2057,142,1915,52,39,1839,1856,1555,120,1435,36,27,1379,1394
"n294213","294213",8,3,5,1,0,3,3,4,3,1,0,0,0,0
"n294207","294207",0,0,0,0,0,0,0,0,0,0,0,0,0,0
"n291104","291104",5214,1043,4171,232,535,3450,3891,4108,912,3196,172,398,2607,2969
"n292065A","292065A",3720,754,2966,276,461,2301,2670,2436,553,1883,171,258,1453,1685
"n850059","850059",5890,3501,2389,849,650,780,1404,4289,2648,1641,614,423,522,926
"n1132301","1132301",3009,2059,950,124,174,572,728,2569,1847,722,103,130,419,538
"n4730207","4730207",5707,4100,1607,50,136,1218,1342,4218,3208,1010,35,78,731,806
"n4910401","4910401",8530,3602,4928,360,1437,3018,4333,5920,2710,3210,250,925,1919,2789
"n3890002","3890002",1925,197,1728,36,41,1644,1676,1386,171,1215,19,27,1154,1181
"n4070006","4070006",2475,2030,445,14,220,108,325,2102,1758,344,9,161,77,238
"n4392484","4392484",8214,1293,6921,1400,3172,2399,5455,6161,1123,5038,1104,2266,1680,3893
"n4393323","4393323",4198,3232,966,470,118,279,382,3324,2624,700,330,72,197,268
"n4530434","4530434",3590,1680,1910,146,232,1491,1698,3165,1564,1601,114,188,1252,1424
"n4530280","4530280",4400,3529,871,82,79,556,620,3646,3015,631,65,58,378,427
"n1212092","1212092",6993,3806,3187,1029,1022,1073,2008,6330,3569,2761,880,853,945,1737
"n2010759","2010759",3748,1251,2497,775,575,1129,1669,2883,1067,1816,595,419,787,1192
"n2150089","2150089",39,9,30,0,1,29,29,24,9,15,0,0,14,14
"n2650410","2650410",339,260,79,13,0,51,51,288,229,59,11,0,40,40
"n3390076","3390076",6045,4726,1319,120,265,768,1002,4726,3786,940,79,178,530,694
"n3390070","3390070",3566,2549,1017,340,97,485,573,2658,1993,665,224,55,314,367
"n291081","291081",4025,2037,1988,181,477,1370,1771,3252,1870,1382,130,349,924,1225
"n1132047","1132047",3326,2466,860,136,189,447,625,2406,1817,589,89,139,310,442
"n1170004","1170004",4618,860,3758,20,86,3666,3712,3126,678,2448,11,42,2389,2414
"n1214161","1214161",5414,2640,2774,335,594,1734,2283,3815,1996,1819,239,377,1108,1467
"n1470012","1470012",1725,1531,194,7,18,112,129,1363,1213,150,7,14,79,93
"n1573169","1573169",1401,83,1318,1206,65,46,109,1005,66,939,864,46,26,72
"n4530465","4530465",5026,1686,3340,249,678,2403,3006,4214,1571,2643,225,547,1835,2335
"n4710104","4710104",2803,2015,788,17,193,506,698,2247,1668,579,12,168,339,506
"n4970012","4970012",2661,2124,537,13,34,413,438,2059,1704,355,11,16,265,279
"n2010196","2010196",721,52,669,13,153,517,658,538,47,491,10,125,366,483
"n2010028","2010028",8793,3042,5751,554,2041,3090,5004,6748,2662,4086,423,1444,2118,3497
"n2010859","2010859",1708,149,1559,15,538,1004,1530,1286,132,1154,15,434,701,1130
"n4090118","4090118",4270,1061,3209,26,54,3091,3131,3270,952,2318,19,42,2222,2253
"n4394256","4394256",2907,168,2739,6,79,2658,2724,1988,152,1836,5,45,1780,1822
"n4393386","4393386",3206,2540,666,188,118,266,376,2405,1972,433,130,79,163,238
"n250016","250016",1760,546,1214,28,62,1125,1174,1336,474,862,19,46,794,832
"n1132519","1132519",6698,1573,5125,326,751,4020,4743,4657,1297,3360,245,518,2559,3060
"n1211015","1211015",2203,1019,1184,114,419,616,1005,1485,741,744,75,253,373,611
"n1213138","1213138",5383,2993,2390,1602,259,482,719,3852,2295,1557,1021,178,307,473
"n1510012","1510012",928,567,361,7,42,297,334,767,482,285,6,26,234,258
"n1573110","1573110",4717,1628,3089,2062,397,644,1011,3720,1413,2307,1559,289,447,719
"n4530347","4530347",4452,3143,1309,539,100,587,662,3078,2235,843,363,60,356,408
"n4550008","4550008",564,506,58,2,8,26,34,455,416,39,1,3,13,16
"n4690016","4690016",666,434,232,7,33,165,192,525,360,165,3,24,112,135
"n4930207","4930207",4281,2253,2028,51,103,1830,1911,3254,1818,1436,32,63,1285,1345
"n2010050","2010050",8131,2160,5971,1614,2150,2192,4239,6135,1758,4377,1282,1508,1551,3002
"n2010713","2010713",4310,1155,3155,617,1119,1371,2441,3246,950,2296,478,786,984,1743
"n2010173","2010173",4082,2707,1375,600,210,522,717,2752,1886,866,379,135,312,442
"n4270011","4270011",7045,90,6955,7,4,6938,6939,5135,76,5059,6,4,5047,5048
"n4394179","4394179",3066,1194,1872,76,506,1248,1725,2326,1035,1291,55,345,850,1180
"n4393502","4393502",1948,1627,321,81,32,150,177,1463,1259,204,50,16,94,106
"n294061","294061",5726,917,4809,151,1275,3453,4620,4027,758,3269,102,899,2289,3131
"n294144","294144",703,389,314,18,70,220,281,600,356,244,14,46,172,215
"n293019","293019",0,0,0,0,0,0,0,0,0,0,0,0,0,0
"n1134640","1134640",7297,1100,6197,1004,2707,2479,5069,5295,982,4313,820,1783,1659,3396
"n1133102","1133102",5657,675,4982,124,3198,1668,4781,4008,571,3437,92,2236,1088,3287
"n1214200","1214200",78,73,5,1,0,4,4,60,56,4,0,0,4,4
"n467003B","467003B",3259,2233,1026,28,437,469,894,2471,1795,676,10,304,292,589
"n3790204","3790204",1026,797,229,1,43,132,171,775,623,152,1,25,84,108
"n4190003","4190003",421,346,75,4,13,54,66,309,263,46,3,4,33,37
"n4230073","4230073",1071,398,673,9,340,311,642,833,346,487,6,249,217,461
"n4391627","4391627",526,338,188,29,33,108,138,326,218,108,21,18,51,67
"n4530193","4530193",4553,1830,2723,489,1036,1188,2164,3497,1517,1980,388,752,808,1531
"n4570005","4570005",265,196,69,0,59,4,63,214,164,50,0,41,3,44
"n1410144","1410144",4315,150,4165,29,53,4088,4122,3258,122,3136,8,29,3094,3115
"n1670226","1670226",4237,2473,1764,58,434,1151,1568,3306,2080,1226,40,294,785,1071
"n1990007","1990007",1070,988,82,4,20,27,46,837,790,47,2,10,15,25
"n2010236","2010236",3664,32,3632,16,1506,2160,3618,2626,29,2597,8,1232,1377,2583
"n2010568","2010568",4896,2869,2027,823,226,872,1080,3790,2311,1479,644,161,580,735
"n3090073","3090073",1614,1298,316,8,41,200,238,1199,1000,199,4,20,121,141
"n270311","270311",4461,3380,1081,69,137,727,835,3546,2771,775,41,89,512,577
"n291018","291018",1888,84,1804,16,31,1761,1777,1441,72,1369,13,23,1327,1342
"n292150","292150",30,4,26,3,6,19,22,17,2,15,0,3,12,15
"n710008","710008",6465,4629,1836,75,348,1292,1606,4459,3283,1176,41,235,782,1007
"n1134117","1134117",235,82,153,5,111,37,147,226,82,144,2,109,32,140
"n1133001","1133001",1338,58,1280,22,878,393,1254,824,58,766,18,508,248,746
"n321001C","321001C",1581,294,1287,17,890,388,1254,1137,229,908,13,648,232,879
"n3510015","3510015",362,304,58,1,39,6,45,289,240,49,0,32,5,37
"n4394050","4394050",4648,365,4283,43,765,3509,4238,3108,264,2844,28,499,2320,2809
"n4392173","4392173",1266,864,402,128,93,147,239,1031,735,296,97,68,93,161
"n4393661","4393661",0,0,0,0,0,0,0,0,0,0,0,0,0,0
"n4530117","4530117",3484,1605,1879,106,701,1057,1728,2839,1395,1444,78,581,757,1322
"n1450203","1450203",2469,867,1602,17,1000,606,1578,2351,853,1498,17,905,592,1477
"n1574067","1574067",4975,1078,3897,1209,1664,1071,2687,3649,847,2802,912,1149,745,1874
"n1870214","1870214",1054,587,467,22,25,389,403,760,431,329,18,11,267,274
"n2010342","2010342",3075,252,2823,45,961,1838,2758,2137,215,1922,35,646,1239,1867
"n2010674","2010674",6952,4036,2916,364,820,1584,2379,5183,3185,1998,271,558,1036,1584
"n2250011","2250011",157,123,34,3,21,4,25,135,105,30,2,20,2,22
"n294107","294107",1473,521,952,147,369,466,804,1212,476,736,119,291,332,607
"n294190","294190",19,7,12,3,7,4,9,15,5,10,2,5,3,7
"n293065","293065",5160,2145,3015,528,365,2104,2428,3901,1721,2180,398,259,1487,1730
"n410059","410059",45,31,14,0,0,14,14,33,22,11,0,0,11,11
"n850122","850122",6470,4978,1492,438,381,549,905,4868,3844,1024,322,257,348,593
"n1050001","1050001",797,229,568,9,14,538,548,639,178,461,7,10,441,448
"n4850108","4850108",7113,4828,2285,143,781,1163,1866,5476,4008,1468,90,472,710,1156
"n2870102","2870102",381,171,210,1,140,67,205,309,142,167,0,122,42,164
"n3030065","3030065",2163,993,1170,14,79,1050,1118,1647,842,805,9,61,701,756
"n3090028","3090028",1855,921,934,25,363,526,870,1406,747,659,19,257,363,614
"n3730011","3730011",612,369,243,6,137,82,219,471,295,176,5,107,55,162
"n4090112","4090112",2475,343,2132,12,45,2069,2108,1885,279,1606,9,35,1556,1586
"n4230018","4230018",3110,248,2862,35,2157,659,2786,2271,228,2043,29,1597,383,1974
"n2011028","2011028",5950,2356,3594,290,1493,1793,3210,3967,1600,2367,194,979,1147,2100
"n2010034","2010034",4297,2596,1701,462,356,837,1163,3945,2416,1529,423,312,744,1038
"n2011114","2011114",6848,521,6327,198,3114,3048,6034,4765,465,4300,165,2180,1961,4067
"n2150026","2150026",2323,87,2236,13,13,2196,2207,1773,74,1699,11,9,1664,1673
"n2450051","2450051",909,37,872,39,360,478,829,666,31,635,30,289,314,600
"n2730022","2730022",1316,354,962,77,104,781,874,1128,340,788,67,84,628,707
"n1132145","1132145",5035,3264,1771,268,397,1034,1406,4712,3167,1545,243,334,896,1212
"n1131110","1131110",50,0,50,0,5,45,50,40,0,40,0,2,38,40
"n1132041","1132041",6689,4160,2529,596,976,851,1803,6152,3901,2251,551,862,742,1585
"n11332T0","11332T0",0,0,0,0,0,0,0,0,0,0,0,0,0,0
"n1213155","1213155",5584,4207,1377,394,250,600,839,4135,3224,911,278,185,348,528
"n1410098","1410098",2308,376,1932,42,54,1829,1877,1913,344,1569,33,37,1483,1520
"n291064","291064",2567,392,2175,18,37,2126,2137,1883,302,1581,14,24,1546,1556
"n350011","350011",1061,901,160,3,9,92,99,854,740,114,2,5,60,65
"n450002","450002",358,239,119,1,11,101,109,270,189,81,1,6,70,76
"n570003","570003",754,533,221,8,16,172,181,619,467,152,6,6,110,115
"n770012","770012",451,365,86,5,4,48,52,366,301,65,3,3,36,39
"n850013","850013",2136,1625,511,114,119,211,325,1421,1112,309,73,70,122,191
"n3090086","3090086",3981,1432,2549,34,1165,1338,2443,2882,1199,1683,26,816,796,1602
"n3410203","3410203",149,98,51,1,5,36,40,108,73,35,1,1,25,26
"n3610006","3610006",2242,1881,361,28,107,160,259,1783,1506,277,24,87,110,193
"n3670200","3670200",3198,2182,1016,28,85,764,842,2497,1766,731,18,69,534,599
"n4393465","4393465",6551,3638,2913,507,786,1513,2241,4597,2697,1900,320,507,981,1454
"n2010179","2010179",3974,1226,2748,264,268,2195,2436,3145,1071,2074,222,213,1600,1800
"n2030009","2030009",2491,1672,819,19,383,352,730,1886,1308,578,13,300,205,503
"n2150172","2150172",72,1,71,0,0,71,71,52,0,52,0,0,52,52
"n2290001","2290001",1299,714,585,16,12,561,569,1214,700,514,16,8,494,500
"n2410016","2410016",516,460,56,1,10,20,29,399,367,32,1,7,6,12
"n2592080","2592080",2611,2089,522,46,38,355,387,1945,1613,332,34,20,218,236
"n930005","930005",1015,737,278,3,5,251,253,806,629,177,2,3,157,158
"n1134067","1134067",4538,420,4118,30,146,3919,4045,3402,366,3036,26,110,2878,2977
"n1132512","1132512",2188,1160,1028,391,267,351,597,1758,998,760,292,188,243,422
"n1211009","1211009",420,271,149,6,9,119,126,330,230,100,5,3,80,82
"n1391011","1391011",4191,2198,1993,46,542,1305,1831,3220,1830,1390,25,401,859,1252
"n2010719","2010719",4143,886,3257,34,216,2994,3165,2987,769,2218,26,149,2010,2138
"n150413","150413",2303,1493,810,13,121,659,765,1752,1204,548,9,86,441,519
"n293105","293105",5326,2077,3249,170,465,2614,3000,3984,1689,2295,116,337,1793,2098
"n610044","610044",5035,1450,3585,198,163,3196,3312,3815,1241,2574,173,125,2265,2359
"n1132106","1132106",2607,1483,1124,201,435,440,865,2524,1456,1068,192,407,419,819
"n1131056","1131056",2020,591,1429,38,111,1256,1354,1491,516,975,26,85,835,919
"n1131062","1131062",104,14,90,0,2,88,88,78,14,64,0,0,62,62
"n5030005","5030005",4149,3325,824,30,58,648,697,3186,2672,514,17,33,386,415
"n223002A","223002A",2011,987,1024,28,628,316,930,1542,783,759,22,483,212,688
"n3050005","3050005",109,68,41,1,3,36,37,86,51,35,1,3,30,31
"n3550086","3550086",790,426,364,17,19,319,329,644,359,285,17,11,242,251
"n4391311","4391311",2994,619,2375,165,1499,713,2173,2246,526,1720,140,1097,478,1562
"n4394487","4394487",0,0,0,0,0,0,0,0,0,0,0,0,0,0
"n4393213","4393213",3106,1895,1211,31,208,905,1085,2348,1556,792,22,119,568,676
"n1410058","1410058",3384,564,2820,147,405,2329,2643,2532,511,2021,121,265,1636,1873
"n1573062","1573062",4620,1347,3273,1296,1378,605,1928,3817,1210,2607,1073,1077,441,1489
"n1571041","1571041",2632,1677,955,110,203,606,792,2015,1377,638,79,131,393,513
"n1750012","1750012",573,362,211,3,49,150,198,450,303,147,2,37,100,136
"n2010819","2010819",202,125,77,15,23,40,59,157,93,64,15,20,29,47
"n2011068","2011068",5656,699,4957,1068,1413,2509,3862,4444,621,3823,922,1056,1869,2885
"n10024","10024",1274,1087,187,17,38,93,131,987,861,126,9,25,65,90
"n294004","294004",1072,312,760,44,150,563,701,965,312,653,43,132,473,599
"n530007","530007",803,685,118,3,11,63,74,693,602,91,3,9,42,51
"n1134022","1134022",3013,933,2080,440,748,886,1607,2694,917,1777,373,694,694,1373
"n1131327","1131327",6883,1544,5339,342,2681,2271,4880,5041,1278,3763,283,1849,1574,3382
"n1211055","1211055",1492,1011,481,69,162,196,353,1149,825,324,46,110,124,231
"n4910412","4910412",2229,1250,979,24,93,825,903,1654,1010,644,20,35,542,577
"n3010002","3010002",1,1,0,0,0,0,0,1,1,0,0,0,0,0
"n3630020","3630020",235,217,18,3,2,5,6,210,196,14,3,2,3,4
"n4391011","4391011",3175,211,2964,60,492,2422,2891,2255,195,2060,51,370,1634,1999
"n4430002A","4430002A",159,32,127,2,2,123,124,134,27,107,1,2,104,105
"n4530445","4530445",3929,2105,1824,185,241,1360,1567,3204,1819,1385,150,193,1008,1175
"n4730101","4730101",3157,1355,1802,16,441,1285,1718,2337,1161,1176,3,310,813,1118
"n1212098","1212098",927,358,569,392,85,88,163,776,318,458,330,61,48,108
"n2010968","2010968",5023,601,4422,231,2433,1777,4130,3421,435,2986,163,1623,1168,2767
"n2010090","2010090",3242,2366,876,97,128,542,647,2537,1947,590,71,83,343,412
"n2010133","2010133",3885,2632,1253,688,79,438,494,2661,1881,780,422,45,267,304
"n2010428","2010428",5870,366,5504,2083,1305,2141,3406,4417,299,4118,1689,926,1513,2418
"n231214A","231214A",4500,3286,1214,48,93,893,980,3427,2644,783,33,61,534,592
"n292005","292005",1545,192,1353,24,35,1297,1319,1265,168,1097,19,31,1045,1067
"n610090","610090",1098,46,1052,0,7,1047,1047,790,33,757,0,2,755,755
"n1132151","1132151",368,239,129,17,22,78,100,325,218,107,13,14,70,84
"n1134537","1134537",30,6,24,1,11,12,22,21,3,18,0,10,9,18
"n1133308","1133308",5403,1122,4281,58,964,3245,4170,3643,955,2688,39,614,1998,2602
"n1410104","1410104",5247,759,4488,85,282,4167,4370,4150,666,3484,62,204,3228,3391
"n4850102","4850102",1498,1141,357,62,101,151,238,1195,942,253,55,62,100,155
"n2190015","2190015",826,525,301,3,7,264,270,657,441,216,3,3,187,190
"n3390019","3390019",5566,4336,1230,40,415,602,1003,4298,3415,883,24,318,391,702
"n4391476","4391476",360,61,299,4,16,282,294,247,57,190,2,12,175,185
"n4392743","4392743",30,8,22,5,0,13,13,23,8,15,5,0,6,6
"n4530255","4530255",5551,2254,3297,851,887,1498,2327,4460,1988,2472,665,642,1112,1723
"n4630008","4630008",2702,530,2172,7,13,2141,2148,2006,449,1557,5,6,1535,1541
"n1572075","1572075",3113,114,2999,127,2060,845,2862,2330,97,2233,108,1546,591,2113
"n1572061","1572061",7551,2676,4875,2541,1496,825,2287,4994,1799,3195,1675,967,529,1479
"n1670435","1670435",2024,673,1351,82,711,556,1244,1533,545,988,70,524,389,901
"n2010528","2010528",3644,288,3356,37,1196,2101,3276,2592,226,2366,31,889,1414,2293
"n2010776","2010776",5771,2147,3624,230,1653,1724,3313,4196,1739,2457,184,1126,1109,2212
"n2010282","2010282",5455,1989,3466,669,1256,1594,2758,4232,1507,2725,514,1053,1210,2186
"n850019","850019",2019,1506,513,185,94,185,274,1617,1216,401,147,77,129,204
"n1134073","1134073",3056,717,2339,14,155,2108,2257,2368,654,1714,9,117,1524,1641
"n1131731","1131731",0,0,0,0,0,0,0,0,0,0,0,0,0,0
"n1211052","1211052",4645,2175,2470,244,1323,821,2071,3094,1545,1549,151,803,504,1280
"n1391017","1391017",4892,2601,2291,47,408,1774,2135,3569,2092,1477,25,260,1122,1373
"n1410204","1410204",3151,175,2976,52,92,2867,2930,2017,116,1901,33,50,1825,1867
"n4010214","4010214",3048,2138,910,15,424,350,767,2470,1824,646,9,343,190,531
"n4392319","4392319",3448,2191,1257,244,391,556,916,2695,1838,857,151,262,375,619
"n4510213","4510213",3830,3118,712,40,35,542,565,2720,2257,463,20,19,351,365
"n4530385A","4530385A",4385,2611,1774,1321,73,327,395,3174,2023,1151,849,56,194,245
"n4770419","4770419",838,515,323,33,85,186,267,637,423,214,32,56,115,169
"n4910314","4910314",6768,4016,2752,200,594,1899,2443,5535,3429,2106,154,451,1437,1865
"n1610008","1610008",779,671,108,2,24,69,92,668,586,82,1,19,53,71
"n1850010","1850010",2210,1803,407,20,45,257,298,1785,1496,289,17,29,168,194
"n2010382","2010382",3246,796,2450,24,418,1994,2377,2174,668,1506,23,271,1195,1445
"n2010136","2010136",2752,296,2456,85,2128,268,2363,2283,277,2006,74,1756,193,1926
"n2010922","2010922",0,0,0,0,0,0,0,0,0,0,0,0,0,0
"n2150129","2150129",258,30,228,3,4,223,224,184,29,155,1,2,152,153
"n292051","292051",1312,425,887,72,131,678,790,1226,406,820,68,119,619,723
"n293025","293025",2165,1581,584,109,39,403,436,1653,1221,432,77,38,295,327
"n390014","390014",7659,5071,2588,73,995,1374,2320,5784,3936,1848,58,704,950,1634
"n830001","830001",1965,1545,420,19,65,281,332,1621,1308,313,15,43,199,241
"n1132103","1132103",2594,605,1989,65,341,1590,1901,2023,534,1489,54,266,1165,1410
"n1134149","1134149",186,11,175,0,4,166,170,134,5,129,0,1,126,127
"n467004D","467004D",5247,4111,1136,30,285,629,899,4192,3388,804,17,227,391,613
"n4790403","4790403",2386,48,2338,3,7,2326,2326,1640,31,1609,3,7,1600,1600
"n2150152","2150152",4971,416,4555,58,31,4446,4461,3510,369,3141,41,16,3057,3065
"n2510043","2510043",4940,1891,3049,385,1475,1172,2577,3385,1409,1976,264,936,734,1641
"n3090067","3090067",4346,3572,774,5,129,500,616,3355,2860,495,4,80,312,388
"n3310419","3310419",3287,1842,1445,27,406,934,1309,2488,1533,955,19,287,584,854
"n3550083","3550083",1888,136,1752,23,114,1632,1724,1392,103,1289,13,67,1214,1271
"n4530204","4530204",4443,2847,1596,664,175,686,842,4178,2675,1503,624,156,651,789
"n1131300","1131300",6520,1292,5228,129,883,4193,5026,4559,1133,3426,94,582,2713,3266
"n1133617","1133617",3882,179,3703,36,3137,535,3634,2856,158,2698,33,2333,319,2640
"n1214194","1214194",721,592,129,2,28,76,100,539,445,94,1,13,53,66
"n2010988","2010988",4818,2898,1920,69,574,1187,1724,3442,2204,1238,51,382,733,1094
"n2010822","2010822",2543,22,2521,26,1350,1170,2496,1911,20,1891,22,1109,770,1867
"n2010491","2010491",5779,2793,2986,1035,763,1112,1838,5079,2553,2526,851,645,939,1573
"n130014","130014",259,170,89,1,1,80,81,212,145,67,1,1,59,60
"n291024","291024",5007,785,4222,182,410,3685,4019,3811,698,3113,150,300,2671,2935
"n293166","293166",875,269,606,31,58,520,565,722,246,476,29,50,395,440
"n293002","293002",3179,1537,1642,274,142,1236,1353,2377,1208,1169,186,94,867,953
"n37008B","37008B",5168,3587,1581,46,1040,319,1344,3989,2901,1088,33,710,195,903
"n410079","410079",147,79,68,0,10,57,67,103,61,42,0,10,31,41
"n4530172","4530172",606,328,278,52,38,186,218,450,268,182,15,23,137,156
"n4790275A","4790275A",2040,39,2001,8,7,1996,1999,1262,20,1242,3,5,1239,1241
"n4910210","4910210",3613,2498,1115,177,181,677,847,2482,1764,718,111,125,418,537
"n3090089","3090089",182,20,162,6,30,122,150,147,16,131,4,30,94,122
"n3490105","3490105",550,309,241,7,41,176,210,376,233,143,3,19,107,123
"n3550105","3550105",2081,84,1997,11,15,1973,1976,1493,59,1434,4,9,1420,1421
"n4210301","4210301",302,164,138,5,4,127,129,217,132,85,3,3,77,78
"n4393140","4393140",2860,1939,921,96,139,567,679,2201,1585,616,74,85,362,440
"n4530386B","4530386B",5,0,5,0,1,4,5,4,0,4,0,0,4,4
"n850139","850139",9115,3194,5921,3371,1547,915,2388,6404,2529,3875,2132,1048,608,1627
"n1132077","1132077",2126,1254,872,163,180,522,689,1618,985,633,122,135,360,491
"n2150009","2150009",4858,294,4564,49,31,4481,4505,3606,251,3355,33,23,3286,3307
"n2450031","2450031",1788,1435,353,37,54,201,255,1402,1148,254,22,39,142,181
"n2570004","2570004",3075,2291,784,43,258,419,668,2214,1711,503,34,167,244,407
"n3030044","3030044",2062,1284,778,10,48,676,723,1574,1022,552,10,25,480,505
"n90008","90008",371,333,38,3,3,23,24,307,281,26,3,0,12,12
"n294104","294104",3739,1184,2555,204,356,2006,2306,2740,955,1785,152,258,1364,1596
"n291001","291001",1026,329,697,31,32,630,650,891,307,584,26,22,528,547
"n292002","292002",2105,81,2024,11,37,1982,2007,1659,72,1587,7,24,1555,1574
"n410056","410056",15,15,0,0,0,0,0,15,15,0,0,0,0,0
"n1133064","1133064",3283,68,3215,27,2542,663,3177,2521,55,2466,14,2019,441,2446
"n4530364","4530364",3609,2617,992,332,115,454,556,2647,1995,652,209,81,303,374
"n4530138","4530138",7916,2228,5688,1775,1583,2383,3818,6254,1921,4333,1391,1159,1769,2844
"n4970006","4970006",3556,2371,1185,42,135,884,1000,2554,1798,756,33,91,541,619
"n2090423A","2090423A",3350,1254,2096,114,199,1797,1954,2484,996,1488,77,144,1256,1380
"n2870202","2870202",3014,1631,1383,27,365,970,1316,2199,1327,872,17,221,609,825
"n3490403","3490403",2242,1786,456,13,100,268,364,1694,1409,285,9,67,153,218
"n3570003","3570003",2612,1542,1070,15,12,971,978,1851,1170,681,8,4,611,615
"n4391186","4391186",913,705,208,69,45,82,127,809,648,161,54,35,61,96
"n4392028","4392028",1770,1247,523,74,139,262,388,1411,1050,361,51,92,166,257
"n1230203","1230203",1642,967,675,2,117,558,651,1205,771,434,2,77,339,412
"n1410184","1410184",0,0,0,0,0,0,0,0,0,0,0,0,0,0
"n1650003","1650003",5532,3967,1565,20,39,1474,1502,3502,2518,984,12,23,924,943
"n1890318","1890318",1795,1019,776,14,34,693,722,1285,782,503,6,23,448,471
"n2010611","2010611",4042,40,4002,15,2519,1523,3980,2946,34,2912,14,1958,953,2894
"n2010276","2010276",3058,31,3027,14,2279,760,2998,2371,28,2343,8,1854,493,2321
"n292025","292025",4480,387,4093,21,106,3958,4040,3276,328,2948,12,71,2851,2907
"n610070","610070",2293,89,2204,9,9,2177,2183,1694,66,1628,9,8,1604,1610
"n1133041","1133041",897,24,873,0,224,648,866,617,24,593,0,175,417,586
"n1131401","1131401",1275,135,1140,5,180,960,1131,874,111,763,3,129,634,758
"n1214216","1214216",1732,951,781,146,280,319,582,1359,801,558,114,179,231,403
"n1950002","1950002",109,69,40,1,4,34,34,71,50,21,1,0,18,18
"n4391106","4391106",3434,97,3337,13,2090,1249,3315,2504,72,2432,3,1691,739,2417
"n4394540","4394540",5972,2658,3314,748,896,1648,2479,4456,2140,2316,560,589,1105,1667
"n4392181","4392181",4183,2532,1651,147,541,851,1377,3292,2143,1149,123,365,576,935
"n4394057","4394057",955,647,308,47,95,132,224,915,635,280,42,86,119,205
"n4650023","4650023",271,97,174,4,6,160,164,212,85,127,4,4,113,117
"n2010634","2010634",6209,1972,4237,167,1451,2536,3902,4528,1646,2882,137,928,1738,2623
"n2010965","2010965",1053,325,728,32,25,663,679,727,264,463,29,16,407,420
"n2210218","2210218",2840,2563,277,30,16,141,153,2518,2295,223,22,12,105,113
"n3370015","3370015",759,644,115,7,11,66,75,614,531,83,7,7,42,49
"n3750324","3750324",6233,4602,1631,324,316,819,1108,4936,3781,1155,246,227,541,752
"n3970004A","3970004A",2309,1317,992,81,145,687,828,1595,1005,590,37,75,413,486
"n410098","410098",13,8,5,0,1,5,5,12,8,4,0,1,4,4
"n850159","850159",6396,2352,4044,939,896,2158,3016,4409,1728,2681,691,598,1332,1910
"n950407","950407",185,163,22,6,3,10,12,163,145,18,4,2,8,10
"n970006","970006",2991,2567,424,8,30,224,246,2350,2075,275,7,5,138,142
"n1410141","1410141",2602,117,2485,6,48,2435,2457,1990,99,1891,5,26,1856,1869
"n1670245","1670245",1906,372,1534,17,937,579,1480,1385,300,1085,9,687,370,1042
"n391004A","391004A",561,203,358,8,15,334,347,444,175,269,4,10,252,260
"n4230076","4230076",2977,435,2542,38,597,1894,2467,2090,362,1728,33,446,1240,1673
"n4391622","4391622",62,22,40,8,7,22,29,45,16,29,8,7,11,18
"n4394118","4394118",2368,1275,1093,143,573,366,918,1937,1110,827,122,399,285,671
"n4391348","4391348",1212,898,314,35,76,181,247,965,728,237,30,56,124,179
"n4392548","4392548",2300,1614,686,122,217,281,472,1675,1217,458,95,137,171,293
"n1710015","1710015",878,777,101,1,5,74,75,775,706,69,1,1,49,50
"n1870304","1870304",5389,2911,2478,295,613,1535,2084,4166,2368,1798,204,452,1077,1502
"n2011151","2011151",5988,3334,2654,778,520,1242,1719,3877,2229,1648,497,342,719,1042
"n2230017","2230017",1877,1508,369,15,53,251,302,1380,1140,240,8,32,159,191
"n2450005","2450005",2569,879,1690,67,1110,494,1585,1905,764,1141,53,754,315,1062
"n2450011","2450011",943,321,622,3,451,166,611,820,317,503,3,366,128,493
"n293045","293045",1900,1185,715,106,25,548,570,1573,1027,546,86,17,408,424
"n390034","390034",10268,4995,5273,136,229,4633,4829,7645,4035,3610,106,156,3109,3253
"n450006","450006",99,74,25,3,1,25,25,71,56,15,2,0,15,15
"n850182","850182",5897,3125,2772,1231,735,719,1416,4321,2460,1861,812,474,484,943
"n1134518","1134518",6621,1105,5516,214,541,4694,5203,4651,960,3691,181,391,3056,3433
"n1391057","1391057",3352,2137,1215,114,575,458,1016,2537,1688,849,92,408,295,698
"n2110301","2110301",681,537,144,7,4,122,125,514,420,94,5,0,83,83
"n2410013","2410013",658,473,185,1,133,28,161,519,378,141,0,104,15,119
"n2510023","2510023",3829,3060,769,22,73,545,612,2923,2382,541,18,49,354,400
"n3090048","3090048",1542,313,1229,14,317,893,1198,1126,273,853,11,208,621,827
"n4810101","4810101",869,399,470,10,232,222,446,694,331,363,10,200,146,345
"n1410041","1410041",1682,85,1597,16,37,1554,1576,1381,79,1302,11,19,1275,1285
"n1410164","1410164",6732,155,6577,42,59,6501,6517,4991,121,4870,25,26,4811,4821
"n1670172","1670172",1069,645,424,20,168,235,399,961,589,372,19,137,211,348
"n1770012","1770012",280,133,147,6,10,131,137,200,111,89,3,3,80,82
"n1810403","1810403",4655,4048,607,43,71,193,259,3984,3531,453,29,36,133,169
"n2010299","2010299",6127,675,5452,105,670,4697,5315,4318,602,3716,80,467,3164,3595
"n110101","110101",473,419,54,4,4,32,35,356,316,40,2,2,21,22
"n293143","293143",2018,701,1317,139,102,1075,1149,1646,628,1018,110,74,827,882
"n390057","390057",1969,998,971,37,61,824,880,1476,798,678,29,53,552,602
"n610001","610001",2059,378,1681,11,21,1650,1658,1580,349,1231,6,10,1212,1216
"n1070039","1070039",1218,462,756,8,59,698,744,884,380,504,0,39,461,496
"n1131107","1131107",2383,171,2212,13,183,2018,2191,1648,146,1502,7,122,1368,1487
"n4530145","4530145",2878,912,1966,90,477,1396,1819,2068,750,1318,59,335,911,1213
"n4910164","4910164",767,400,367,47,91,218,305,620,346,274,32,70,153,223
"n2010442","2010442",5618,4093,1525,221,301,835,1118,4407,3319,1088,157,227,579,793
"n2510001","2510001",640,472,168,10,33,109,133,447,346,101,5,13,65,77
"n3030078","3030078",4108,2898,1210,285,137,693,824,3120,2310,810,206,79,445,521
"n3550125","3550125",4971,1460,3511,370,296,2882,3130,3515,1120,2395,237,198,1944,2128
"n3730017","3730017",2345,1927,418,16,124,222,343,1940,1643,297,9,102,140,240
"n4394630","4394630",0,0,0,0,0,0,0,0,0,0,0,0,0,0
"n1219303","1219303",0,0,0,0,0,0,0,0,0,0,0,0,0,0
"n1410021","1410021",2752,946,1806,78,65,1649,1703,2260,822,1438,62,46,1317,1352
"n1810109","1810109",6657,5039,1618,93,241,961,1191,4871,3828,1043,58,174,583,754
"n1890420","1890420",576,406,170,7,6,150,156,445,322,123,4,4,108,112
"n2011108","2011108",688,64,624,9,489,145,604,464,51,413,8,303,103,394
"n2011031","2011031",5691,1535,4156,45,807,3256,4020,3881,1242,2639,33,524,2022,2527
"n610027","610027",4715,219,4496,13,29,4455,4462,3340,168,3172,5,15,3143,3148
"n990308","990308",6413,5084,1329,90,239,802,1019,4794,3965,829,58,141,478,606
"n1133084","1133084",1990,644,1346,93,605,630,1218,1767,615,1152,91,543,507,1040
"n1131143","1131143",2364,1986,378,78,95,155,248,1599,1338,261,50,75,97,171
"n1133952","1133952",257,28,229,6,181,51,225,178,22,156,5,122,35,152
"n1270006","1270006",1533,150,1383,19,20,1333,1347,1129,128,1001,14,17,962,974
"n3710003","3710003",238,121,117,4,17,93,107,187,102,85,1,15,67,80
"n4391265","4391265",3175,1094,2081,86,1203,755,1917,2441,975,1466,65,844,523,1342
"n4391717","4391717",4339,1802,2537,124,1019,1284,2257,3102,1467,1635,86,650,785,1420
"n4394733","4394733",4554,1795,2759,1100,866,754,1585,2942,1198,1744,735,531,449,963
"n1890110","1890110",519,305,214,3,4,196,198,403,261,142,3,3,126,127
"n2010591","2010591",5893,334,5559,28,239,5324,5514,4177,281,3896,18,184,3707,3859
"n2011008","2011008",2004,1397,607,35,148,379,516,1510,1109,401,20,93,247,335
"n4690031","4690031",2447,876,1571,44,282,1254,1498,1877,773,1104,27,206,861,1049
"n4730419","4730419",5631,1042,4589,58,1504,3012,4454,4055,873,3182,47,1064,2027,3068
"n1310009","1310009",1919,251,1668,3,140,1256,1391,1586,231,1355,0,136,1004,1137
"n2010606","2010606",1824,13,1811,12,1272,542,1797,1191,11,1180,7,867,319,1173
"n2010108","2010108",9880,1964,7916,259,3157,4306,7344,7113,1725,5388,229,2097,2898,4928
"n2010649","2010649",10702,705,9997,1923,3047,5104,8010,7893,606,7287,1644,2138,3548,5598
"n2011146","2011146",4911,2718,2193,678,178,1151,1323,3167,1842,1325,410,110,665,773
"n2950409","2950409",296,106,190,0,4,181,184,214,82,132,0,2,124,126
"n130003","130003",2719,1068,1651,26,44,1521,1559,2013,860,1153,19,23,1064,1085
"n294125","294125",258,63,195,4,81,105,185,208,51,157,4,70,81,150
"n291096","291096",384,44,340,1,18,312,326,248,35,213,1,13,190,202
"n390066","390066",7311,1550,5761,2552,2059,1177,3168,4864,1088,3776,1717,1306,748,2023
"n1110009","1110009",1680,611,1069,10,45,981,1024,1190,468,722,7,31,657,687
"n1132056","1132056",1572,1253,319,131,53,110,160,1341,1101,240,108,30,83,111
"n4394344","4394344",1770,1454,316,57,55,178,226,1522,1286,236,49,50,122,166
"n4393063","4393063",2338,1723,615,89,102,360,448,1858,1445,413,67,54,226,278
"n4850303","4850303",4138,1190,2948,51,1405,1477,2809,2973,994,1979,30,974,923,1872
"n4970029","4970029",1263,346,917,12,23,873,890,875,286,589,11,11,561,570
"n2010208","2010208",5013,409,4604,9,617,3966,4562,3580,346,3234,3,473,2734,3197
"n2011046","2011046",1908,534,1374,116,235,1018,1237,1447,456,991,96,177,710,880
"n2450069","2450069",5429,3394,2035,399,396,1145,1518,4127,2775,1352,297,251,712,958
"n277001C","277001C",412,364,48,4,12,17,28,311,283,28,4,6,11,17
"n3550064","3550064",1156,711,445,34,45,334,368,897,583,314,24,19,229,247
"n3750224","3750224",6793,1861,4932,129,434,4349,4705,4657,1504,3153,82,198,2803,2983
"n1134611","1134611",4965,1096,3869,136,333,3361,3672,3653,935,2718,106,249,2319,2560
"n1214175","1214175",674,372,302,45,128,124,249,627,349,278,43,113,116,226
"n1410030","1410030",381,15,366,14,11,342,346,280,5,275,7,2,262,263
"n1674801","1674801",0,0,0,0,0,0,0,0,0,0,0,0,0,0
"n1930015","1930015",310,252,58,2,3,32,35,241,195,46,2,2,24,26
"n2010797","2010797",0,0,0,0,0,0,0,0,0,0,0,0,0,0
"n270412","270412",7055,1622,5433,430,3290,1765,4791,5036,1326,3710,328,2189,1166,3231
"n293181","293181",3498,1660,1838,374,219,1186,1376,2575,1321,1254,254,143,804,935
"n490303","490303",1943,1269,674,31,118,487,595,1406,952,454,21,71,320,389
"n850240","850240",8017,5512,2505,503,622,1131,1735,5159,3647,1512,307,380,686,1055
"n1132609","1132609",26,2,24,6,1,11,12,14,0,14,5,0,4,4
"n1211027","1211027",1407,590,817,174,334,278,607,997,449,548,131,222,179,396
"n3150005","3150005",896,662,234,7,166,29,191,745,559,186,6,142,17,157
"n3610024","3610024",2631,2190,441,102,46,256,292,1943,1663,280,82,21,138,159
"n4310002B","4310002B",0,0,0,0,0,0,0,0,0,0,0,0,0,0
"n4393539","4393539",34,19,15,8,3,1,4,27,17,10,5,1,1,2
"n4530358","4530358",4218,3031,1187,240,137,730,856,3313,2436,877,170,91,542,629
"n4910259","4910259",2576,1677,899,279,147,425,563,1885,1260,625,191,106,274,379
"n1410179","1410179",1689,32,1657,8,23,1642,1649,1113,25,1088,5,14,1075,1081
"n1830006","1830006",3904,2768,1136,225,472,321,772,2790,2071,719,154,273,213,482
"n2010897","2010897",3853,1277,2576,218,1162,1152,2263,3053,1097,1956,194,882,828,1687
"n2010357","2010357",5680,3689,1991,326,336,1188,1498,4040,2747,1293,241,189,750,928
"n2150104","2150104",9209,251,8958,52,45,8862,8873,5780,186,5594,27,25,5535,5545
"n2510038","2510038",1962,1163,799,13,49,643,688,1337,874,463,12,19,375,394
"n190408","190408",261,217,44,3,6,29,34,230,199,31,3,2,20,21
"n293201","293201",6426,3216,3210,533,625,2044,2613,4426,2319,2107,338,417,1301,1688
"n292063","292063",2469,1220,1249,115,126,974,1071,1894,1017,877,73,73,698,755
"n390026","390026",7585,2266,5319,805,1193,3305,4424,5498,1805,3693,575,849,2200,3017
"n610059","610059",520,406,114,14,15,81,92,495,403,92,11,11,65,73
"n850174","850174",7116,3812,3304,659,1146,1333,2423,4996,2817,2179,445,724,851,1553
"n4530432","4530432",1431,726,705,45,38,598,624,1235,657,578,32,25,498,513
"n4790447","4790447",7985,435,7550,22,37,7476,7493,5157,277,4880,16,15,4837,4845
"n5070001","5070001",854,107,747,7,5,736,739,654,76,578,7,2,572,572
"n2030001","2030001",3242,1839,1403,73,738,530,1261,2424,1492,932,41,529,303,828
"n2150164","2150164",4128,523,3605,142,43,3415,3438,2896,467,2429,111,23,2275,2291
"n4070004","4070004",1079,908,171,15,39,87,121,837,725,112,11,28,49,74
"n4391414","4391414",67,26,41,0,16,25,41,57,20,37,0,16,21,37
"n4393321","4393321",4252,2820,1432,168,131,1020,1131,3414,2381,1033,124,96,726,809
"n4410409","4410409",1278,1020,258,9,33,147,173,953,779,174,8,16,92,106
"n1410079","1410079",1727,59,1668,17,22,1626,1642,1274,45,1229,13,17,1194,1208
"n1573105","1573105",891,121,770,621,84,58,136,679,91,588,481,52,42,92
"n1850008","1850008",1067,755,312,6,100,185,278,817,605,212,5,71,112,181
"n2010171","2010171",3991,91,3900,43,1562,2317,3852,2682,78,2604,31,1095,1480,2568
"n2010834","2010834",624,20,604,7,532,71,600,350,13,337,7,297,38,333
"n2010503","2010503",4303,2688,1615,437,338,768,1066,3010,1878,1132,324,232,526,733
"n150205","150205",3961,2835,1126,39,340,649,975,3067,2290,777,32,252,415,664
"n292040","292040",4831,689,4142,80,334,3728,4014,3745,601,3144,62,234,2836,3048
"n293178","293178",1,0,1,0,0,1,1,1,0,1,0,0,1,1
"n390003","390003",7626,4406,3220,115,394,2563,2914,5700,3545,2155,68,234,1720,1941
"n2010857","2010857",0,0,0,0,0,0,0,0,0,0,0,0,0,0
"n2010194","2010194",3753,1766,1987,592,737,604,1313,3335,1635,1700,502,661,501,1142
"n4530402","4530402",4629,2065,2564,232,358,1892,2216,4057,1918,2139,205,319,1547,1834
"n4790344","4790344",5705,362,5343,136,45,5191,5205,4317,284,4033,107,24,3908,3917
"n3390052","3390052",9815,4450,5365,139,355,4663,4960,6889,3547,3342,91,232,2833,3039
"n3610027","3610027",2908,2616,292,24,14,172,184,2254,2051,203,20,6,114,119
"n4010418","4010418",3345,2168,1177,4,413,674,1081,2570,1770,800,1,312,418,726
"n4391300","4391300",4815,928,3887,285,1828,1796,3560,3471,828,2643,186,1250,1179,2416
"n4393187","4393187",2661,1628,1033,151,149,625,765,2004,1322,682,103,94,406,498
"n4410201","4410201",4143,1478,2665,62,474,2093,2505,3116,1251,1865,42,320,1446,1737
"n2010526","2010526",2408,148,2260,40,143,2077,2201,1826,131,1695,32,110,1560,1652
"n2030024","2030024",1639,1154,485,11,244,162,404,1232,888,344,7,199,88,286
"n2150187","2150187",5722,808,4914,12,23,4862,4866,4279,773,3506,7,16,3466,3469
"n2450043","2450043",4016,2535,1481,157,260,1061,1279,3059,2074,985,109,195,670,834
"n2850223","2850223",1882,1386,496,7,40,425,461,1455,1130,325,0,23,281,303
"n3150002","3150002",1662,1358,304,16,114,90,200,1408,1185,223,12,91,54,142
"n294042","294042",591,110,481,37,205,231,428,409,88,321,34,136,144,279
"n390072","390072",3849,846,3003,1205,1216,606,1775,2638,599,2039,849,811,386,1174
"n634004","634004",3070,1764,1306,45,486,716,1193,2299,1410,889,35,351,450,798
"n850220","850220",9015,2258,6757,4661,1114,865,1921,5689,1567,4122,2846,668,529,1171
"n1134605","1134605",5577,1308,4269,301,578,3344,3895,4079,1145,2934,225,395,2269,2642
"n1133076","1133076",0,0,0,0,0,0,0,0,0,0,0,0,0,0
"n4394702","4394702",2724,1449,1275,177,341,725,1043,1836,1002,834,112,206,482,677
"n3510008B","3510008B",163,41,122,1,109,3,112,137,37,100,1,89,1,90
"n3610004","3610004",947,66,881,6,826,47,869,651,54,597,2,552,41,589
"n3750124","3750124",3599,2427,1172,129,164,791,932,2650,1915,735,71,76,503,572
"n3990010","3990010",503,403,100,1,2,88,89,380,301,79,1,1,67,68
"n4391237","4391237",2773,293,2480,45,184,2264,2428,1866,254,1612,34,106,1476,1571
"n4393039","4393039",2355,1883,472,201,71,141,209,1741,1418,323,121,47,102,148
"n2450066","2450066",2061,1404,657,27,308,281,578,1582,1147,435,7,197,193,387
"n2592020","2592020",2702,2179,523,63,28,353,379,2210,1838,372,51,21,248,268
"n2890002","2890002",441,381,60,1,8,38,46,365,321,44,1,4,29,33
"n3030121","3030121",4780,3284,1496,113,172,1094,1224,3389,2414,975,85,98,682,768
"n3210007","3210007",335,242,93,14,5,74,77,255,192,63,13,0,48,48
"n3390032","3390032",4848,2695,2153,312,472,1221,1676,3785,2285,1500,234,272,878,1139
"n1131723","1131723",645,103,542,30,208,307,511,413,81,332,21,134,173,306
"n1250004","1250004",437,230,207,7,22,182,196,335,190,145,7,15,127,137
"n2010880","2010880",4681,2493,2188,630,315,1174,1468,3285,1883,1402,409,204,753,945
"n2090110","2090110",3676,1359,2317,104,168,2002,2134,2778,1146,1632,67,120,1396,1503
"n2150210","2150210",1064,14,1050,0,2,1050,1050,685,12,673,0,2,673,673
"n227207C","227207C",911,556,355,15,19,312,324,640,402,238,5,10,214,222
"n214021","214021",5065,2413,2652,56,327,2136,2452,3852,2045,1807,42,245,1387,1627
"n294019","294019",6575,850,5725,48,724,5009,5633,4687,723,3964,38,522,3417,3890
"n292085","292085",2652,311,2341,28,70,2249,2300,1978,276,1702,19,42,1627,1664
"n390049","390049",2429,1923,506,22,69,350,415,1810,1486,324,15,52,208,260
"n610082","610082",5797,289,5508,14,18,5466,5473,3868,245,3623,6,10,3598,3605
"n850197","850197",2446,731,1715,1387,142,159,294,1712,603,1109,895,96,98,191
"n3530007","3530007",369,306,63,0,11,33,41,295,253,42,0,6,17,22
"n3550120","3550120",3542,1149,2393,84,158,2116,2249,2684,982,1702,60,104,1494,1587
"n3770003","3770003",56,3,53,0,1,51,52,46,3,43,0,1,41,42
"n397002E","397002E",6171,1902,4269,244,833,3096,3892,4349,1509,2840,171,532,2054,2572
"n4230056","4230056",5178,3550,1628,194,716,566,1252,4386,3080,1306,151,603,429,1008
"n4392228","4392228",2895,2035,860,229,224,358,568,2340,1704,636,178,166,251,412
"n2450089","2450089",1241,238,1003,14,783,196,967,900,216,684,8,532,132,656
"n2570019","2570019",4159,2551,1608,51,451,1036,1460,3233,2145,1088,32,320,664,977
"n2910013","2910013",1508,1283,225,4,68,99,162,1120,977,143,1,37,61,94
"n3030062","3030062",3623,2284,1339,171,196,912,1080,2947,1949,998,137,119,669,787
"n323003A","323003A",5624,179,5445,24,27,5398,5412,4014,149,3865,14,11,3837,3845
"n3390011","3390011",3780,2508,1272,75,222,846,1043,2871,2029,842,39,141,560,688
"n1133053","1133053",5986,228,5758,52,4173,1547,5666,4410,208,4202,43,3117,1043,4127
"n1131700","1131700",5318,985,4333,155,467,3697,4130,3868,858,3010,107,294,2568,2852
"n2011026","2011026",5385,1107,4278,72,210,3965,4142,3762,948,2814,45,143,2580,2707
"n2150233","2150233",22,0,22,2,0,17,17,9,0,9,2,0,4,4
"n2150024","2150024",156,52,104,1,1,102,103,121,46,75,0,1,73,74
"n2270033","2270033",2810,1442,1368,51,178,1099,1254,2076,1187,889,28,112,710,812
"n294165","294165",177,103,74,0,5,69,69,147,87,60,0,2,58,58
"n291056","291056",7039,585,6454,107,257,6142,6346,4766,442,4324,67,155,4094,4235
"n291062","291062",441,69,372,13,21,344,360,306,54,252,10,9,236,244
"n850011","850011",7059,4432,2627,94,374,1935,2306,5089,3409,1680,58,274,1177,1449
"n1132118","1132118",3025,103,2922,21,890,2028,2891,2286,97,2189,16,705,1469,2166
"n1134659","1134659",740,102,638,2,30,595,621,528,90,438,1,23,403,422
"n3030035","3030035",1183,842,341,7,25,281,300,968,735,233,7,13,188,197
"n3270003","3270003",500,368,132,5,9,111,117,436,331,105,5,6,88,91
"n3810222","3810222",6053,4612,1441,139,226,911,1116,4669,3674,995,87,157,606,751
"n4392309","4392309",5218,770,4448,75,270,4067,4315,3560,686,2874,56,169,2616,2771
"n4530215","4530215",1396,775,621,139,81,379,445,1243,720,523,121,69,317,376
"n4690014","4690014",2169,1131,1038,4,104,927,1007,1662,925,737,3,67,653,715
"n1430045","1430045",5156,3157,1999,82,794,1008,1798,4655,2811,1844,74,764,906,1668
"n2011003","2011003",449,159,290,43,129,109,237,419,157,262,41,116,95,210
"n2010666","2010666",0,0,0,0,0,0,0,0,0,0,0,0,0,0
"n2010340","2010340",5014,3238,1776,153,301,1220,1491,3746,2558,1188,99,198,802,986
"n2010003","2010003",4620,3270,1350,317,130,814,932,3564,2585,979,178,85,649,729
"n2250009","2250009",573,480,93,3,30,41,67,462,401,61,1,13,26,38
"n294182","294182",0,0,0,0,0,0,0,0,0,0,0,0,0,0
"n291079","291079",4942,992,3950,314,665,3071,3612,3603,797,2806,223,462,2131,2551
"n850034","850034",6364,1909,4455,3828,270,338,582,4715,1564,3151,2688,206,236,422
"n1132143","1132143",729,421,308,89,101,101,196,682,404,278,88,88,82,169
"n1134628","1134628",5574,755,4819,1148,2413,1252,3586,4306,683,3623,960,1729,922,2607
"n1131746","1131746",3154,787,2367,472,630,1275,1875,2404,670,1734,356,471,889,1354
"n2010980","2010980",1694,884,810,379,136,276,411,1417,769,648,316,122,195,317
"n2230011","2230011",1191,1031,160,6,16,79,95,923,815,108,4,14,47,61
"n3830003A","3830003A",705,232,473,7,18,442,454,468,190,278,4,11,256,266
"n4392401","4392401",914,411,503,14,195,294,480,768,400,368,12,141,209,345
"n4530245","4530245",5596,2926,2670,1033,403,1139,1502,5339,2841,2498,977,377,1047,1387
"n4910343","4910343",5135,3406,1729,156,297,1181,1446,4108,2862,1246,130,215,815,1004
"n1212067","1212067",4853,1756,3097,56,200,2750,2934,3442,1480,1962,39,128,1716,1830
"n1410217","1410217",1167,23,1144,12,16,1132,1136,714,13,701,9,10,694,698
"n1572036","1572036",1444,38,1406,19,1185,213,1387,1140,36,1104,18,931,161,1085
"n1670224","1670224",5633,3009,2624,366,722,1444,2135,4714,2701,2013,320,529,1073,1596
"n1970003","1970003",873,519,354,4,42,285,319,661,427,234,3,27,181,204
"n2010317","2010317",4030,666,3364,241,1974,1200,3089,3022,569,2453,185,1427,859,2247
"n1132226","1132226",3771,3197,574,290,33,149,177,2606,2251,355,172,28,99,124
"n1212090","1212090",7585,3628,3957,964,1165,1721,2823,5827,2946,2881,741,805,1223,1997
"n1270004","1270004",101,16,85,1,1,85,85,87,13,74,1,1,74,74
"n1572109","1572109",1777,490,1287,168,478,668,1117,1312,399,913,131,376,425,782
"n1670159","1670159",9683,4613,5070,278,627,3959,4555,7120,3778,3342,225,393,2540,2917
"n2010048","2010048",1637,155,1482,29,782,709,1454,1282,126,1156,25,663,494,1134
"n4910398","4910398",5740,3303,2437,1116,373,860,1192,4188,2542,1646,732,255,572,812
"n3510013","3510013",1294,1164,130,8,30,47,77,1054,966,88,7,17,25,42
"n4230039","4230039",527,143,384,2,271,102,370,408,106,302,1,228,65,290
"n4392468","4392468",3434,1899,1535,380,453,620,1061,2698,1562,1136,304,331,423,749
"n4394047","4394047",5972,4729,1243,60,113,813,910,4654,3829,825,44,54,503,550
"n4530274","4530274",6071,3900,2171,742,311,977,1275,4436,2958,1478,499,211,654,861
"n4650012D","4650012D",0,0,0,0,0,0,0,0,0,0,0,0,0,0
"n2010294","2010294",2437,28,2409,18,1898,512,2388,1906,22,1884,13,1546,337,1867
"n2010711","2010711",10264,3221,7043,2570,2180,2241,4315,7835,2601,5234,1866,1613,1689,3237
"n2010957","2010957",1061,71,990,87,458,463,904,794,56,738,75,364,310,664
"n2010125","2010125",4939,1630,3309,382,1144,1743,2833,3695,1379,2316,287,740,1220,1937
"n2150041","2150041",10189,159,10030,19,28,9991,9993,6707,111,6596,14,12,6573,6574
"n2570036","2570036",4069,2150,1919,179,871,759,1609,2757,1587,1170,120,513,437,943
"n1133059","1133059",1443,37,1406,5,1169,237,1399,1150,31,1119,4,976,146,1115
"n1219301","1219301",0,0,0,0,0,0,0,0,0,0,0,0,0,0
"n1212113","1212113",4462,2425,2037,988,314,671,974,3735,2098,1637,828,222,524,743
"n1470010","1470010",4097,3179,918,27,97,593,685,3033,2447,586,22,72,356,424
"n1573043","1573043",2093,257,1836,512,521,800,1289,1551,208,1343,402,391,551,924
"n1630003","1630003",1260,28,1232,0,15,1210,1223,915,21,894,0,12,876,888
"n4910433","4910433",7340,4336,3004,1056,456,1351,1762,5051,3123,1928,700,272,822,1082
"n4230066","4230066",1600,470,1130,3,254,862,1108,1164,422,742,1,210,523,727
"n4394107","4394107",2920,206,2714,54,142,2534,2657,2069,168,1901,51,114,1745,1849
"n4393384","4393384",2692,1737,955,167,198,532,718,2057,1417,640,128,127,341,459
"n4530315","4530315",4827,2229,2598,1365,250,985,1225,4733,2187,2546,1333,246,966,1205
"n4530463","4530463",2211,655,1556,99,231,1215,1422,1667,580,1087,78,159,828,977
"n467002D","467002D",2604,2210,394,19,37,241,275,2071,1799,272,14,18,165,183
"n2010811","2010811",539,21,518,2,14,504,514,414,15,399,1,12,386,395
"n2010026","2010026",3563,703,2860,153,224,2484,2671,2894,642,2252,136,181,1919,2078
"n2010271","2010271",3599,26,3573,11,3187,400,3553,2737,18,2719,7,2480,246,2704
"n2010148","2010148",3717,2244,1473,824,188,387,558,2877,1786,1091,624,139,274,403
"n2010688","2010688",6499,4143,2356,611,440,1162,1566,4860,3318,1542,392,294,719,1002
"n2150018","2150018",810,29,781,0,1,779,779,555,14,541,0,1,539,539
"n570001","570001",3159,419,2740,94,93,2562,2624,2279,333,1946,56,58,1829,1873
"n1134065","1134065",2358,140,2218,6,24,2175,2197,1662,123,1539,3,22,1501,1523
"n1131325","1131325",4492,1821,2671,214,923,1504,2382,3414,1570,1844,182,641,975,1593
"n1132510","1132510",2672,1437,1235,414,261,511,751,2115,1166,949,342,202,351,540
"n1133036","1133036",85,7,78,1,22,58,78,68,7,61,1,15,46,61
"n1410156","1410156",3269,59,3210,7,21,3191,3192,2507,44,2463,0,18,2452,2452
"n3390068","3390068",7869,4635,3234,342,867,1876,2667,5684,3540,2144,239,513,1223,1715
"n3470046","3470046",1455,1092,363,10,109,179,287,1086,837,249,9,77,116,192
"n3630011","3630011",424,337,87,3,6,67,73,329,264,65,3,4,51,55
"n4391678","4391678",76,13,63,5,11,49,58,50,12,38,2,8,29,35
"n1573086","1573086",5214,767,4447,3067,880,524,1371,3879,571,3308,2264,636,400,1019
"n1610002","1610002",2502,1516,986,19,548,378,915,1936,1215,721,14,414,250,662
"n2150087","2150087",6341,112,6229,7,14,6168,6171,3487,76,3411,5,10,3380,3383
"n2150170","2150170",1969,16,1953,1,6,1944,1946,1329,13,1316,1,4,1308,1310
"n2310433","2310433",6510,1419,5091,43,1604,3374,4910,4479,1107,3372,33,1153,2093,3224
"n3090084","3090084",3547,2710,837,36,275,470,730,2663,2075,588,24,212,312,518
"n292162","292162",1495,470,1025,299,161,565,710,1213,440,773,196,115,452,558
"n610042","610042",2535,152,2383,4,34,2340,2357,1857,119,1738,3,20,1701,1716
"n850157","850157",6227,2598,3629,2656,436,456,880,4265,1905,2360,1730,291,283,573
"n1134135","1134135",3936,701,3235,441,606,2180,2725,3186,651,2535,388,505,1627,2086
"n1131108","1131108",6572,332,6240,23,1246,4985,6164,4548,285,4263,13,958,3272,4200
"n1214189","1214189",1092,614,478,17,24,413,435,817,526,291,10,15,243,256
"n5010404","5010404",746,371,375,3,5,354,356,556,295,261,2,1,242,242
"n2850430","2850430",4079,1843,2236,23,416,1772,2140,3002,1539,1463,20,266,1136,1389
"n3030153","3030153",2534,172,2362,11,1294,1103,2337,1895,133,1762,7,954,834,1744
"n3730009","3730009",1058,638,420,3,194,199,389,850,525,325,2,163,139,300
"n4230016","4230016",2427,243,2184,2,1149,1022,2151,1734,217,1517,2,869,638,1497
"n4530133","4530133",5445,929,4516,114,656,3765,4350,4041,834,3207,96,542,2572,3066
"n4790363","4790363",1889,45,1844,1,4,1834,1836,1337,32,1305,0,1,1304,1305
"n1213153","1213153",3767,3153,614,93,76,339,404,2955,2524,431,58,55,231,280
"n1410096","1410096",4348,697,3651,70,128,3485,3575,3436,609,2827,53,97,2689,2764
"n2010188","2010188",4914,411,4503,26,67,4410,4451,3496,359,3137,24,41,3057,3091
"n2011066","2011066",39,6,33,11,13,9,19,23,1,22,8,6,7,11
"n2010734","2010734",4211,2152,2059,415,618,952,1537,3033,1633,1400,292,420,620,1025
"n2610005","2610005",25,2,23,2,1,22,22,22,1,21,1,1,21,21
"n10022","10022",1434,1146,288,30,98,125,219,1150,944,206,24,84,71,155
"n294205","294205",205,54,151,6,6,141,144,172,50,122,4,3,112,115
"n291016","291016",1976,75,1901,12,15,1883,1891,1514,59,1455,9,11,1443,1447
"n293161","293161",5586,1587,3999,249,700,3064,3672,4480,1438,3042,186,510,2327,2786
"n37005B","37005B",7,1,6,0,2,4,6,6,1,5,0,1,4,5
"n410071","410071",172,135,37,7,5,12,17,112,85,27,3,2,11,13
"n2150124","2150124",2496,463,2033,83,64,1879,1924,2015,407,1608,76,38,1480,1505
"n3410201","3410201",2503,1160,1343,123,90,1093,1174,1782,933,849,69,52,697,743
"n3670135","3670135",2659,2033,626,27,65,389,449,2001,1597,404,17,32,247,278
"n4393446","4393446",0,0,0,0,0,0,0,0,0,0,0,0,0,0
"n4510108","4510108",1359,963,396,7,21,339,349,1050,776,274,3,12,230,235
"n510406","510406",1863,825,1038,11,472,519,955,1394,671,723,7,324,345,653
"n1131134","1131134",1217,33,1184,11,623,542,1160,792,26,766,11,400,347,746
"n1132220","1132220",2292,1980,312,128,31,105,136,1578,1397,181,72,17,61,78
"n1810401","1810401",2980,1768,1212,40,599,369,949,2308,1453,855,27,434,234,662
"n2010131","2010131",4297,186,4111,70,446,3606,4025,2793,169,2624,57,335,2232,2559
"n2011126","2011126",4508,529,3979,549,1758,1723,3415,3400,454,2946,445,1269,1253,2487
"n90006","90006",1595,1359,236,10,43,120,157,1230,1071,159,7,29,73,98
"n294142","294142",1560,207,1353,36,750,568,1286,1215,172,1043,34,577,432,986
"n293103","293103",1447,354,1093,192,235,671,878,1013,265,748,128,167,438,593
"n291159","291159",611,39,572,2,5,567,568,480,28,452,1,3,448,448
"n293017","293017",3316,2379,937,115,80,648,725,2450,1817,633,70,59,437,495
"n590004","590004",1937,1742,195,11,16,127,141,1539,1418,121,5,7,75,81
"n2450003","2450003",3586,137,3449,20,2827,628,3427,2547,116,2431,17,2027,400,2412
"n2730014","2730014",2476,481,1995,32,82,1868,1930,1770,387,1383,28,51,1293,1333
"n277004F","277004F",2607,2037,570,49,226,158,379,1912,1525,387,44,147,96,241
"n3090026","3090026",1851,612,1239,37,319,892,1189,1437,554,883,27,242,613,844
"n4090110","4090110",2790,756,2034,16,54,1949,1979,2117,631,1486,12,30,1425,1443
"n4391445","4391445",92,32,60,1,2,54,56,65,21,44,1,2,38,40
"n850074","850074",2881,1862,1019,345,298,321,604,2328,1505,823,289,251,232,477
"n950102","950102",107,59,48,2,2,44,44,78,48,30,2,2,26,26
"n1131054","1131054",3920,813,3107,182,206,2694,2880,2972,729,2243,170,179,1874,2037
"n1212107","1212107",5389,3086,2303,867,368,940,1296,4233,2572,1661,642,263,643,899
"n2010817","2010817",3411,1527,1884,713,454,659,1092,2565,1199,1366,493,336,486,809
"n2010486","2010486",6664,3968,2696,798,461,1321,1736,4998,3135,1863,566,321,864,1170
"n292148","292148",8046,2084,5962,997,1103,3938,4888,6627,1932,4695,727,862,3093,3871
"n430008","430008",1385,381,1004,19,117,870,970,1192,343,849,13,104,731,823
"n890202","890202",744,532,212,6,22,166,185,582,461,121,4,9,91,100
"n1133809","1133809",735,88,647,11,261,372,632,506,72,434,11,201,219,419
"n1211050","1211050",814,392,422,43,178,164,335,553,268,285,32,119,103,218
"n1350206","1350206",2908,1297,1611,122,246,1182,1396,2373,1109,1264,103,200,904,1084
"n2930202","2930202",1825,352,1473,13,791,700,1454,1294,283,1011,5,601,408,1001
"n3950022","3950022",2365,339,2026,13,1356,664,1987,1686,277,1409,9,980,405,1379
"n4270003","4270003",4276,49,4227,3,11,4218,4219,2974,39,2935,3,6,2930,2931
"n4530335","4530335",4534,2952,1582,361,152,1030,1161,3294,2239,1055,237,101,663,755
"n4910311","4910311",225,147,78,2,11,60,70,174,128,46,2,3,36,39
"n2010334","2010334",2284,190,2094,69,1397,617,1985,1620,158,1462,54,980,410,1375
"n2010920","2010920",482,148,334,10,152,153,301,341,126,215,5,91,101,189
"n2010085","2010085",4117,970,3147,972,1611,583,2165,3893,957,2936,960,1445,540,1968
"n2010672","2010672",7691,3240,4451,498,913,2934,3793,5292,2427,2865,354,592,1823,2390
"n2550011","2550011",1253,557,696,24,37,633,658,946,455,491,20,19,444,457
"n2930302","2930302",1295,647,648,12,305,325,621,1001,535,466,6,234,226,455
"n293057","293057",910,416,494,42,69,386,438,733,364,369,32,44,286,328
"n410011","410011",6315,2426,3889,996,893,1946,2773,5150,2212,2938,921,577,1362,1913
"n1030003","1030003",1151,258,893,18,59,808,854,816,216,600,14,47,533,571
"n1133099","1133099",467,13,454,5,246,203,449,356,10,346,3,205,137,342
"n1410010","1410010",8056,612,7444,113,204,7207,7325,5920,518,5402,86,138,5228,5318
"n1572058","1572058",3697,410,3287,198,1899,1233,3074,2512,325,2187,146,1273,786,2033
"n3550038","3550038",355,29,326,9,156,175,318,273,19,254,6,126,130,249
"n4394239","4394239",345,159,186,14,23,149,165,257,124,133,10,9,112,119
"n4392535","4392535",4391,2890,1501,311,519,602,1095,3441,2345,1096,213,392,432,808
"n4570003","4570003",1886,1417,469,11,193,193,384,1537,1187,350,10,142,125,267
"n1670214","1670214",6218,2211,4007,117,1824,1975,3753,5034,1982,3052,78,1437,1432,2845
"n1990005","1990005",875,818,57,5,16,25,38,697,653,44,4,11,16,26
"n2010771","2010771",5568,827,4741,325,1102,3380,4365,3954,680,3274,247,731,2312,2983
"n213002E","213002E",3608,3152,456,18,51,282,329,2797,2463,334,16,40,185,222
"n2190011","2190011",660,338,322,8,30,275,301,473,285,188,4,16,159,173
"n3310317","3310317",1542,1241,301,11,75,175,246,1195,1019,176,10,50,86,135
"n292102","292102",3653,1004,2649,155,372,2173,2484,2808,844,1964,122,279,1570,1824
"n770006","770006",625,513,112,8,7,55,61,486,415,71,7,3,30,33
"n1134020","1134020",2152,472,1680,96,314,1243,1534,1875,459,1416,85,284,1007,1278
"n1211004","1211004",5274,3525,1749,64,321,1144,1426,3800,2663,1137,44,197,705,889
"n1410202","1410202",4859,376,4483,56,160,4300,4424,3110,253,2857,44,103,2718,2806
"n1574048","1574048",5115,596,4519,74,1370,3137,4419,3628,517,3111,53,871,2196,3032
"n4530383","4530383",4834,3029,1805,1066,120,529,630,3650,2422,1228,734,87,340,417
"n4710404","4710404",5019,3729,1290,37,639,477,1099,3873,2974,899,23,455,299,751
"n4910202","4910202",990,586,404,176,83,137,213,808,515,293,117,62,103,163
"n1810305","1810305",2119,1753,366,27,30,170,198,1674,1422,252,19,13,109,120
"n2010380","2010380",7351,2598,4753,536,2152,2081,4148,5184,1932,3252,381,1496,1367,2810
"n2010626","2010626",8653,3365,5288,841,2311,2122,4317,6987,2974,4013,672,1667,1609,3218
"n2010874","2010874",4561,2806,1755,244,399,1050,1409,3466,2246,1220,170,269,705,956
"n227031A","227031A",0,0,0,0,0,0,0,0,0,0,0,0,0,0
"n4392169","4392169",5029,313,4716,182,1519,3013,4499,3348,240,3108,143,1071,1878,2931
"n291119","291119",318,20,298,1,8,293,297,228,12,216,1,2,214,215
"n1132101","1132101",1848,1388,460,106,89,238,320,1795,1361,434,96,82,224,300
"n1134535","1134535",1934,169,1765,97,200,1453,1638,1396,146,1250,75,150,1008,1149
"n1410056","1410056",3554,736,2818,96,263,2529,2733,2699,660,2039,69,199,1806,1969
"n1571008","1571008",1448,866,582,18,125,424,546,1205,736,469,9,97,349,444
"n1670432","1670432",3231,1403,1828,74,687,1029,1685,2569,1201,1368,58,522,738,1251
"n4530191","4530191",3851,2073,1778,329,435,991,1384,3173,1822,1351,254,331,726,1038
"n4830401","4830401",1371,1019,352,26,60,232,286,1023,811,212,22,32,132,160
"n4970001","4970001",1483,978,505,15,25,424,438,1075,736,339,9,14,278,290
"n1890305","1890305",1540,881,659,14,41,576,612,1209,740,469,11,27,409,431
"n2011020","2011020",3672,376,3296,111,1538,1654,3118,2556,310,2246,79,1069,1093,2125
"n2010234","2010234",5901,4209,1692,568,328,735,1038,5282,3850,1432,480,285,627,890
"n2010480","2010480",4505,1971,2534,545,523,1372,1878,3462,1675,1787,421,335,951,1278
"n2150227","2150227",10377,150,10227,15,28,10174,10184,6880,71,6809,8,11,6792,6799
"n4392741","4392741",420,49,371,36,219,110,323,288,34,254,29,147,68,212
"n294079","294079",2602,1101,1501,175,421,901,1283,2103,962,1141,135,304,674,966
"n291141","291141",4827,1073,3754,267,820,2752,3464,3289,803,2486,166,528,1804,2285
"n550306","550306",2573,424,2149,27,43,2070,2103,1798,355,1443,21,34,1379,1409
"n710003","710003",729,271,458,15,138,299,427,557,220,337,15,113,197,310
"n890102","890102",422,258,164,1,44,105,148,359,232,127,1,39,72,111
"n1410162","1410162",7592,140,7452,18,42,7410,7426,5356,100,5256,9,18,5226,5239
"n4590006","4590006",2236,1743,493,36,195,165,348,1619,1306,313,17,122,94,213
"n4910490","4910490",7270,3694,3576,822,1096,1617,2629,5426,2984,2442,520,747,1087,1796
"n2310427","2310427",6594,3364,3230,256,1932,721,2595,5408,2885,2523,220,1512,495,1969
"n3970002","3970002",6224,4421,1803,297,506,837,1308,5054,3776,1278,223,345,566,895
"n4391104","4391104",4887,368,4519,115,2334,2078,4389,3589,311,3278,82,1863,1317,3179
"n4391714","4391714",6552,1533,5019,336,2878,1803,4592,4878,1327,3551,259,2022,1196,3189
"n4394533","4394533",3497,1189,2308,268,208,1781,1968,2486,986,1500,203,123,1130,1243
"n4393646","4393646",6000,3615,2385,400,685,1121,1758,4346,2695,1651,286,485,735,1192
"n1610006A","1610006A",703,587,116,6,50,53,99,555,472,83,3,32,37,68
"n1770010","1770010",883,403,480,1,15,460,466,687,341,346,0,9,332,337
"n2010254","2010254",4509,161,4348,21,147,4152,4285,2944,137,2807,17,117,2663,2769
"n2010751","2010751",6783,2297,4486,802,1227,2453,3561,5162,1879,3283,595,878,1792,2587
"n2090315","2090315",2194,1499,695,72,52,465,511,1834,1296,538,54,41,350,389
"n2150081","2150081",3615,362,3253,114,29,3103,3122,2682,297,2385,87,25,2271,2289
"n270415","270415",7405,1614,5791,465,3546,1849,5105,5266,1364,3902,362,2298,1192,3359
"n294102","294102",2217,438,1779,71,544,1171,1696,1754,373,1381,61,438,890,1310
"n293141","293141",415,118,297,12,70,216,282,411,118,293,12,69,213,278
"n410054","410054",831,598,233,19,31,156,184,651,498,153,15,18,102,119
"n590007","590007",621,553,68,0,6,45,50,516,462,54,0,3,36,39
"n850114","850114",1971,1381,590,46,76,428,485,1501,1115,386,33,40,277,303
"n4910162","4910162",6170,3640,2530,822,471,1137,1561,4810,2918,1892,635,337,834,1142
"n4970004","4970004",1351,1101,250,13,12,184,196,1042,890,152,3,8,111,119
"n1870232","1870232",57,48,9,0,0,6,6,47,42,5,0,0,2,2
"n2010397","2010397",2233,208,2025,24,143,1864,1986,1580,186,1394,16,113,1260,1361
"n2010231","2010231",6632,500,6132,94,395,5664,6002,4818,368,4450,69,292,4092,4352
"n2010894","2010894",7209,499,6710,307,4279,2206,6348,5001,423,4578,229,2898,1495,4313
"n4393729","4393729",6,3,3,0,2,1,2,5,3,2,0,2,1,2
"n4530362","4530362",4583,3478,1105,252,130,601,715,3147,2440,707,160,66,386,449
"n910203","910203",6446,4637,1809,194,324,1142,1439,5133,3802,1331,140,261,802,1045
"n1132606","1132606",5634,1434,4200,2521,864,787,1624,4702,1335,3367,1949,734,663,1377
"n1211030","1211030",38,5,33,6,15,10,24,28,5,23,3,8,9,17
"n1410139","1410139",3344,157,3187,30,44,3140,3162,2605,123,2482,23,27,2447,2466
"n1571019","1571019",1357,803,554,38,175,304,461,1057,658,399,27,135,206,332
"n4770109","4770109",1429,1043,386,8,137,219,355,1143,876,267,5,99,141,240
"n2670006","2670006",459,408,51,1,3,38,40,425,381,44,1,3,32,34
"n292154","292154",7349,2179,5170,487,763,4028,4624,4838,1570,3268,296,432,2548,2927
"n2010180","2010180",4504,116,4388,22,3144,1244,4332,3279,101,3178,16,2346,833,3143
"n3570004","3570004",2593,1082,1511,12,19,1437,1451,1821,850,971,7,11,909,920
"n1133045","1133045",1032,37,995,59,619,315,924,721,24,697,32,483,184,660
"n4710204A","4710204A",756,526,230,7,156,56,207,613,429,184,7,132,38,167
"n2010223","2010223",8789,2286,6503,3340,1977,1188,3080,7846,2138,5708,2974,1682,1042,2660
"n2593040","2593040",1513,1028,485,9,6,436,441,1148,818,330,5,2,302,303
"n1133002","1133002",2421,109,2312,47,452,1816,2249,1726,102,1624,35,354,1229,1574
"n467004E","467004E",1785,1432,353,13,41,209,249,1433,1156,277,10,29,168,196
"n2010137","2010137",5863,2419,3444,338,812,2205,2973,3822,1729,2093,229,515,1260,1759
"n610091","610091",2534,84,2450,58,11,2384,2389,1618,73,1545,42,9,1497,1501
"n2011115","2011115",930,355,575,89,73,390,451,714,307,407,58,46,283,325
"n292111","292111",2491,390,2101,65,370,1685,2010,1956,367,1589,56,265,1257,1510
"n1410105","1410105",3775,435,3340,55,147,3185,3276,3000,385,2615,47,104,2489,2561
"n4392513","4392513",0,0,0,0,0,0,0,0,0,0,0,0,0,0
"n4392190","4392190",613,211,402,16,59,314,371,480,193,287,16,42,218,258
"n292026","292026",3691,658,3033,140,281,2643,2871,2813,580,2233,86,176,1964,2118
"n1391035","1391035",3726,2177,1549,58,246,1138,1367,2699,1661,1038,37,165,744,906
"n3550047","3550047",968,120,848,4,64,775,823,685,103,582,2,35,529,562
"n2010051","2010051",2676,1595,1081,53,40,924,953,2146,1396,750,46,31,627,649
"n4391718","4391718",1456,583,873,186,379,293,661,1159,485,674,156,299,205,499
"n2010009","2010009",4044,931,3113,201,1261,1640,2856,3280,872,2408,171,890,1312,2177
"n1410019","1410019",6786,1346,5440,225,300,4898,5139,5391,1187,4204,187,207,3767,3950
"n2011072","2011072",3459,904,2555,384,1009,1179,2124,2742,761,1981,300,756,919,1630
"n610048","610048",5426,407,5019,90,47,4892,4923,3830,328,3502,62,28,3412,3430
"n4530466","4530466",9547,1146,8401,174,567,7721,8155,6732,1009,5723,146,378,5197,5521
"n4392675","4392675",18,0,18,0,4,9,13,15,0,15,0,1,9,10
"n2570005","2570005",4127,991,3136,36,1959,1140,3060,3110,856,2254,26,1501,714,2196
"n4393391","4393391",5875,2404,3471,792,1295,1234,2470,4669,2092,2577,634,916,882,1768
"n2010283","2010283",6544,245,6299,161,2723,3497,6115,4385,191,4194,119,1863,2247,4057
"n1410148","1410148",3604,121,3483,23,24,3441,3448,2740,99,2641,3,10,2621,2625
"n1132517","1132517",5206,1245,3961,1651,1688,572,2226,4013,1084,2929,1210,1229,446,1653
"n4810202","4810202",1178,346,832,1,576,258,822,932,288,644,1,459,176,635
"n3710007","3710007",2838,574,2264,21,35,2194,2217,2079,459,1620,17,21,1568,1583
"n850020","850020",1099,857,242,25,32,150,177,884,703,181,20,29,108,133
"n4393575","4393575",12,3,9,0,6,2,7,10,3,7,0,5,0,5
"n2910026","2910026",5975,2851,3124,45,150,2775,2915,4156,2195,1961,31,97,1712,1805
"n1133309","1133309",3739,1284,2455,89,1223,1101,2292,2884,1100,1784,65,892,789,1667
"n1410208","1410208",4387,78,4309,14,32,4283,4295,3130,51,3079,9,20,3064,3070
"n2090121","2090121",4328,1704,2624,240,608,1765,2301,3952,1601,2351,211,557,1565,2064
"n2150033","2150033",2759,109,2650,12,12,2623,2627,1959,89,1870,10,6,1852,1853
"n293109","293109",5647,1371,4276,239,415,3657,4000,4335,1191,3144,182,302,2646,2912
"n2010369","2010369",1139,262,877,72,509,305,793,1043,257,786,64,464,262,709
"n3630021","3630021",1240,855,385,19,65,280,333,910,681,229,11,37,153,187
"n2774A6E","2774A6E",2334,1656,678,163,227,191,412,1878,1399,479,118,162,120,279
"n2110402","2110402",129,116,13,0,1,7,8,90,81,9,0,0,4,4
"n3750421","3750421",4660,709,3951,158,518,3276,3730,3233,605,2628,107,339,2148,2465
"n2010240","2010240",4389,70,4319,37,3345,986,4255,3140,65,3075,21,2466,595,3035
"n1132302","1132302",4043,748,3295,138,155,2934,3078,3129,664,2465,122,143,2129,2268
"n2010986","2010986",3128,109,3019,74,1048,1922,2906,1950,85,1865,50,662,1183,1810
"n4630009","4630009",2174,190,1984,7,20,1958,1960,1622,132,1490,6,5,1473,1475
"n4392748","4392748",0,0,0,0,0,0,0,0,0,0,0,0,0,0
"n1350209","1350209",3182,1505,1677,125,365,1145,1473,2532,1257,1275,109,274,851,1105
"n3550090","3550090",1357,378,979,35,50,878,915,1072,326,746,27,37,664,693
"n610005","610005",4596,798,3798,76,31,3696,3723,3559,759,2800,61,23,2716,2737
"n2490003","2490003",1512,773,739,9,23,666,680,1148,645,503,2,12,451,461
"n1132104","1132104",852,392,460,196,154,87,240,703,343,360,130,129,79,208
"n530005","530005",1230,1025,205,11,15,138,152,1063,919,144,10,10,90,100
"n4890007","4890007",388,52,336,3,5,320,325,296,43,253,3,5,237,242
"n4730105","4730105",1311,845,466,10,69,350,414,981,680,301,8,35,225,259
"n4392320","4392320",4327,686,3641,805,1618,1246,2797,3189,571,2618,626,1120,878,1954
"n292068","292068",5538,1817,3721,202,349,3178,3461,4424,1558,2866,152,273,2398,2642
"n3490401","3490401",1355,515,840,15,251,554,786,1035,431,604,12,195,378,567
"n4394073","4394073",1241,386,855,25,404,425,821,843,357,486,18,208,263,463
"n690201","690201",1608,326,1282,19,62,1209,1257,1125,274,851,16,38,793,828
"n4392275","4392275",1753,385,1368,103,412,829,1214,1280,328,952,82,287,558,833
"n2530004","2530004",3629,2740,889,35,98,655,735,2767,2177,590,22,57,425,476
"n1391058","1391058",2200,1031,1169,42,217,869,1073,1556,798,758,29,135,551,684
"n2011009","2011009",757,31,726,197,118,416,532,555,31,524,165,87,278,364
"n4392428","4392428",2316,243,2073,72,565,1474,1997,1601,207,1394,58,358,989,1330
"n2570028","2570028",3180,2027,1153,33,319,747,1050,2497,1664,833,21,249,528,763
"n1132803","1132803",1564,1192,372,165,33,147,174,1180,951,229,94,20,100,114
"n2010117","2010117",6701,696,6005,109,338,5589,5873,4696,603,4093,78,252,3778,3993
"n3510016","3510016",426,315,111,0,79,17,96,327,245,82,0,52,15,67
"n2010966","2010966",5736,514,5222,131,1642,3495,5027,4134,441,3693,100,1236,2377,3538
"n292134","292134",4251,721,3530,373,797,2389,3080,3246,653,2593,204,548,1823,2314
"n1133025","1133025",1402,2,1400,1,131,1271,1396,868,2,866,1,106,765,865
"n2010160","2010160",1200,46,1154,16,704,460,1128,930,42,888,11,561,328,867
"n770017","770017",1141,1047,94,10,5,45,49,968,906,62,9,0,26,26
"n4392033","4392033",4976,2048,2928,103,801,1978,2706,3562,1663,1899,66,465,1296,1748
"n4393240","4393240",5763,2933,2830,647,709,1348,2002,3976,2148,1828,431,459,835,1271
"n3390035","3390035",9130,4534,4596,441,1211,2840,3961,6850,3768,3082,310,751,1896,2603
"n4530385B","4530385B",47,14,33,18,3,9,12,35,12,23,15,2,4,6
"n570004","570004",2702,575,2127,119,170,1869,2004,2028,489,1539,94,127,1331,1442
"n2790003","2790003",1212,421,791,4,29,765,784,869,347,522,4,16,507,520
"n2010243","2010243",708,3,705,1,601,110,701,565,3,562,0,491,70,558
"n650302","650302",556,470,86,0,9,55,63,428,363,65,0,9,37,45
"n4392775","4392775",0,0,0,0,0,0,0,0,0,0,0,0,0,0
"n2011135","2011135",7755,1192,6563,566,1893,4128,5894,5414,941,4473,427,1239,2784,3974
"n2010923","2010923",6634,3753,2881,1070,601,1079,1651,4449,2614,1835,681,392,675,1049
"n1132800","1132800",0,0,0,0,0,0,0,0,0,0,0,0,0,0
"n1410168","1410168",982,37,945,11,12,931,935,633,30,603,7,10,591,595
"n291124","291124",397,21,376,6,9,364,372,310,15,295,6,9,283,291
"n850106","850106",2878,1645,1233,331,332,507,814,2169,1316,853,243,222,324,537
"n3790408","3790408",1553,1286,267,13,40,151,187,1183,1003,180,11,27,91,117
"n4530438","4530438",3906,1421,2485,138,247,2085,2284,3193,1293,1900,114,179,1572,1726
"n1391015","1391015",5191,2643,2548,51,620,1799,2396,3771,2148,1623,30,372,1154,1518
"n4392317","4392317",1687,1043,644,161,148,316,452,1354,898,456,121,104,211,311
"n3550067","3550067",7594,2674,4920,631,541,3731,4182,5787,2254,3533,452,378,2651,2989
"n410037","410037",179,130,49,2,17,24,41,134,103,31,1,13,13,26
"n1133312","1133312",4946,1398,3548,386,1608,1530,3094,3671,1198,2473,315,1081,1028,2095
"n2010071","2010071",5026,2618,2408,850,309,1204,1489,4319,2337,1982,695,241,987,1220
"n1133068","1133068",6302,147,6155,49,4675,1473,6062,4467,132,4335,37,3384,916,4272
"n610028","610028",4531,366,4165,21,60,4090,4108,3116,295,2821,16,43,2752,2769
"n1450301","1450301",1168,775,393,8,177,191,355,905,641,264,2,130,108,235
"n2090337","2090337",4166,3330,836,76,47,547,578,3275,2698,577,39,23,363,384
"n4710201A","4710201A",8343,3212,5131,223,2879,1999,4819,7426,3023,4403,199,2340,1829,4122
"n292151","292151",309,22,287,3,5,278,280,204,22,182,1,4,175,177
"n1133042","1133042",2699,27,2672,11,1408,1252,2646,1864,13,1851,7,1081,756,1834
"n2011155","2011155",9,5,4,0,0,4,4,9,5,4,0,0,4,4
"n4790309","4790309",4766,174,4592,24,32,4549,4564,3630,145,3485,13,22,3458,3471
"n3670220","3670220",1100,966,134,3,11,83,93,889,794,95,2,6,58,63
"n3610033","3610033",2210,1963,247,17,18,144,157,1616,1477,139,8,8,78,83
"n1132407","1132407",8241,2059,6182,848,614,4648,5220,6235,1856,4379,690,464,3156,3598
"n1572087","1572087",2733,1700,1033,334,288,378,656,1902,1183,719,240,220,234,447
"n4790123","4790123",2254,29,2225,4,13,2216,2216,1514,26,1488,4,9,1482,1482
"n2070001","2070001",578,425,153,10,19,110,125,453,351,102,4,12,71,82
"n850063","850063",2488,1800,688,235,108,267,365,1995,1533,462,170,67,161,223
"n1530004","1530004",1377,354,1023,18,63,948,998,987,294,693,8,32,647,679
"n4850109","4850109",1901,834,1067,40,558,390,941,1817,794,1023,39,526,381,900
"n3550004","3550004",4327,663,3664,130,359,3204,3487,3263,553,2710,88,257,2349,2568
"n11329A1","11329A1",435,117,318,17,96,210,296,358,104,254,16,67,171,232
"n2510002","2510002",5422,3939,1483,114,171,985,1128,3898,2952,946,64,99,612,700
"n3550109","3550109",705,216,489,25,24,433,451,555,196,359,22,16,310,324
"n2011092","2011092",2758,232,2526,442,145,1960,2080,1955,187,1768,344,99,1339,1419
"n4570009","4570009",570,488,82,3,18,35,51,446,396,50,1,14,13,27
"n1410188","1410188",207,38,169,14,26,141,157,159,35,124,9,16,101,113
"n2010134","2010134",3768,508,3260,73,349,2846,3157,2757,454,2303,57,275,1970,2220
"n2011029","2011029",5401,2049,3352,1652,607,1056,1626,3933,1549,2384,1171,423,758,1154
"n1410125","1410125",6502,373,6129,139,241,5821,5991,4992,312,4680,88,162,4435,4567
"n1132124","1132124",8072,767,7305,519,4967,1866,6728,5966,680,5286,333,3666,1284,4895
"n1410062","1410062",4190,374,3816,74,317,3474,3691,3086,334,2752,59,231,2471,2643
"n410080","410080",5856,4033,1823,464,342,859,1180,4130,2899,1231,334,224,557,771
"n710015","710015",4343,1719,2624,122,724,1704,2400,3030,1287,1743,92,523,1071,1583
"n292088","292088",5949,1431,4518,211,409,3941,4281,4575,1183,3392,171,310,2907,3180
"n21303CS","21303CS",2508,2104,404,35,138,166,296,1939,1651,288,30,97,102,195
"n3490106","3490106",1116,458,658,17,47,569,609,797,366,431,13,30,364,390
"n490410","490410",3607,2682,925,30,133,639,758,2839,2200,639,20,96,426,521
"n4650032","4650032",285,155,130,6,6,107,111,246,140,106,6,0,87,87
"n1214217","1214217",2218,1508,710,202,141,299,434,1664,1170,494,130,110,197,301
"n2570002","2570002",2849,1635,1214,21,102,1023,1118,2066,1328,738,12,72,601,671
"n83002E","83002E",507,410,97,0,8,79,84,399,332,67,0,2,52,54
"n292177","292177",1,1,0,0,0,0,0,1,1,0,0,0,0,0
"n4393209","4393209",5028,3989,1039,215,200,466,655,3877,3161,716,141,143,306,445
"n11330C4","11330C4",0,0,0,0,0,0,0,0,0,0,0,0,0,0
"n1410205","1410205",8628,288,8340,32,106,8201,8264,5655,217,5438,19,73,5338,5394
"n2090114","2090114",3022,1012,2010,70,234,1677,1883,2542,938,1604,62,186,1320,1490
"n4790275B","4790275B",102,4,98,0,0,96,96,56,2,54,0,0,53,53
"n2772C3A","2772C3A",7669,3547,4122,66,2615,1132,3705,5624,2847,2777,45,1819,664,2468
"n3670205","3670205",3263,2270,993,29,83,764,839,2416,1784,632,17,42,471,509
"n2010237","2010237",3210,37,3173,10,1976,1236,3152,2348,31,2317,7,1565,768,2302
"n4810102","4810102",5073,2520,2553,39,792,1678,2426,4038,2171,1867,26,591,1192,1762
"n850017","850017",6552,3707,2845,204,942,1520,2422,4425,2656,1769,132,622,886,1499
"n1450201","1450201",1024,796,228,4,78,135,207,816,653,163,1,68,80,146
"n3710004","3710004",1123,401,722,15,13,687,690,795,321,474,10,5,449,450
"n770010","770010",354,316,38,2,3,31,31,306,275,31,0,0,24,24
"n2090333","2090333",2903,2420,483,42,46,303,343,2461,2113,348,24,25,209,229
"n4850309","4850309",2825,2359,466,47,65,232,287,2180,1876,304,21,44,137,174
"n2910023","2910023",6921,428,6493,19,84,6391,6442,4075,303,3772,17,50,3707,3735
"n3750325","3750325",4499,2848,1651,149,310,1102,1368,3604,2458,1146,108,193,740,920
"n850060","850060",3723,2246,1477,632,243,515,749,2755,1761,994,431,171,316,481
"n2010323","2010323",5596,1154,4442,100,670,3686,4306,4108,999,3109,86,513,2511,3002
"n2110302","2110302",40,36,4,0,0,4,4,30,29,1,0,0,1,1
"n293106","293106",2121,1201,920,106,51,696,742,1695,1015,680,70,36,516,550
"n1133621","1133621",1089,102,987,3,819,174,980,843,98,745,2,633,117,741
"n1530001","1530001",1345,761,584,1,37,535,570,988,662,326,0,23,296,317
"n3630017","3630017",1729,817,912,10,110,764,862,1268,663,605,7,69,494,561
"n2030007","2030007",1192,857,335,8,218,75,289,969,703,266,7,182,50,230
"n4770413","4770413",2054,1660,394,7,69,261,327,1686,1410,276,6,44,172,216
"n4393567","4393567",4531,2826,1705,279,584,724,1265,2943,1926,1017,179,325,417,730
"n2150053","2150053",5475,167,5308,47,22,5242,5252,3917,121,3796,35,9,3753,3759
"n990412","990412",6032,3176,2856,344,1175,1168,2252,4344,2441,1903,225,786,735,1470
"n1134053","1134053",973,111,862,105,228,534,751,695,97,598,76,164,359,512
"n850146","850146",7616,3707,3909,1719,1023,1042,2028,5469,2820,2649,1172,674,678,1343
"n1134098","1134098",51,36,15,5,2,4,6,37,26,11,4,0,4,4
"n2010618","2010618",8845,1989,6856,670,1874,4275,6030,6528,1632,4896,523,1294,3034,4262
"n2150219","2150219",3942,88,3854,21,28,3811,3816,2539,58,2481,18,16,2446,2451
"n850189","850189",1372,863,509,29,28,374,401,1042,719,323,22,19,222,240
"n2010366","2010366",10509,461,10048,1144,2013,6965,8877,7254,369,6885,910,1408,4582,5948
"n49903-1","49903-1",1689,1404,285,11,42,174,214,1360,1168,192,8,32,104,136
"n3030027","3030027",7226,2719,4507,294,1086,3123,4107,5526,2353,3173,246,728,2154,2845
"n293147","293147",119,74,45,7,6,30,36,116,74,42,7,6,27,33
"n33001A","33001A",79,71,8,1,1,6,7,53,51,2,0,0,2,2
"n4070010","4070010",1250,682,568,8,19,524,539,955,564,391,6,14,354,364
"n4393822","4393822",0,0,0,0,0,0,0,0,0,0,0,0,0,0
"n2870103","2870103",350,287,63,2,17,41,53,288,257,31,0,6,18,24
"n3810309","3810309",6780,4870,1910,40,193,1412,1598,5107,3825,1282,16,115,950,1063
"n3090074","3090074",1130,839,291,11,54,213,258,864,660,204,9,38,143,179
"n1133306","1133306",4580,1099,3481,85,1075,2312,3335,3161,953,2208,78,627,1471,2073
"n1572018","1572018",3884,2114,1770,74,111,1525,1623,2852,1666,1186,52,67,1010,1072
"n610045","610045",4245,63,4182,1,7,4174,4174,2879,29,2850,1,6,2844,2844
"n4394182","4394182",4618,3299,1319,504,273,424,681,3537,2637,900,314,179,316,485
"n4910175","4910175",5471,2535,2936,1172,441,1241,1648,4243,2192,2051,784,315,859,1160
"n4394666","4394666",0,0,0,0,0,0,0,0,0,0,0,0,0,0
"n4910413","4910413",4294,3061,1233,59,114,955,1057,3330,2505,825,30,75,629,700
"n4490015","4490015",1728,856,872,16,88,738,816,1257,692,565,12,68,461,525
"n294028","294028",3682,462,3220,48,139,3065,3156,2926,412,2514,42,104,2386,2461
"n292108","292108",1549,729,820,49,62,711,757,1251,642,609,34,38,525,558
"n4910251","4910251",135,117,18,0,1,12,13,110,98,12,0,1,9,10
"n2010512","2010512",10464,1959,8505,1095,2122,5292,7294,8009,1660,6349,876,1569,3867,5370
"n1572153","1572153",3437,107,3330,62,2852,465,3266,2425,85,2340,52,2014,304,2289
"n2150113","2150113",7840,507,7333,130,55,7151,7174,5617,434,5183,101,44,5034,5056
"n1190005","1190005",1338,1004,334,15,110,144,246,1035,803,232,9,71,97,165
"n4910473","4910473",2328,890,1438,39,62,1303,1350,1713,748,965,28,45,855,892
"n1670193","1670193",4436,2874,1562,313,377,772,1134,3247,2193,1054,210,265,501,762
"n4410103","4410103",4665,2626,2039,86,541,1328,1805,3474,2133,1341,54,328,841,1151
"n294131","294131",869,188,681,38,194,465,640,638,157,481,28,140,316,449
"n3930003","3930003",225,191,34,4,5,17,21,166,140,26,1,2,15,17
"n2010409","2010409",5840,430,5410,37,245,5137,5350,4030,366,3664,32,180,3458,3610
"n1134522","1134522",5935,1245,4690,727,1767,2172,3889,4333,1080,3253,517,1246,1448,2674
"n1574001","1574001",4352,1637,2715,155,827,1738,2510,3599,1507,2092,109,665,1292,1933
"n2970009","2970009",1691,706,985,9,26,909,924,1288,577,711,5,10,655,664
"n10006","10006",2173,750,1423,13,828,569,1379,1588,656,932,7,580,333,901
"n2010472","2010472",1804,988,816,498,81,190,267,1398,791,607,371,62,145,203
"n3030127","3030127",3927,2602,1325,137,202,914,1088,3200,2219,981,112,138,671,797
"n2150010","2150010",4712,236,4476,13,24,4446,4455,3467,197,3270,7,20,3248,3256
"n2010280","2010280",4460,325,4135,90,947,3142,4022,3173,290,2883,71,637,2198,2796
"n4090122","4090122",92,26,66,1,2,58,58,66,13,53,1,1,48,48
"n3850004","3850004",121,89,32,2,4,24,26,99,80,19,2,4,11,13
"n3790305","3790305",1226,952,274,14,59,142,196,1011,811,200,14,40,96,133
"n21301CR","21301CR",2894,2397,497,13,44,339,381,2231,1889,342,9,26,215,240
"n4710102","4710102",11372,5599,5773,428,2795,2416,5160,10116,5074,5042,373,2434,2100,4498
"n2010343","2010343",5277,320,4957,103,320,4554,4837,4044,294,3750,76,251,3422,3648
"n2150073","2150073",4570,755,3815,400,95,3329,3388,3361,623,2738,274,65,2384,2429
"n970011","970011",4188,2746,1442,32,77,1144,1214,3079,2196,883,22,41,681,722
"n2150030","2150030",10018,478,9540,142,192,9248,9376,6966,385,6581,108,148,6340,6452
"n50022","50022",1665,1412,253,9,52,161,209,1252,1092,160,7,37,94,127
"n850123","850123",3273,1716,1557,682,432,382,797,2477,1407,1070,467,314,247,551
"n1572077","1572077",3073,197,2876,327,2011,550,2522,2325,163,2162,279,1517,354,1860
"n2890008","2890008",1665,1069,596,36,67,451,513,1227,835,392,22,52,289,338
"n1133082","1133082",7704,260,7444,27,3899,3555,7401,5067,213,4854,16,2611,2241,4829
"n1573064","1573064",4352,1846,2506,1306,392,774,1149,3352,1544,1808,985,254,539,789
"n850166","850166",6546,2752,3794,2247,907,566,1451,4393,1912,2481,1519,568,337,898
"n1133960","1133960",5113,2452,2661,510,1143,946,2043,3708,1881,1827,374,788,596,1365
"n4394201","4394201",2645,68,2577,19,46,2525,2558,1882,55,1827,9,35,1790,1815
"n293126","293126",2863,1339,1524,188,77,1246,1312,2035,1021,1014,116,42,831,868
"n2050202","2050202",1490,833,657,4,186,464,648,1316,695,621,4,182,434,614
"n2150156","2150156",3462,89,3373,2,17,3351,3358,2458,73,2385,1,4,2379,2382
"n1410185","1410185",905,246,659,27,81,577,625,725,221,504,19,45,434,472
"n4850106","4850106",34,29,5,0,3,0,3,26,25,1,0,1,0,1
"n1590102","1590102",720,583,137,4,23,80,99,556,463,93,2,9,57,66
"n3730015","3730015",3283,2721,562,28,98,335,429,2533,2174,359,17,54,208,261
"n397004D","397004D",2461,1690,771,100,200,429,614,1565,1123,442,69,114,224,332
"n830002","830002",1465,1126,339,8,59,236,292,1140,893,247,2,34,179,212
"n1134519","1134519",4487,1239,3248,700,1230,1284,2480,3401,1051,2350,532,897,874,1755
"n4050001","4050001",1844,981,863,10,636,234,845,1454,832,622,5,479,147,613
"n3650014","3650014",680,549,131,6,33,50,83,494,410,84,4,23,32,55
"n4910278","4910278",6222,3904,2318,439,365,1384,1690,4835,3186,1649,334,245,944,1171
"n4393507","4393507",4311,2596,1715,153,398,1028,1390,3181,2049,1132,112,232,688,906
"n3030135","3030135",662,447,215,16,21,161,177,507,366,141,10,11,107,118
"n3610030","3610030",1540,1173,367,87,39,192,225,1207,948,259,72,19,127,143
"n1133503","1133503",1855,929,926,287,380,230,605,1372,732,640,205,246,161,405
"n910304","910304",5889,2887,3002,183,280,2459,2684,4417,2335,2082,125,196,1677,1846
"n4393324","4393324",4070,2519,1551,145,468,872,1289,3160,2096,1064,113,291,569,841
"n4890004","4890004",2446,182,2264,12,19,2231,2237,1866,147,1719,11,11,1687,1693
"n2010469","2010469",4407,3062,1345,206,293,781,1040,3425,2506,919,142,179,517,686
"n2150199","2150199",4323,379,3944,289,88,3586,3637,3080,290,2790,236,54,2501,2544
"n850209","850209",2280,1006,1274,751,236,261,477,1442,663,779,459,150,148,289
"n1134029","1134029",104,7,97,7,20,71,85,61,6,55,1,6,44,48
"n293167","293167",50,16,34,1,8,28,34,50,16,34,1,8,28,34
"n2090220","2090220",4658,2924,1734,150,200,1287,1442,3268,2146,1122,105,119,817,914
"n294008","294008",1236,546,690,41,151,494,621,1170,528,642,40,145,455,579
"n770013","770013",174,149,25,2,2,2,4,144,128,16,2,0,1,1
"n4394060","4394060",3210,1766,1444,221,147,1022,1155,2637,1516,1121,182,114,762,868
"n710012","710012",2400,1235,1165,15,362,731,1087,1709,973,736,6,273,414,683
"n1410165","1410165",7796,154,7642,25,62,7429,7449,5480,108,5372,18,22,5235,5247
"n3030045","3030045",730,362,368,3,21,346,361,522,288,234,1,12,222,231
"n2930403","2930403",541,373,168,6,69,77,145,433,324,109,6,42,49,91
"n4393560","4393560",0,0,0,0,0,0,0,0,0,0,0,0,0,0
"n2910020","2910020",6063,2563,3500,78,1364,1961,3284,4674,2122,2552,62,1066,1341,2382
"n3550106","3550106",3782,1013,2769,61,299,2390,2644,2912,883,2029,48,197,1731,1919
"n2010363","2010363",8801,2169,6632,135,3042,3453,6379,6818,1920,4898,105,2296,2457,4690
"n294088","294088",6702,1408,5294,317,2046,3092,4945,4980,1180,3800,263,1495,2099,3505
"n1430019","1430019",2342,1781,561,17,41,447,486,1838,1435,403,10,29,315,343
"n4394124","4394124",1389,924,465,58,42,330,367,1179,834,345,44,26,234,258
"n1670392","1670392",2282,732,1550,35,199,1277,1453,1616,597,1019,26,132,825,944
"n2010452","2010452",5483,2482,3001,407,724,1738,2414,4163,2021,2142,324,476,1208,1669
"n2810006","2810006",607,484,123,8,8,89,93,507,431,76,7,4,47,49
"n1134050","1134050",7133,1005,6128,344,3628,2160,5706,5096,808,4288,273,2537,1444,3933
"n850040","850040",4481,3016,1465,268,341,701,1019,3540,2521,1019,200,216,456,668
"n292182C","292182C",797,189,608,58,129,431,544,500,127,373,34,72,265,332
"n4910380","4910380",134,112,22,2,4,12,14,107,93,14,1,2,6,7
"n4150010","4150010",1699,1016,683,11,99,544,630,1348,832,516,7,82,392,470
"n475003S","475003S",482,200,282,5,19,258,273,353,164,189,3,13,175,186
"n2010300","2010300",4221,2854,1367,610,129,553,667,2894,1980,914,408,85,361,444
"n4394395","4394395",1240,997,243,18,27,147,170,977,806,171,14,19,104,119
"n1650008","1650008",3049,1169,1880,11,136,1745,1859,2056,790,1266,6,89,1171,1258
"n2150093","2150093",386,103,283,4,4,277,278,298,100,198,2,1,193,194
"n4930414","4930414",4325,2655,1670,30,59,1476,1520,3281,2132,1149,17,50,1001,1041
"n2011132","2011132",0,0,0,0,0,0,0,0,0,0,0,0,0,0
"n1134118","1134118",0,0,0,0,0,0,0,0,0,0,0,0,0,0
"n293063","293063",2662,1067,1595,77,146,1396,1495,2131,975,1156,52,80,1030,1090
"n850103","850103",2933,836,2097,152,425,1478,1885,2098,696,1402,108,251,985,1230
"n3090035","3090035",2539,553,1986,27,656,1308,1937,1744,472,1272,17,450,789,1232
"n294111","294111",1227,82,1145,11,777,399,1121,682,62,620,11,415,208,604
"n1134557","1134557",0,0,0,0,0,0,0,0,0,0,0,0,0,0
"n2010535","2010535",927,105,822,2,13,806,812,676,87,589,2,10,580,586
"n4910419","4910419",1240,528,712,72,151,479,610,902,411,491,52,103,327,422
"n2150136","2150136",2567,306,2261,28,34,2192,2216,2002,263,1739,28,15,1691,1702
"n4010314A","4010314A",1307,1025,282,9,109,135,242,1013,805,208,4,92,86,177
"n910106","910106",4431,3269,1162,78,97,870,939,3500,2696,804,51,62,599,649
"n3070101","3070101",1744,1292,452,14,37,388,417,1379,1110,269,9,19,229,246
"n4394495","4394495",239,84,155,1,80,72,152,228,84,144,1,80,62,142
"n294154","294154",1185,256,929,89,118,732,825,915,225,690,67,75,539,608
"n850229","850229",2415,1188,1227,371,389,410,789,1746,883,863,232,289,282,564
"n1574082","1574082",11790,5284,6506,2019,2324,2089,4347,8444,3946,4498,1421,1619,1360,2946
"n1610010","1610010",518,404,114,2,38,62,97,401,314,87,1,31,46,75
"n3030092","3030092",755,418,337,21,50,253,290,566,354,212,13,32,150,175
"n294025","294025",2624,381,2243,18,103,2116,2194,1909,319,1590,11,63,1496,1548
"n1134095","1134095",99,24,75,2,7,67,73,77,22,55,1,5,49,53
"n2010449","2010449",11,0,11,1,8,3,10,7,0,7,0,7,0,7
"n4910231","4910231",3166,1971,1195,158,225,756,952,2251,1473,778,104,130,490,608
"n2150050","2150050",4774,79,4695,8,19,4671,4679,3317,73,3244,8,14,3224,3232
"n3890003","3890003",4550,439,4111,68,134,3951,4033,4122,378,3744,64,125,3598,3674
"n850143","850143",2902,1805,1097,436,253,340,591,2487,1576,911,379,220,253,471
"n1572136","1572136",481,109,372,15,239,119,354,372,95,277,9,181,80,260
"n4690017","4690017",1003,313,690,14,115,560,652,685,254,431,9,57,353,405
"n2970006","2970006",269,203,66,1,0,56,56,219,165,54,1,0,45,45
"n1134003","1134003",4659,272,4387,79,149,4146,4280,3057,215,2842,65,101,2660,2753
"n2011089","2011089",44,0,44,4,8,40,40,25,0,25,4,8,21,21
"n4910123","4910123",8219,2876,5343,217,966,4111,4959,5973,2373,3600,161,638,2715,3307
"n4392405","4392405",7295,1733,5562,1203,2726,1626,4243,5211,1322,3889,892,1879,1057,2876
"n2150007","2150007",6407,672,5735,117,46,5588,5607,4929,611,4318,109,31,4186,4202
"n1510010A","1510010A",951,550,401,12,76,323,380,729,444,285,8,45,225,264
"n4394121","4394121",4742,2067,2675,63,115,2434,2520,3595,1788,1807,52,68,1624,1680
"n293187","293187",0,0,0,0,0,0,0,0,0,0,0,0,0,0
"n2010406","2010406",958,15,943,6,634,320,934,719,10,709,1,494,218,703
"n4392561","4392561",0,0,0,0,0,0,0,0,0,0,0,0,0,0
"n3750322","3750322",279,203,76,2,16,41,56,215,162,53,0,9,29,37
"n2010154","2010154",4912,203,4709,43,62,4613,4649,3658,174,3484,22,37,3416,3446
"n4394259","4394259",1416,1165,251,33,30,131,155,1181,1003,178,24,22,77,94
"n2730023","2730023",734,132,602,6,32,562,588,555,124,431,4,21,401,419
"n1133062","1133062",5935,90,5845,42,4692,1154,5773,3818,69,3749,29,3041,687,3696
"n1573121","1573121",1491,590,901,439,175,266,441,1289,527,762,379,148,215,363
"n3610010","3610010",1360,886,474,25,138,291,427,1041,726,315,15,66,213,279
"n1134300","1134300",3815,194,3621,29,84,3513,3575,2727,178,2549,18,56,2469,2512
"n1410122","1410122",5404,303,5101,69,116,4946,5024,4185,251,3934,52,80,3806,3868
"n397001BB","397001BB",0,0,0,0,0,0,0,0,0,0,0,0,0,0
"n850100","850100",94,16,78,12,17,51,62,69,13,56,8,8,39,42
"n850083","850083",6169,4009,2160,313,662,1029,1651,4474,3071,1403,211,389,680,1051
"n2030010","2030010",1442,934,508,22,298,152,449,1140,783,357,21,222,81,302
"n1133963","1133963",3722,1829,1893,339,816,701,1485,2741,1425,1316,237,546,483,1013
"n2010346","2010346",0,0,0,0,0,0,0,0,0,0,0,0,0,0
"n1470017","1470017",1128,953,175,14,23,79,102,904,789,115,7,9,50,59
"n2010320","2010320",4436,478,3958,40,135,3793,3903,3200,438,2762,36,102,2629,2718
"n2090432","2090432",2305,1564,741,48,105,533,626,1758,1237,521,31,71,368,435
"n4393750","4393750",0,0,0,0,0,0,0,0,0,0,0,0,0,0
"n293144","293144",559,243,316,51,97,176,265,447,208,239,36,79,126,200
"n3670350","3670350",3571,2872,699,31,37,461,493,2803,2313,490,18,22,324,344
"n3810305","3810305",4778,3413,1365,51,148,984,1114,3668,2708,960,29,101,693,785
"n850057","850057",7729,4090,3639,526,1343,1621,2905,5760,3329,2431,366,882,1056,1912
"n4393327","4393327",2059,1427,632,86,116,359,453,1698,1233,465,73,82,259,328
"n3030024","3030024",3996,1602,2394,81,507,1774,2221,3041,1397,1644,54,313,1230,1511
"n4790221","4790221",1633,96,1537,5,8,1520,1525,1229,76,1153,4,6,1142,1147
"n4850306","4850306",562,402,160,9,28,96,124,487,376,111,3,26,61,87
"n1133019","1133019",1487,64,1423,12,1236,185,1401,1157,57,1100,11,944,144,1078
"n2890011","2890011",1849,1038,811,31,180,554,728,1358,815,543,20,134,347,480
"n293043","293043",4096,2376,1720,188,263,1198,1431,3055,1857,1198,110,174,818,979
"n293083","293083",2573,1235,1338,74,139,1099,1211,2071,1091,980,55,96,784,870
"n2011152","2011152",455,330,125,7,24,75,97,342,263,79,7,17,42,59
"n292171","292171",2490,786,1704,116,193,1395,1565,1995,697,1298,90,135,1059,1183
"n850186","850186",183,147,36,4,7,18,25,139,122,17,1,1,12,13
"n4790401","4790401",3136,185,2951,8,40,2883,2920,2457,156,2301,5,36,2245,2278
"n294068","294068",1246,265,981,53,363,596,917,957,217,740,42,284,431,689
"n650103","650103",661,490,171,4,19,107,125,505,376,129,4,16,81,96
"n293170","293170",1,0,1,0,1,0,1,1,0,1,0,1,0,1
"n4910323","4910323",112,77,35,7,8,22,28,85,67,18,7,4,7,11
"n2650416","2650416",2639,1731,908,18,29,775,800,2223,1549,674,11,11,564,573
"n3030002","3030002",3315,971,2344,41,247,2051,2249,2454,812,1642,34,150,1426,1560
"n1134026","1134026",402,22,380,8,65,313,374,293,20,273,6,48,222,269
"n2010386","2010386",2455,1452,1003,19,232,734,947,1944,1228,716,13,178,496,669
"n4910182","4910182",1640,889,751,426,73,195,266,1017,580,437,238,50,116,165
"n1571103","1571103",9001,4386,4615,511,1684,2278,3912,6550,3371,3179,394,1140,1531,2641
"n4394068","4394068",3900,199,3701,37,126,3567,3667,2807,171,2636,24,84,2548,2616
"n4393663","4393663",18,2,16,4,2,4,5,10,2,8,0,0,1,1
"n2930305","2930305",555,382,173,4,76,83,154,465,333,132,1,63,55,116
"n850080","850080",5124,2824,2300,730,659,758,1389,3849,2233,1616,529,447,507,946
"n3950001","3950001",1548,762,786,16,546,189,728,1182,613,569,16,397,125,520
"n4910284","4910284",6100,3934,2166,348,340,1337,1641,4674,3163,1511,237,229,920,1128
"n4393486","4393486",6496,4125,2371,566,648,1018,1618,4323,2846,1477,345,377,621,983
"n1470013","1470013",696,557,139,13,10,76,83,580,483,97,10,5,48,53
"n277001H","277001H",764,663,101,0,15,55,69,599,532,67,0,10,31,41
"n810002","810002",799,648,151,5,2,110,110,656,537,119,1,0,85,85
"n1131172","1131172",3560,1611,1949,711,389,811,1162,2628,1359,1269,399,282,537,800
"n1133983","1133983",3255,1877,1378,419,400,456,845,2360,1432,928,303,244,308,548
"n1131704","1131704",2986,578,2408,817,469,1091,1547,2238,513,1725,577,348,767,1113
"n1574154","1574154",6061,1490,4571,477,1539,2521,3982,4356,1204,3152,340,1029,1696,2701
"n3390088","3390088",7273,3841,3432,881,983,1410,2354,4839,2635,2204,554,647,886,1514
"n4392258","4392258",1328,700,628,16,119,478,594,999,580,419,11,80,316,396
"n4410202","4410202",7302,2210,5092,61,723,4315,4907,5286,1813,3473,35,471,2913,3342
"n4490003","4490003",1096,657,439,6,102,303,401,857,566,291,4,66,196,262
"n4690032","4690032",2891,528,2363,64,356,1987,2279,2138,446,1692,56,247,1395,1617
"n2010066","2010066",2823,102,2721,12,176,2524,2692,2117,94,2023,5,153,1850,2003
"n2010607","2010607",3163,62,3101,28,2148,985,3049,1931,57,1874,26,1245,629,1838
"n2010109","2010109",4694,88,4606,54,3489,1104,4531,3186,60,3126,34,2415,686,3076
"n2310109","2310109",2162,1566,596,24,38,462,496,1626,1230,396,16,21,296,315
"n2910010","2910010",10418,5845,4573,107,1681,2559,4226,8762,5029,3733,88,1421,2044,3456
"n2970001","2970001",721,456,265,10,6,226,228,624,421,203,9,2,167,169
"n211002","211002",807,567,240,22,37,152,185,647,481,166,22,20,104,122
"n291145","291145",992,397,595,48,106,455,545,727,330,397,30,74,302,364
"n410038","410038",750,49,701,4,340,358,686,533,37,496,2,256,237,486
"n610066","610066",5685,657,5028,39,31,4953,4957,3956,528,3428,31,16,3372,3374
"n1132125","1132125",6693,844,5849,291,4224,1379,5495,5297,771,4526,248,3291,1014,4241
"n1133119","1133119",0,0,0,0,0,0,0,0,0,0,0,0,0,0
"n3090007","3090007",3456,841,2615,49,839,1709,2512,2539,715,1824,34,603,1171,1752
"n3370011","3370011",1704,1258,446,22,25,323,341,1308,1028,280,21,8,194,198
"n4210401","4210401",700,420,280,4,11,260,267,482,306,176,4,5,163,167
"n4391415","4391415",5020,545,4475,116,1609,2735,4283,3461,482,2979,85,1127,1713,2823
"n4530226","4530226",3790,2488,1302,223,241,781,997,3331,2250,1081,188,193,640,818
"n4590010","4590010",3563,3021,542,17,117,253,361,2708,2368,340,16,78,132,204
"n1410080","1410080",2731,51,2680,8,30,2657,2667,2030,29,2001,5,18,1988,1992
"n1572003","1572003",7839,312,7527,114,1738,5797,7423,5322,251,5071,79,1234,3806,4989
"n2010507","2010507",17067,318,16749,4093,1883,10802,12512,12391,239,12152,3024,1388,7777,9033
"n2010258","2010258",4877,3553,1324,708,66,477,530,3390,2555,835,457,45,287,324
"n2150005","2150005",3705,54,3651,4,6,3647,3648,2542,33,2509,4,4,2505,2506
"n2150254","2150254",8818,193,8625,15,34,8593,8597,5689,108,5581,7,22,5562,5566
"n270413","270413",8862,1827,7035,681,4056,2477,6110,5646,1354,4292,433,2456,1360,3653
"n293182","293182",951,403,548,38,30,472,490,796,374,422,26,17,368,377
"n490306","490306",2769,2211,558,57,57,364,413,2144,1756,388,45,27,240,265
"n850241","850241",2757,1449,1308,822,227,227,450,1956,1059,897,543,170,163,330
"n1132610","1132610",0,0,0,0,0,0,0,0,0,0,0,0,0,0
"n1211028","1211028",543,201,342,30,37,265,300,394,156,238,20,29,180,208
"n3150006","3150006",1257,798,459,11,385,36,413,1012,656,356,6,305,22,326
"n3610025","3610025",2904,2298,606,90,54,362,414,2164,1784,380,56,23,229,252
"n4310002C","4310002C",11,6,5,1,2,3,5,10,6,4,1,1,3,4
"n4393542","4393542",3533,2360,1173,302,182,608,773,2703,1911,792,208,116,400,505
"n4530360","4530360",4333,2978,1355,426,97,711,792,3266,2351,915,268,64,489,546
"n4910261","4910261",4857,2701,2156,279,478,1315,1747,3429,1985,1444,174,320,864,1166
"n1410180","1410180",4562,243,4319,19,111,4208,4298,3427,226,3201,16,90,3101,3187
"n1830007","1830007",5558,3781,1777,106,807,695,1488,3901,2789,1112,72,502,403,903
"n2010358","2010358",6420,191,6229,99,2813,3366,6103,4315,143,4172,87,1903,2206,4070
"n2010898","2010898",4393,794,3599,307,1086,2244,3240,3135,656,2479,238,734,1521,2204
"n2150105","2150105",6659,362,6297,178,86,6036,6097,4669,291,4378,120,56,4206,4243
"n2510039","2510039",4167,2840,1327,118,325,769,1076,2910,2050,860,86,191,483,671
"n150104","150104",1168,751,417,12,59,314,370,938,631,307,9,42,227,267
"n293177","293177",0,0,0,0,0,0,0,0,0,0,0,0,0,0
"n292039","292039",2193,269,1924,23,74,1826,1887,1755,233,1522,16,53,1448,1492
"n390002","390002",6044,3741,2303,66,815,1296,2072,4663,3024,1639,49,580,888,1464
"n610035","610035",2268,440,1828,8,28,1789,1801,1711,367,1344,8,26,1316,1328
"n1410055","1410055",3993,634,3359,192,452,2785,3146,3105,576,2529,159,334,2048,2345
"n4530401","4530401",4578,2500,2078,309,293,1431,1698,4212,2410,1802,284,244,1228,1450
"n4790343","4790343",3473,177,3296,17,15,3242,3251,2753,155,2598,15,12,2549,2558
"n49904-2","49904-2",3709,3080,629,56,52,397,435,2993,2568,425,42,33,254,278
"n2150140","2150140",89,15,74,11,0,60,60,64,13,51,9,0,39,39
"n3610026","3610026",3822,3193,629,123,69,349,413,2826,2403,423,104,39,220,257
"n4010417","4010417",2726,1488,1238,12,332,817,1147,2006,1179,827,8,235,519,754
"n4391298","4391298",4990,3691,1299,216,253,693,928,4434,3356,1078,202,205,537,733
"n4393185","4393185",0,0,0,0,0,0,0,0,0,0,0,0,0,0
"n4410110","4410110",129,119,10,0,0,3,3,106,98,8,0,0,2,2
"n1573042","1573042",1426,927,499,224,95,149,237,1263,853,410,183,75,122,193
"n1830005","1830005",6607,4261,2346,208,1074,884,1924,5233,3599,1634,149,761,550,1301
"n2010810","2010810",604,28,576,5,39,538,571,438,27,411,1,25,388,409
"n2010147","2010147",5910,390,5520,84,3147,2322,5403,4279,322,3957,61,2352,1536,3866
"n2010479","2010479",6236,3552,2684,421,896,1255,2101,4677,2874,1803,297,586,824,1393
"n2011142","2011142",603,419,184,33,28,97,122,429,295,134,26,17,67,81
"n130001","130001",1305,551,754,20,15,696,710,1041,466,575,14,15,526,540
"n293154","293154",2056,1279,777,60,74,638,688,1689,1109,580,41,54,476,519
"n292016","292016",2526,66,2460,9,29,2429,2448,1889,55,1834,9,22,1807,1822
"n1850007","1850007",2127,1468,659,25,194,357,535,1648,1184,464,21,129,239,356
"n2010833","2010833",22,3,19,5,4,11,13,18,3,15,5,4,7,9
"n2010502","2010502",6379,3154,3225,64,620,2410,3000,4497,2471,2026,44,372,1497,1858
"n4530376","4530376",4171,3481,690,196,82,289,365,3420,2929,491,128,65,200,260
"n3390031","3390031",6151,4275,1876,580,253,928,1148,4942,3619,1323,407,175,643,798
"n3610003","3610003",2257,471,1786,30,1509,228,1728,1725,403,1322,23,1124,154,1273
"n3990009","3990009",1163,691,472,6,16,447,458,872,537,335,5,11,312,322
"n4391236","4391236",1075,563,512,28,125,343,456,860,489,371,20,108,226,325
"n4393038","4393038",8104,3401,4703,395,768,3455,4164,6035,2881,3154,293,508,2262,2755
"n4394694","4394694",3817,1829,1988,287,745,954,1660,2564,1306,1258,190,436,618,1033
"n2010170","2010170",5904,1247,4657,36,474,4135,4560,4176,1050,3126,31,297,2767,3050
"n2011165","2011165",0,0,0,0,0,0,0,0,0,0,0,0,0,0
"n2150163","2150163",13599,265,13334,19,43,13286,13288,8244,191,8053,13,13,8021,8023
"n2450019","2450019",2946,147,2799,43,1845,917,2742,2124,131,1993,38,1376,580,1945
"n2790008","2790008",3257,1525,1732,10,149,1557,1680,2398,1258,1140,7,96,1016,1097
"n3030120","3030120",5712,3425,2287,63,128,1952,2056,4173,2640,1533,42,67,1281,1341
"n294018","294018",1233,657,576,28,30,511,538,1082,605,477,23,24,422,444
"n390048","390048",6159,2378,3781,115,778,2796,3511,4431,1897,2534,74,517,1838,2336
"n610081","610081",3495,438,3057,10,26,3028,3038,2572,400,2172,7,17,2149,2158
"n850196","850196",3162,1693,1469,522,475,422,877,2187,1227,960,357,310,263,567
"n1133052","1133052",4552,88,4464,17,3396,1066,4426,3287,84,3203,12,2522,679,3178
"n1131412","1131412",930,249,681,8,55,613,666,661,194,467,6,45,412,455
"n3390010","3390010",7269,822,6447,57,1433,4928,6304,4991,658,4333,37,1049,3221,4241
"n3490206","3490206",1077,729,348,9,52,232,280,799,573,226,7,39,136,174
"n3550119","3550119",5399,1878,3521,136,336,2962,3245,4338,1625,2713,117,265,2238,2478
"n397002D","397002D",4117,1906,2211,264,934,961,1850,2942,1472,1470,188,628,594,1202
"n4391142","4391142",2018,1072,946,51,225,602,821,1534,890,644,32,155,401,553
"n4392699","4392699",6264,1765,4499,1084,2494,955,3357,4337,1289,3048,701,1716,599,2280
"n2270032","2270032",308,149,159,2,12,144,155,226,130,96,1,5,88,93
"n2450042","2450042",3514,2626,888,98,93,629,709,2682,2101,581,67,55,412,458
"n2570018","2570018",3873,2901,972,36,206,641,830,2785,2182,603,21,142,368,504
"n2850208","2850208",913,811,102,1,29,56,80,737,665,72,0,20,39,55
"n3030060","3030060",1540,1164,376,26,37,288,322,1173,914,259,12,25,197,222
"n3150001","3150001",851,615,236,2,159,35,191,732,532,200,0,140,22,161
"n1134528","1134528",0,0,0,0,0,0,0,0,0,0,0,0,0,0
"n1219102","1219102",6,0,6,0,2,3,5,4,0,4,0,0,3,3
"n2010856","2010856",0,0,0,0,0,0,0,0,0,0,0,0,0,0
"n2010525","2010525",5414,1047,4367,310,2917,1115,3972,4210,787,3423,285,2348,767,3079
"n2030023","2030023",768,673,95,6,25,39,62,586,525,61,2,16,23,39
"n2150186","2150186",371,29,342,1,4,342,342,320,28,292,0,2,292,292
"n190407","190407",2922,2140,782,28,29,603,632,2484,1877,607,17,22,451,473
"n292062","292062",1714,317,1397,29,30,1331,1355,1374,289,1085,20,20,1031,1048
"n293200","293200",0,0,0,0,0,0,0,0,0,0,0,0,0,0
"n390025","390025",2839,1430,1409,33,47,1302,1336,2165,1190,975,17,26,900,917
"n610058","610058",4916,553,4363,21,35,4276,4293,3519,467,3052,16,16,2989,2997
"n850173","850173",709,586,123,36,36,37,68,523,450,73,22,21,17,37
"n3550096","3550096",1521,170,1351,5,42,1309,1343,1200,152,1048,1,32,1010,1040
"n3750123","3750123",5878,3711,2167,250,447,1212,1620,4650,3120,1530,151,303,863,1150
"n3950005","3950005",1924,1395,529,32,305,136,437,1492,1124,368,28,220,90,307
"n4230032","4230032",1851,829,1022,53,396,542,919,1305,658,647,42,257,315,566
"n4392143","4392143",2311,549,1762,62,128,1545,1650,1660,479,1181,45,97,1007,1096
"n2550010","2550010",412,320,92,2,5,76,80,333,273,60,0,4,49,53
"n2890001","2890001",2406,1916,490,21,229,179,407,1954,1551,403,14,192,137,328
"n3030034","3030034",1942,879,1063,6,275,777,1046,1650,772,878,5,260,609,863
"n3210006","3210006",1674,1256,418,18,214,130,340,1479,1139,340,10,178,94,272
"n3370003","3370003",1924,1664,260,16,18,161,178,1481,1328,153,9,7,86,92
"n3510008A","3510008A",573,476,97,1,71,17,87,438,375,63,1,48,10,58
"n1131312","1131312",2157,512,1645,15,268,1355,1610,1523,448,1075,11,179,870,1047
"n2011002","2011002",7374,201,7173,212,1351,5621,6828,4749,142,4607,177,893,3557,4364
"n2134NLP","2134NLP",2250,1873,377,7,99,189,283,1750,1481,269,5,72,122,191
"n2150209","2150209",7920,149,7771,24,19,7751,7754,4722,82,4640,12,10,4630,4631
"n2250008","2250008",461,398,63,3,22,23,45,390,347,43,3,15,12,27
"n2450065","2450065",2345,1723,622,96,253,231,474,1842,1425,417,69,177,143,314
"n294141","294141",1156,57,1099,5,365,769,1088,688,41,647,3,216,437,638
"n291032","291032",4117,124,3993,17,38,3950,3968,3157,107,3050,8,14,3029,3036
"n291038","291038",6295,612,5683,107,327,5293,5534,4499,537,3962,86,218,3649,3833
"n790202","790202",638,304,334,2,24,304,319,443,228,215,2,15,190,202
"n1134627","1134627",7548,3345,4203,1318,1462,1343,2731,6991,3167,3824,1188,1334,1198,2475
"n1131745","1131745",4503,1580,2923,589,703,1553,2221,3511,1329,2182,464,516,1117,1618
"n467002C","467002C",3816,3282,534,32,49,317,364,2975,2608,367,22,38,207,244
"n3030009","3030009",3432,2474,958,164,122,613,704,2799,2128,671,116,72,411,476
"n323002E","323002E",1494,175,1319,39,86,1190,1271,1200,163,1037,34,80,926,1002
"n3770002","3770002",877,43,834,17,1,811,812,619,41,578,11,1,561,562
"n4394102","4394102",3520,902,2618,215,105,2254,2338,2432,746,1686,151,56,1418,1471
"n4392226","4392226",5156,869,4287,690,1420,2185,3545,3654,727,2927,562,928,1412,2310
"n4530181","4530181",5335,1558,3777,973,1102,1721,2748,4442,1393,3049,788,895,1362,2205
"n1132095","1132095",5,0,5,2,2,1,3,3,0,3,1,2,1,3
"n1410216","1410216",60,5,55,1,2,55,55,41,4,37,1,1,37,37
"n1970002","1970002",882,637,245,7,61,160,215,671,505,166,5,42,106,144
"n2010979","2010979",0,0,0,0,0,0,0,0,0,0,0,0,0,0
"n2010316","2010316",2038,1224,814,495,69,201,261,1587,1001,586,357,44,153,191
"n2230008","2230008",364,313,51,2,9,38,47,275,237,38,2,8,26,34
"n294164","294164",3394,1573,1821,151,299,1330,1568,2657,1365,1292,111,214,896,1088
"n294158","294158",990,410,580,28,211,330,522,874,375,499,28,185,270,444
"n291055","291055",3105,666,2439,171,304,1956,2222,2289,526,1763,124,209,1392,1587
"n633003","633003",3081,1306,1775,51,850,812,1652,2252,1036,1216,40,619,512,1127
"n850010","850010",1061,736,325,22,11,243,254,781,583,198,13,8,142,150
"n1132117","1132117",3796,1177,2619,169,1833,586,2375,3123,1135,1988,166,1296,490,1755
"n4910303","4910303",4125,1721,2404,1784,103,469,560,2694,1218,1476,1116,54,275,326
"n2010293","2010293",2003,941,1062,165,223,645,844,1640,821,819,150,170,469,625
"n2190046","2190046",1029,600,429,0,21,374,394,764,472,292,0,17,245,261
"n3810216","3810216",2959,1947,1012,142,203,623,812,2275,1551,724,106,135,444,575
"n4392308","4392308",6298,2996,3302,194,1238,1757,2921,4644,2365,2279,129,868,1156,1994
"n4530214","4530214",2524,1584,940,210,127,502,616,2232,1417,815,180,107,429,532
"n4690013","4690013",2384,462,1922,9,119,1789,1886,1676,376,1300,6,90,1183,1269
"n1134604","1134604",6762,1370,5392,367,410,4559,4937,4997,1208,3789,306,283,3132,3410
"n1131722","1131722",6614,1376,5238,402,1965,2871,4734,4758,1181,3577,295,1329,1913,3209
"n1211043","1211043",3214,1296,1918,270,1045,569,1573,2427,1052,1375,223,708,396,1087
"n1410195","1410195",8988,1659,7329,324,1220,5943,6897,6092,1322,4770,201,751,3765,4429
"n1670152","1670152",2035,1563,472,110,90,235,320,1629,1279,350,91,63,165,228
"n2010956","2010956",6501,309,6192,298,2165,3749,5832,4337,217,4120,234,1425,2459,3848
"n850033","850033",6821,4025,2796,273,703,1608,2278,4839,3115,1724,184,425,950,1369
"n1132142","1132142",5080,572,4508,1811,1174,1516,2660,3499,489,3010,1077,895,1026,1897
"n1211066","1211066",418,217,201,21,61,101,155,291,169,122,14,38,52,84
"n1219300","1219300",0,0,0,0,0,0,0,0,0,0,0,0,0,0
"n1572034","1572034",7699,269,7430,210,5916,1411,7194,5267,208,5059,165,4007,919,4864
"n1630002","1630002",2986,156,2830,147,143,2520,2658,2612,136,2476,146,139,2174,2310
"n4610002","4610002",274,134,140,5,9,109,117,224,106,118,3,9,93,101
"n4910342","4910342",2732,1358,1374,444,302,621,888,1984,1069,915,295,211,386,576
"n3490306","3490306",513,300,213,7,26,133,159,381,241,140,1,17,81,98
"n4230015","4230015",4018,3583,435,33,71,213,279,3381,3077,304,24,44,133,176
"n4392393","4392393",1019,175,844,78,124,635,755,742,154,588,66,88,428,513
"n4393700","4393700",4655,2743,1912,129,808,915,1665,2934,1863,1071,61,411,524,913
"n4530462","4530462",10325,1403,8922,205,926,7861,8634,7662,1256,6406,161,668,5593,6168
"n4530244","4530244",4120,1826,2294,748,404,1109,1455,3769,1743,2026,693,343,944,1248
"n2010025","2010025",1992,140,1852,47,1479,343,1784,1620,133,1487,45,1199,249,1429
"n2010933","2010933",1260,310,950,265,526,165,673,1053,283,770,216,414,140,546
"n2010270","2010270",7966,2392,5574,182,1048,4332,5309,6009,2112,3897,162,744,2955,3664
"n2010687","2010687",3724,1661,2063,1093,276,651,910,2988,1369,1619,871,218,488,693
"n2150017","2150017",2804,702,2102,3,10,2089,2093,2263,692,1571,3,3,1563,1564
"n2570012","2570012",3430,2513,917,16,106,669,763,2562,1971,591,13,74,413,482
"n1134658","1134658",199,48,151,5,9,139,145,140,38,102,5,8,90,96
"n1133035","1133035",3232,64,3168,10,1768,1412,3134,2297,55,2242,7,1357,872,2221
"n1214210","1214210",7645,5593,2052,821,300,724,1001,5213,3933,1280,510,190,424,606
"n1212089","1212089",4218,2726,1492,630,375,415,759,3456,2318,1138,496,274,312,568
"n1430044","1430044",2918,2371,547,24,64,358,410,2210,1876,334,11,19,220,235
"n1572108","1572108",9605,1318,8287,2644,4532,1188,5624,7559,1117,6442,2183,3442,834,4210
"n4910397","4910397",2047,1881,166,30,20,79,97,2022,1871,151,25,18,67,85
"n505002A","505002A",594,44,550,0,2,550,550,436,27,409,0,2,409,409
"n4230038","4230038",4001,2609,1392,200,704,411,1082,3417,2336,1081,153,534,319,838
"n4393289","4393289",5269,2744,2525,329,351,1694,2014,3960,2248,1712,223,229,1137,1350
"n4394046","4394046",4120,3264,856,46,138,500,628,3119,2589,530,34,81,288,363
"n4530431","4530431",3634,2229,1405,129,113,1085,1165,3118,2017,1101,95,89,837,900
"n4530273","4530273",5008,3386,1622,815,101,570,656,3202,2236,966,501,57,311,363
"n4650012C","4650012C",18,0,18,0,0,18,18,11,0,11,0,0,11,11
"n1610001","1610001",4444,3005,1439,56,510,803,1290,3320,2385,935,41,356,460,809
"n2010787","2010787",1368,90,1278,7,55,1220,1265,982,87,895,7,26,861,886
"n2010247","2010247",3591,371,3220,370,2501,366,2841,2723,364,2359,359,1702,298,1989
"n2010665","2010665",4408,2556,1852,90,124,1509,1620,3260,2015,1245,57,81,994,1065
"n2010002","2010002",4770,2565,2205,472,399,1280,1635,4232,2391,1841,419,329,1045,1345
"n2010124","2010124",4485,2995,1490,239,402,734,1108,3373,2311,1062,183,283,491,762
"n610041","610041",8522,348,8174,37,99,8064,8121,6083,259,5824,34,68,5737,5785
"n850156","850156",5225,2970,2255,436,766,941,1671,3904,2359,1545,322,486,630,1103
"n850073","850073",3125,1451,1674,539,650,434,1066,2711,1287,1424,453,553,355,897
"n1134131","1134131",2873,1017,1856,229,852,737,1569,2531,999,1532,225,654,615,1256
"n1131052","1131052",5335,2968,2367,172,655,1447,2076,4315,2590,1725,128,480,1030,1492
"n1214188","1214188",10,0,10,2,0,7,7,2,0,2,2,0,0,0
"n3030152","3030152",2856,1672,1184,196,237,687,923,2615,1580,1035,178,194,606,800
"n3670255","3670255",3508,2593,915,62,186,520,697,2498,1934,564,47,91,312,399
"n4010317","4010317",921,491,430,17,356,37,388,731,379,352,13,290,30,317
"n4150014","4150014",1139,550,589,0,192,396,584,1086,518,568,0,190,377,564
"n4910432","4910432",550,260,290,44,103,147,241,432,220,212,36,69,114,178
"n5010305","5010305",987,234,753,13,19,718,731,705,189,516,6,11,490,501
"n1212106","1212106",6686,3067,3619,1286,942,1283,2183,5275,2576,2699,995,696,891,1572
"n1410049","1410049",3588,710,2878,142,486,2289,2689,2620,601,2019,104,356,1565,1879
"n2011065","2011065",3899,2282,1617,506,379,669,1023,2716,1658,1058,306,253,455,696
"n2450002","2450002",1659,261,1398,25,749,621,1353,1252,222,1030,17,594,414,994
"n2610004","2610004",62,24,38,2,3,35,36,52,21,31,1,2,31,31
"n277004E","277004E",1548,1343,205,6,48,71,116,1199,1050,149,6,34,47,81
"n270215","270215",7458,2073,5385,750,3090,1587,4424,5152,1519,3633,500,2099,988,2973
"n293160","293160",2208,1047,1161,114,89,932,1013,1751,872,879,91,75,689,757
"n37005A","37005A",409,210,199,0,150,46,188,308,173,135,0,111,19,126
"n1134063","1134063",5642,815,4827,36,212,4541,4735,4261,742,3519,25,169,3281,3443
"n1131133","1131133",450,295,155,22,32,99,127,353,247,106,19,20,61,80
"n1132810","1132810",75,38,37,8,8,23,28,56,30,26,6,4,15,19
"n4530382","4530382",5119,3121,1998,520,397,1015,1381,4336,2753,1583,405,300,789,1079
"n3090083","3090083",845,636,209,4,37,144,178,639,504,135,0,27,91,115
"n3390027","3390027",4572,2519,2053,218,553,1159,1683,3503,2128,1375,152,385,729,1098
"n3470045","3470045",1168,924,244,9,71,132,202,906,743,163,6,41,94,134
"n4394713","4394713",5489,2590,2899,195,973,1659,2574,3892,1999,1893,144,615,1059,1645
"n4393583","4393583",0,0,0,0,0,0,0,0,0,0,0,0,0,0
"n4391677","4391677",347,239,108,16,24,67,89,335,231,104,14,22,63,85
"n1132509","1132509",3720,2583,1137,415,255,410,646,2999,2150,849,325,175,280,448
"n1573084","1573084",2214,773,1441,1025,114,282,387,1696,649,1047,753,71,197,266
"n1850001","1850001",2343,1888,455,5,165,239,397,1830,1502,328,2,135,149,283
"n2010379","2010379",3190,82,3108,19,1395,1726,3081,2458,78,2380,16,1182,1206,2354
"n2150040","2150040",6100,52,6048,9,17,6019,6024,4083,28,4055,4,11,4041,4046
"n2270304","2270304",1047,638,409,19,26,339,359,748,484,264,12,13,216,228
"n90005","90005",211,199,12,1,3,4,7,156,147,9,0,2,3,5
"n294095","294095",2606,873,1733,44,227,1488,1648,2030,768,1262,36,153,1059,1182
"n291078","291078",924,23,901,5,18,883,893,657,18,639,4,9,627,632
"n291158","291158",2169,303,1866,120,276,1499,1728,1489,226,1263,76,191,1001,1163
"n292161","292161",248,133,115,2,4,110,110,195,107,88,2,4,83,83
"n293056","293056",3724,1004,2720,349,488,1859,2309,2915,862,2053,265,370,1386,1735
"n2010439","2010439",7594,3956,3638,2253,345,889,1212,5789,3089,2700,1643,291,660,936
"n2330042","2330042",5085,2433,2652,57,323,2103,2381,3779,1954,1825,39,215,1413,1621
"n4090109","4090109",5277,2303,2974,115,158,2632,2740,3818,1810,2008,73,87,1762,1834
"n4391444","4391444",211,35,176,14,85,84,162,137,24,113,0,58,58,113
"n4530453","4530453",3730,1630,2100,231,272,1576,1807,2922,1339,1583,187,204,1165,1353
"n4810303","4810303",2942,1920,1022,13,133,831,956,2265,1579,686,10,101,533,630
"n590003","590003",3301,2775,526,26,33,361,391,2523,2138,385,26,17,252,267
"n850027","850027",4480,2452,2028,394,748,774,1502,3071,1767,1304,267,439,511,946
"n850110","850110",3595,2032,1563,701,413,397,795,3098,1818,1280,599,321,302,613
"n990416","990416",7934,3623,4311,427,2004,1733,3491,5655,2795,2860,317,1291,1097,2275
"n1572056","1572056",1831,140,1691,18,353,1332,1663,1394,122,1272,16,275,985,1250
"n2010770","2010770",1997,211,1786,31,550,1232,1748,1259,173,1086,23,273,797,1058
"n293116","293116",2984,1302,1682,307,317,1083,1351,2064,946,1118,204,200,703,884
"n294204","294204",41,0,41,0,2,38,40,28,0,28,0,2,26,28
"n291015","291015",2640,81,2559,12,24,2515,2530,1977,59,1918,8,16,1888,1897
"n33003A","33003A",100,80,20,0,2,20,20,75,64,11,0,1,11,11
"n410070","410070",1947,1065,882,77,277,514,770,1492,892,600,67,188,328,503
"n510309","510309",923,739,184,2,50,101,150,756,615,141,1,44,68,111
"n3090039","3090039",2915,342,2573,21,645,1931,2534,2033,283,1750,18,448,1277,1716
"n3390067","3390067",4069,2689,1380,338,191,739,902,3298,2292,1006,237,132,525,648
"n3390103","3390103",6986,3629,3357,452,1002,1787,2727,4817,2660,2157,298,613,1139,1723
"n3630009","3630009",394,370,24,4,1,15,16,360,343,17,2,1,12,13
"n4393254","4393254",4203,2183,2020,216,733,899,1606,3257,1863,1394,167,468,619,1075
"n4410402","4410402",5985,4082,1903,154,669,971,1607,5139,3662,1477,121,502,749,1229
"n730047","730047",383,278,105,5,25,71,95,278,214,64,4,24,33,56
"n1134013","1134013",416,323,93,27,6,50,55,334,259,75,25,4,36,40
"n1132203","1132203",1978,1652,326,128,23,116,132,1535,1311,224,84,15,80,93
"n2011125","2011125",0,0,0,0,0,0,0,0,0,0,0,0,0,0
"n2150123","2150123",1677,151,1526,3,18,1502,1511,1215,142,1073,3,7,1062,1063
"n2310432","2310432",2525,1957,568,23,176,289,461,1900,1514,386,16,134,185,317
"n291115","291115",2083,140,1943,10,22,1923,1932,1590,114,1476,5,15,1460,1467
"n293010","293010",1734,424,1310,212,213,891,1091,1414,380,1034,163,159,713,863
"n293016","293016",0,0,0,0,0,0,0,0,0,0,0,0,0,0
"n410010","410010",6483,3871,2612,783,635,1064,1647,4572,2859,1713,546,367,657,1016
"n950101","950101",476,385,91,10,8,74,80,377,330,47,1,6,38,43
"n1132100","1132100",5217,3034,2183,467,608,1038,1608,5009,2982,2027,443,551,951,1480
"n4530190","4530190",5243,1499,3744,466,1547,1768,3218,4338,1377,2961,366,1199,1389,2528
"n4570002","4570002",1792,1007,785,29,593,140,733,1412,868,544,26,409,91,500
"n213001T","213001T",2774,2246,528,31,178,240,405,2280,1926,354,21,107,147,252
"n2150226","2150226",4111,58,4053,15,8,4037,4043,2909,48,2861,5,1,2852,2853
"n3310316","3310316",1020,741,279,19,113,119,221,806,609,197,14,86,77,158
"n3530006","3530006",1729,964,765,11,37,680,710,1221,745,476,7,16,422,436
"n4394091","4394091",4605,2604,2001,66,92,1699,1767,3540,2188,1352,51,55,1120,1162
"n4392525","4392525",6097,1257,4840,596,2206,2059,4206,4265,938,3327,445,1506,1378,2860
"n1133098","1133098",428,4,424,1,246,181,422,312,3,309,1,197,112,308
"n1133092","1133092",3571,122,3449,14,2497,948,3417,2555,96,2459,10,1851,596,2434
"n1571006","1571006",18190,9515,8675,2949,1778,3720,5402,11773,6369,5404,1798,1106,2302,3363
"n1670211","1670211",5420,2119,3301,99,1987,1215,3145,4547,2007,2540,83,1571,880,2411
"n1990004","1990004",1168,1081,87,9,7,34,40,885,822,63,8,6,19,25
"n2010233","2010233",5416,3036,2380,840,541,972,1479,4974,2880,2094,746,455,844,1274
"n292101","292101",140,55,85,10,2,76,78,102,49,53,6,2,48,50
"n430001","430001",2501,1487,1014,64,43,848,874,1979,1265,714,46,32,569,593
"n430007","430007",268,178,90,0,1,82,83,230,175,55,0,1,51,52
"n850213","850213",7079,2758,4321,2385,932,850,1743,4330,1736,2594,1425,565,506,1057
"n850219","850219",5456,2781,2675,1547,457,582,1022,4188,2255,1933,1093,338,419,750
"n1133808","1133808",7620,1538,6082,69,3138,2873,5892,5515,1377,4138,45,2214,1835,3988
"n4910310","4910310",3276,1849,1427,32,73,1198,1251,2425,1492,933,21,43,772,807
"n2510017","2510017",8084,4641,3443,65,458,2676,3105,6148,3801,2347,44,319,1782,2092
"n2930201","2930201",1102,488,614,12,301,300,591,821,424,397,8,214,167,381
"n3870027","3870027",739,653,86,12,31,31,57,601,541,60,10,22,17,37
"n4270002","4270002",5669,189,5480,35,19,5419,5425,4169,142,4027,24,12,3978,3983
"n4393443","4393443",3211,2070,1141,223,269,540,777,2500,1713,787,154,165,384,532
"n4690007","4690007",4169,702,3467,35,599,2888,3400,3039,578,2461,28,406,2026,2412
"n1211049","1211049",6529,3677,2852,367,1312,1056,2292,4412,2623,1789,234,792,642,1409
"n1250003","1250003",444,274,170,5,23,143,159,347,236,111,2,15,90,102
"n1410201","1410201",5161,396,4765,79,263,4470,4656,3425,288,3137,34,173,2924,3063
"n2010084","2010084",2726,1397,1329,45,95,1133,1221,1958,1118,840,28,56,708,758
"n2010919","2010919",4905,2795,2110,1482,90,468,551,3362,2011,1351,945,54,302,353
"n2010625","2010625",7601,1989,5612,587,3300,1809,4921,5759,1756,4003,464,2247,1295,3448
"n7001A","7001A",3036,1783,1253,37,59,1049,1104,2431,1519,912,20,41,755,795
"n294101","294101",1962,666,1296,13,210,1044,1233,1535,564,971,5,157,778,926
"n390042","390042",1148,543,605,19,162,438,571,863,462,401,9,103,283,376
"n1030002","1030002",1156,341,815,8,13,791,800,832,286,546,4,6,526,532
"n1132033","1132033",3319,2151,1168,283,349,496,824,3085,2052,1033,259,296,430,715
"n1134534","1134534",191,25,166,0,4,161,165,123,25,98,0,4,93,97
"n3730008","3730008",1978,1310,668,7,289,288,569,1545,1041,504,3,228,196,423
"n4392731","4392731",3593,992,2601,440,1365,800,2122,2437,688,1749,304,894,535,1415
"n4394234","4394234",4583,2984,1599,412,358,740,1062,3363,2275,1088,291,236,486,699
"n4530132","4530132",14486,1951,12535,809,1749,10062,11603,10597,1729,8868,568,1301,7044,8201
"n4830301","4830301",1159,827,332,13,56,222,273,880,665,215,7,36,137,172
"n4950401","4950401",1916,329,1587,53,66,1455,1513,1422,283,1139,39,46,1039,1080
"n1213152","1213152",2746,2183,563,112,74,302,371,2124,1739,385,78,45,202,243
"n1410009","1410009",4518,1253,3265,94,102,3086,3142,3541,1031,2510,71,67,2365,2409
"n1670431","1670431",4161,889,3272,57,2118,1109,3164,3292,762,2530,42,1691,793,2457
"n1890304","1890304",1503,589,914,20,91,786,870,1077,495,582,18,67,478,543
"n2010187","2010187",921,23,898,2,18,883,892,693,23,670,1,15,661,670
"n2011019","2011019",1819,73,1746,14,390,1354,1715,1219,58,1161,9,254,907,1143
"n770001","770001",1496,1290,206,14,26,82,106,1157,1014,143,12,19,45,63
"n1134019","1134019",4932,1312,3620,1134,1129,1335,2427,4302,1258,3044,1028,959,1022,1965
"n1131324","1131324",4745,1832,2913,396,906,1598,2447,3727,1591,2136,310,667,1117,1755
"n1211003","1211003",3022,2235,787,78,112,498,606,2289,1775,514,46,65,331,394
"n1350205","1350205",3541,1602,1939,79,205,1576,1753,2547,1308,1239,33,123,1009,1116
"n1410155","1410155",1927,62,1865,8,21,1843,1856,1480,43,1437,4,16,1422,1434
"n4410408","4410408",4955,3964,991,110,114,592,684,3673,3032,641,76,63,363,422
"n4530334","4530334",4199,2607,1592,276,181,1095,1237,3251,2126,1125,189,130,757,864
"n4710403B","4710403B",16,12,4,0,4,1,4,5,4,1,0,1,1,1
"n4910201","4910201",6057,3323,2734,1085,385,1169,1517,4168,2398,1770,711,244,742,967
"n1574040","1574040",6201,438,5763,66,1139,4668,5687,4457,349,4108,52,823,3290,4051
"n1810304","1810304",6113,4106,2007,386,672,726,1369,4731,3280,1451,310,457,490,934
"n2010333","2010333",5636,3837,1799,283,266,1081,1319,4429,3136,1293,204,193,748,924
"n2010873","2010873",1488,127,1361,307,399,667,1042,1148,110,1038,264,298,478,766
"n3950019","3950019",840,737,103,2,13,72,84,692,617,75,2,10,48,57
"n4392168","4392168",2558,857,1701,135,595,956,1509,1948,716,1232,97,443,660,1078
"n50010A","50010A",2272,857,1415,74,647,671,1304,1619,697,922,53,422,421,840
"n294221","294221",0,0,0,0,0,0,0,0,0,0,0,0,0,0
"n292121","292121",913,183,730,32,51,640,683,710,152,558,18,30,498,523
"n291118","291118",5853,1672,4181,307,970,2961,3767,3815,1175,2640,222,591,1816,2347
"n670006","670006",747,611,136,4,52,47,98,597,494,103,3,39,38,77
"n1410138","1410138",3712,123,3589,24,91,3509,3557,2924,107,2817,19,60,2761,2799
"n4550020","4550020",84,57,27,0,21,2,23,75,51,24,0,19,2,21
"n4730315","4730315",480,195,285,3,18,254,270,358,165,193,1,15,167,181
"n2150057","2150057",2270,45,2225,7,12,2204,2214,1552,36,1516,6,10,1497,1507
"n391002A","391002A",237,164,73,2,4,65,67,201,142,59,1,4,52,54
"n4391617","4391617",88,28,60,0,3,48,51,68,26,42,0,2,31,33
"n4392537","4392537",4781,925,3856,165,2023,1642,3606,3532,813,2719,132,1474,1083,2533
"n4394452","4394452",6659,2298,4361,1832,925,1564,2422,4553,1689,2864,1252,518,1044,1535
"n4510327","4510327",4014,1557,2457,30,249,2138,2360,2998,1271,1727,26,193,1469,1653
"n1571014","1571014",12328,5944,6384,2584,1298,2355,3592,8222,4079,4143,1655,820,1552,2342
"n1710010","1710010",1509,1079,430,4,5,387,389,1260,933,327,4,4,293,294
"n1870231","1870231",119,93,26,0,7,15,22,106,82,24,0,7,13,20
"n2010230","2010230",2011,38,1973,13,961,1007,1961,1445,32,1413,7,759,648,1402
"n2010396","2010396",2622,29,2593,12,2032,552,2559,2056,24,2032,7,1645,379,2010
"n2010893","2010893",2999,686,2313,560,954,792,1708,2104,550,1554,405,616,532,1122
"n294078","294078",2097,1229,868,23,126,690,800,1633,1044,589,20,85,456,533
"n2010468","2010468",10549,572,9977,1492,1932,6535,8386,7647,487,7160,1202,1412,4529,5895
"n2011131","2011131",421,283,138,35,45,55,100,325,232,93,26,31,34,65
"n2250015","2250015",288,223,65,6,43,7,49,244,187,57,3,41,6,46
"n270204","270204",4566,1267,3299,168,1788,1336,2993,3502,1146,2356,140,1240,925,2107
"n11341A1","11341A1",0,0,0,0,0,0,0,0,0,0,0,0,0,0
"n1213118","1213118",4153,1380,2773,1057,1014,661,1634,3453,1230,2223,814,840,524,1338
"n1391037","1391037",2367,1838,529,39,135,268,399,1587,1258,329,13,85,160,244
"n1430018","1430018",2683,2141,542,47,15,426,438,2053,1703,350,28,8,270,276
"n1574167","1574167",57,6,51,18,12,17,28,38,3,35,9,11,16,26
"n4391075","4391075",2626,260,2366,28,313,2021,2313,1859,219,1640,16,264,1364,1613
"n4392267","4392267",5889,1397,4492,458,1716,2316,3968,4227,1160,3067,373,1138,1517,2639
"n4393558","4393558",4618,3407,1211,662,107,332,432,3313,2576,737,386,68,202,267
"n4410206","4410206",4060,3108,952,18,62,753,813,3089,2458,631,12,43,477,518
"n4530314","4530314",3724,2010,1714,731,230,730,947,3429,1846,1583,681,218,663,868
"n1830011","1830011",7530,4259,3271,105,1354,1631,2936,5575,3494,2081,66,863,991,1835
"n2010319","2010319",3925,86,3839,28,1936,1948,3803,2814,80,2734,19,1435,1311,2705
"n2010070","2010070",5232,3597,1635,536,256,775,1010,4722,3346,1376,427,209,649,850
"n3550006","3550006",5194,2769,2425,330,249,1767,1984,3991,2192,1799,274,178,1246,1413
"n3670345","3670345",3391,2633,758,34,75,520,589,2590,2109,481,23,41,316,354
"n4030005","4030005",1667,1510,157,5,75,50,115,1266,1161,105,2,52,27,75
"n130008","130008",900,323,577,15,8,551,554,681,272,409,9,5,391,392
"n293125","293125",5807,2501,3306,933,491,1914,2322,4022,1827,2195,622,328,1237,1512
"n410036","410036",7255,3702,3553,253,1390,1784,3105,5889,3285,2604,213,964,1295,2246
"n850096","850096",2336,819,1517,108,564,821,1364,1657,657,1000,70,383,520,894
"n850145","850145",2372,1154,1218,537,390,264,642,1726,892,834,375,261,176,429
"n1132084","1132084",915,333,582,76,279,219,492,856,327,529,75,254,194,442
"n4910117","4910117",9376,3977,5399,2429,1110,1743,2782,7809,3551,4258,1892,868,1402,2221
"n2450074","2450074",4081,3093,988,137,171,618,782,3201,2520,681,100,107,418,524
"n3030126","3030126",2165,1241,924,49,175,675,833,1704,1051,653,38,130,452,576
"n4230004","4230004",4344,1115,3229,18,612,2550,3144,3041,924,2117,12,456,1586,2042
"n4230041","4230041",6170,4911,1259,97,500,483,967,4356,3506,850,62,353,288,636
"n4392659","4392659",38,10,28,3,1,22,22,26,10,16,3,0,14,14
"n4393054","4393054",5502,3746,1756,460,336,826,1133,3955,2824,1131,300,216,513,721
"n1410084","1410084",3375,104,3271,11,28,3254,3260,2633,85,2548,8,18,2537,2543
"n1410121","1410121",2615,211,2404,73,67,2286,2333,2153,189,1964,62,41,1864,1901
"n1670387","1670387",5106,3104,2002,422,290,1170,1437,3511,2252,1259,271,184,691,868
"n1674391","1674391",30,15,15,4,9,7,14,22,13,9,3,7,1,8
"n2010839","2010839",3876,764,3112,587,929,1617,2479,3102,625,2477,449,758,1286,1990
"n2150003","2150003",1860,47,1813,6,12,1800,1805,1256,36,1220,1,3,1214,1216
"n291087","291087",3780,322,3458,66,365,3100,3380,2624,262,2362,46,246,2090,2291
"n292173","292173",3010,733,2277,122,347,1812,2100,2363,656,1707,97,233,1351,1558
"n490318","490318",2731,2093,638,34,61,438,484,2179,1749,430,25,32,283,309
"n610007","610007",3794,291,3503,15,29,3454,3471,2724,239,2485,11,21,2450,2465
"n730033","730033",2972,2316,656,30,267,216,476,2297,1853,444,20,181,117,297
"n850039","850039",4919,2255,2664,507,831,1243,2025,3827,1945,1882,399,541,854,1375
"n2270035","2270035",769,373,396,16,64,302,360,599,303,296,16,34,231,262
"n2390002","2390002",3718,2017,1701,20,166,1456,1602,2789,1599,1190,14,127,994,1113
"n3150010","3150010",772,597,175,8,94,50,144,649,516,133,4,77,31,108
"n3390092","3390092",8298,4386,3912,659,1335,1834,3092,5541,3054,2487,437,844,1130,1941
"n4530470","4530470",4144,1556,2588,271,408,1867,2226,3461,1411,2050,230,340,1443,1753
"n4790220","4790220",2872,91,2781,15,7,2756,2759,1973,69,1904,3,6,1891,1894
"n1134002","1134002",1528,772,756,76,98,579,660,1204,673,531,51,66,399,457
"n1132614","1132614",462,39,423,389,13,25,35,306,25,281,265,5,12,17
"n2010696","2010696",5345,1719,3626,131,265,3149,3357,4064,1493,2571,89,188,2205,2357
"n2010448","2010448",4590,3085,1505,284,182,947,1106,3556,2482,1074,178,107,709,803
"n2150109","2150109",8856,653,8203,319,298,7633,7859,6779,551,6228,260,224,5751,5935
"n2150195","2150195",2126,732,1394,6,8,1381,1383,1618,722,896,6,2,885,887
"n294130","294130",1321,438,883,51,254,593,807,998,360,638,41,179,406,570
"n294167","294167",166,44,122,4,3,113,113,138,44,94,4,2,85,85
"n291149","291149",4220,821,3399,336,556,2541,3022,3087,667,2420,237,393,1789,2153
"n1131040","1131040",6766,1404,5362,202,3303,1862,5078,5140,1282,3858,168,2366,1292,3618
"n1131087","1131087",7216,440,6776,159,3044,3592,6583,5249,373,4876,145,2332,2402,4710
"n1133501","1133501",14,2,12,8,0,4,4,9,2,7,5,0,2,2
"n507004A","507004A",956,54,902,1,13,890,897,681,46,635,1,5,628,630
"n2810005","2810005",709,618,91,7,15,51,66,611,549,62,5,12,28,40
"n3390034","3390034",3531,2519,1012,147,172,627,780,2780,2076,704,102,116,434,538
"n4391550","4391550",73,3,70,1,22,47,69,45,3,42,0,16,25,41
"n4391423","4391423",2904,2267,637,313,89,177,258,2386,1892,494,246,64,136,199
"n4590014","4590014",1091,769,322,17,96,145,239,848,609,239,17,77,96,171
"n49901-4","49901-4",1015,842,173,5,16,95,108,790,664,126,3,12,78,88
"n1572017","1572017",4005,107,3898,29,2552,1365,3860,3024,92,2932,22,2029,893,2899
"n1572120","1572120",4118,2663,1455,441,308,635,929,2996,2007,989,303,220,421,634
"n2011051","2011051",0,0,0,0,0,0,0,0,0,0,0,0,0,0
"n2011088","2011088",1382,401,981,47,156,770,913,1009,326,683,35,113,530,632
"n2010511","2010511",5493,2141,3352,1588,760,960,1684,3592,1452,2140,980,516,602,1105
"n277002D","277002D",929,705,224,10,112,64,176,722,554,168,8,89,43,132
"n50018","50018",1244,670,574,43,286,234,510,1007,575,432,25,225,171,391
"n291044","291044",3117,150,2967,15,54,2910,2938,2420,116,2304,12,35,2263,2282
"n292130","292130",3147,823,2324,185,278,1856,2091,2432,714,1718,131,202,1364,1545
"n293186","293186",0,0,0,0,0,0,0,0,0,0,0,0,0,0
"n1133021","1133021",1803,40,1763,5,1272,498,1748,1390,35,1355,5,1041,313,1343
"n1134049","1134049",0,0,0,0,0,0,0,0,0,0,0,0,0,0
"n475003N","475003N",2411,1099,1312,22,99,1174,1242,1734,852,882,7,66,784,837
"n4910266","4910266",5952,3167,2785,998,559,1181,1660,4306,2460,1846,709,346,739,1054
"n3030023","3030023",2121,1291,830,35,185,608,749,1659,1094,565,20,126,405,508
"n323004C","323004C",925,16,909,9,8,896,897,689,10,679,8,1,670,670
"n3470014","3470014",4677,3342,1335,49,449,740,1174,3407,2546,861,29,319,434,747
"n3610029","3610029",1790,1628,162,9,12,77,83,1367,1247,120,8,8,51,54
"n4510423","4510423",2023,1553,470,64,56,309,359,1585,1243,342,46,36,225,256
"n4530414","4530414",5518,3608,1910,444,271,1084,1324,5163,3443,1720,407,241,944,1165
"n1131751","1131751",8718,4252,4466,1359,1656,1312,2911,7232,3734,3498,1098,1260,1014,2239
"n1211032","1211032",7237,4644,2593,944,553,971,1488,4911,3302,1609,577,342,597,920
"n2010654","2010654",4535,932,3603,410,536,2660,3152,3514,822,2692,350,397,1918,2299
"n2010156","2010156",55,39,16,6,1,2,3,39,27,12,6,1,2,3
"n2010902","2010902",4752,2968,1784,447,296,985,1253,4114,2614,1500,383,255,812,1048
"n2010405","2010405",6245,3855,2390,566,593,1160,1728,4176,2663,1513,379,364,711,1064
"n190410","190410",546,475,71,2,2,61,62,471,416,55,1,1,45,46
"n293082","293082",3779,1574,2205,171,336,1664,1930,2939,1309,1630,134,209,1225,1406
"n293039","293039",7009,3473,3536,462,456,2544,2943,4916,2498,2418,323,306,1708,1986
"n390071","390071",1845,492,1353,365,625,369,980,1430,407,1023,260,508,258,759
"n1132123","1132123",5191,786,4405,954,2268,1193,3417,3766,638,3128,721,1639,766,2384
"n1134610","1134610",4979,1414,3565,186,354,2986,3301,3803,1268,2535,152,259,2065,2311
"n4530232","4530232",3882,3277,605,204,38,295,329,3141,2693,448,149,28,218,243
"n4530224","4530224",2836,2028,808,213,78,438,514,2267,1688,579,146,58,314,370
"n4850302","4850302",6460,3076,3384,107,617,2560,3116,4896,2620,2276,85,381,1687,2050
"n4850308","4850308",5920,5080,840,86,88,405,480,4403,3875,528,47,48,235,276
"n2010262","2010262",13486,2953,10533,732,751,9068,9682,9877,2566,7311,620,563,6133,6599
"n2010796","2010796",6400,1462,4938,480,1391,3080,4378,4563,1133,3430,337,930,2126,3027
"n3090005","3090005",2434,160,2274,14,158,2118,2249,1678,130,1548,13,117,1425,1526
"n3090011","3090011",2718,1982,736,86,224,376,572,2122,1611,511,63,153,245,390
"n3550063","3550063",3147,1721,1426,76,88,1231,1305,2539,1476,1063,61,67,910,968
"n3550069","3550069",3168,574,2594,24,147,2416,2536,2409,481,1928,19,94,1793,1879
"n1134616","1134616",4969,538,4431,151,252,4003,4228,3373,449,2924,122,179,2607,2775
"n1134512","1134512",3763,863,2900,41,488,2371,2821,2640,743,1897,28,306,1558,1842
"n1132129","1132129",2590,326,2264,60,414,1771,2175,1841,302,1539,57,298,1161,1458
"n1410035","1410035",3088,809,2279,110,158,1972,2120,2629,736,1893,87,149,1629,1769
"n2010256","2010256",7817,1150,6667,433,655,5564,6179,5864,1030,4834,339,447,4016,4440
"n2010802","2010802",0,0,0,0,0,0,0,0,0,0,0,0,0,0
"n10002","10002",3811,3159,652,16,256,294,530,2880,2453,427,11,172,173,335
"n294024","294024",5070,847,4223,67,363,3844,4125,3888,771,3117,49,257,2795,3027
"n370027","370027",1045,962,83,1,10,29,39,841,775,66,1,4,22,26
"n910301A","910301A",11002,3551,7451,161,502,6691,7102,7936,2788,5148,109,333,4599,4887
"n1131708","1131708",1566,544,1022,34,338,627,947,1218,477,741,27,246,438,678
"n1212075","1212075",2309,601,1708,37,44,1584,1622,1597,493,1104,23,26,1018,1042
"n2970005","2970005",424,308,116,6,2,90,92,346,264,82,5,1,62,63
"n3650013","3650013",390,274,116,5,55,38,91,309,221,88,5,51,23,72
"n397003E","397003E",3469,2725,744,135,207,290,488,2590,2095,495,81,132,202,331
"n4393735","4393735",1730,1093,637,337,107,134,233,1282,854,428,240,73,75,146
"n4490007","4490007",1901,1188,713,20,169,484,644,1428,945,483,13,119,311,428
"n4910370","4910370",4348,2678,1670,91,366,1136,1464,3321,2187,1134,61,205,773,967
"n1350408","1350408",1762,259,1503,11,90,1408,1476,1314,218,1096,10,72,1017,1072
"n1870126","1870126",40,25,15,0,2,15,15,26,19,7,0,0,7,7
"n2010945","2010945",352,30,322,3,14,303,312,212,22,190,2,5,182,187
"n2010113","2010113",4809,1288,3521,452,1418,1644,3005,3639,1151,2488,358,965,1141,2085
"n2050201","2050201",412,304,108,3,8,91,95,300,232,68,3,7,52,56
"n2570024","2570024",2124,1279,845,15,208,568,769,1669,1092,577,11,159,361,516
"n294124","294124",5121,627,4494,48,473,4007,4397,4056,564,3492,39,378,3078,3415
"n291143","291143",6234,1950,4284,483,866,2971,3748,4456,1544,2912,322,591,1983,2532
"n610064","610064",800,86,714,1,2,706,708,573,62,511,1,1,505,506
"n1110008","1110008",1706,802,904,3,29,853,879,1180,609,571,0,20,537,555
"n1133116","1133116",14,0,14,0,10,3,13,11,0,11,0,7,3,10
"n1214174","1214174",3292,1311,1981,240,970,767,1695,3045,1240,1805,218,886,698,1545
"n4394343","4394343",3223,2539,684,142,155,303,456,2684,2121,563,115,136,242,377
"n4391578","4391578",3333,624,2709,62,1518,1130,2600,2231,476,1755,41,986,718,1677
"n4394573","4394573",19,3,16,0,11,3,14,16,3,13,0,8,3,11
"n4650040","4650040",8455,623,7832,59,117,7666,7748,6157,507,5650,39,69,5546,5605
"n2830002","2830002",1408,529,879,2,57,830,876,1240,524,716,1,54,667,713
"n3370009","3370009",1568,1393,175,4,4,87,90,1329,1211,118,4,3,41,44
"n3390040","3390040",6621,4388,2233,328,707,1074,1742,5042,3530,1512,225,462,717,1158
"n3750223","3750223",4749,838,3911,49,244,3577,3772,3510,717,2793,32,132,2568,2692
"n3810307","3810307",1491,1235,256,17,16,175,187,1133,971,162,9,8,104,112
"n4391412","4391412",0,0,0,0,0,0,0,0,0,0,0,0,0,0
"n1571160","1571160",4391,1854,2537,872,648,999,1617,3078,1384,1694,600,421,657,1061
"n1930014","1930014",240,215,25,0,1,21,21,200,178,22,0,0,18,18
"n2011045","2011045",1543,246,1297,753,194,341,508,1080,192,888,528,125,218,335
"n2010505","2010505",9204,2578,6626,244,1585,4705,6207,7193,2308,4885,198,1172,3403,4543
"n2150252","2150252",9,6,3,0,0,3,3,9,6,3,0,0,3,3
"n2750401","2750401",857,466,391,10,51,321,368,620,360,260,4,43,200,243
"n50021","50021",1512,1043,469,12,222,215,428,1107,798,309,0,149,137,286
"n291129","291129",3503,960,2543,296,632,1675,2232,2491,755,1736,207,415,1105,1491
"n970021","970021",1770,1628,142,16,12,63,75,1315,1231,84,5,3,35,38
"n1132115","1132115",301,249,52,7,15,27,41,292,246,46,7,13,22,35
"n1133806","1133806",1707,51,1656,8,1475,197,1649,1210,45,1165,7,1045,123,1159
"n1211041","1211041",8118,3339,4779,2137,1461,1062,2449,5024,2178,2846,1264,874,613,1448
"n3350004","3350004",1656,880,776,19,112,624,720,1239,699,540,15,66,436,494
"n3550094","3550094",3103,849,2254,19,128,2081,2196,2415,735,1680,16,92,1539,1627
"n3950003","3950003",675,570,105,1,19,82,100,548,473,75,1,13,59,71
"n4394494","4394494",238,115,123,3,69,49,115,219,115,104,3,65,33,98
"n4391082","4391082",1633,349,1284,66,90,1116,1194,1200,290,910,51,46,789,834
"n4392601","4392601",0,0,0,0,0,0,0,0,0,0,0,0,0,0
"n1391043","1391043",4933,3256,1677,87,573,882,1432,3589,2446,1143,63,412,577,981
"n1571133","1571133",5730,3354,2376,1148,269,842,1074,4105,2481,1624,775,185,563,732
"n1750031","1750031",904,591,313,7,48,253,291,703,494,209,7,37,160,192
"n2010076","2010076",3644,790,2854,230,330,2308,2591,2723,716,2007,187,239,1581,1796
"n2550008","2550008",224,149,75,0,2,69,70,171,126,45,0,2,40,41
"n3030032","3030032",1838,1125,713,29,70,601,664,1241,819,422,21,38,353,389
"n70003","70003",5817,4162,1655,213,147,1146,1265,4961,3729,1232,157,101,814,908
"n291152","291152",1847,447,1400,143,165,1115,1241,1410,368,1042,103,119,827,925
"n293131","293131",13,3,10,1,5,4,7,6,3,3,1,2,0,2
"n370010","370010",2419,1898,521,81,272,93,358,1911,1528,383,53,204,63,264
"n410091A","410091A",12,9,3,0,1,2,3,12,9,3,0,1,2,3
"n770032","770032",276,248,28,2,7,17,24,225,203,22,2,6,13,19
"n4530349","4530349",4865,3243,1622,411,164,962,1101,3730,2614,1116,305,118,625,732
"n4790125","4790125",1657,14,1643,11,9,1623,1624,1190,10,1180,5,7,1173,1173
"n4910256","4910256",2410,1462,948,129,132,623,729,1790,1159,631,88,92,403,473
"n3390008","3390008",4793,3521,1272,57,115,953,1050,3634,2796,838,44,87,594,673
"n3550117","3550117",4699,3043,1656,165,118,1260,1347,3617,2463,1154,145,91,821,894
"n397002B","397002B",2791,1640,1151,185,430,477,896,2194,1372,822,148,295,326,617
"n4391132","4391132",3789,122,3667,12,1364,2293,3646,2687,104,2583,11,1061,1514,2564
"n4392681","4392681",0,0,0,0,0,0,0,0,0,0,0,0,0,0
"n4394591","4394591",5231,2508,2723,492,775,1404,2096,3600,1793,1807,335,516,896,1375
"n930015","930015",555,468,87,4,1,62,63,449,392,57,4,1,38,39
"n1132092","1132092",0,0,0,0,0,0,0,0,0,0,0,0,0,0
"n1133606","1133606",3723,248,3475,53,3016,425,3400,2919,227,2692,41,2360,291,2634
"n1211018","1211018",1264,554,710,349,162,191,342,785,359,426,203,95,115,208
"n1391020","1391020",3245,1816,1429,26,179,1168,1329,2386,1483,903,11,120,723,836
"n1530003","1530003",1349,333,1016,6,61,940,984,941,240,701,5,43,638,677
"n110402","110402",221,196,25,4,3,10,13,177,161,16,1,1,6,7
"n294116","294116",77,29,48,8,16,23,36,56,25,31,8,10,13,20
"n292014","292014",2078,154,1924,12,33,1887,1907,1632,133,1499,7,17,1473,1485
"n293152","293152",945,466,479,49,32,379,408,743,388,355,35,22,278,299
"n292181A","292181A",1162,302,860,85,172,614,771,759,221,538,53,113,370,477
"n37002D","37002D",166,65,101,0,93,6,99,120,54,66,0,60,5,65
"n2190044","2190044",1157,555,602,2,40,539,572,860,450,410,2,29,355,382
"n2510010","2510010",5111,2871,2240,159,251,1699,1923,3761,2169,1592,152,179,1136,1305
"n2970011","2970011",1389,231,1158,1,172,979,1150,1352,215,1137,0,172,958,1129
"n3290303","3290303",864,134,730,13,52,658,699,608,112,496,9,31,444,470
"n1133311","1133311",4786,1645,3141,92,853,2139,2938,3396,1356,2040,70,572,1310,1866
"n1190004","1190004",954,748,206,18,94,67,155,771,613,158,12,65,55,118
"n2010954","2010954",2522,76,2446,25,1204,1229,2395,1680,61,1619,16,817,794,1587
"n2010291","2010291",2481,792,1689,135,282,1272,1502,1776,662,1114,112,180,806,960
"n2010623","2010623",7955,2935,5020,784,2025,2181,4097,6193,2546,3647,595,1407,1586,2935
"n2090441","2090441",2949,2313,636,83,42,403,441,2287,1865,422,48,20,280,298
"n410068","410068",0,0,0,0,0,0,0,0,0,0,0,0,0,0
"n610010","610010",5030,97,4933,4,15,4918,4919,3613,56,3557,4,9,3546,3547
"n730045","730045",1677,668,1009,3,109,883,990,1245,552,693,2,102,576,676
"n850125","850125",8087,3362,4725,3005,984,622,1588,6113,2725,3388,2133,761,406,1154
"n910306","910306",5177,2841,2336,180,277,1806,2031,4152,2458,1694,130,197,1301,1472
"n1132050","1132050",3162,1507,1655,105,443,1066,1492,2381,1245,1136,76,324,710,1019
"n150102","150102",1865,1172,693,9,210,438,643,1455,965,490,8,158,295,451
"n270404","270404",9053,2639,6414,469,3470,2592,5708,6176,1873,4303,336,2258,1683,3754
"n294093","294093",4506,1423,3083,122,539,2387,2865,3420,1223,2197,92,370,1672,2015
"n293175","293175",821,323,498,13,35,446,473,723,295,428,10,29,379,405
"n292159","292159",308,77,231,29,22,181,198,232,62,170,26,15,131,141
"n292037","292037",1945,735,1210,113,111,1002,1086,1571,643,928,94,85,752,821
"n3030007","3030007",4531,2754,1777,130,312,1276,1533,3554,2386,1168,104,190,819,985
"n329307A","329307A",2418,804,1614,38,220,1343,1533,1787,675,1112,28,153,910,1051
"n3550072","3550072",2799,442,2357,34,97,2239,2315,2120,356,1764,21,63,1674,1725
"n3890005","3890005",552,122,430,7,3,413,416,436,102,334,6,1,320,321
"n4391014","4391014",1842,360,1482,34,147,1295,1430,1279,322,957,16,85,843,921
"n1131153","1131153",158,5,153,0,13,137,150,117,5,112,0,13,96,109
"n1133004","1133004",2722,688,2034,33,727,1272,1980,2156,609,1547,16,623,893,1506
"n1132024","1132024",2353,1746,607,162,157,258,410,1991,1496,495,130,131,206,334
"n213001A","213001A",3287,2476,811,20,66,596,656,2572,2016,556,11,46,393,438
"n2230004","2230004",2292,1554,738,28,106,569,670,1698,1239,459,16,73,341,413
"n2510032","2510032",5996,3938,2058,62,180,1562,1728,4479,3125,1354,42,115,995,1108
"n37022A","37022A",160,142,18,2,8,1,9,130,119,11,0,7,1,8
"n410045","410045",180,96,84,2,16,65,75,141,93,48,2,3,38,40
"n610033","610033",1897,133,1764,16,33,1723,1744,1292,102,1190,13,25,1159,1175
"n710017","710017",1445,999,446,41,85,304,387,842,603,239,20,56,154,209
"n850148","850148",421,365,56,12,26,17,40,414,361,53,12,24,14,37
"n910105","910105",5793,4250,1543,71,73,1177,1230,4749,3614,1135,53,45,834,866
"n292136","292136",6589,2236,4353,385,499,3563,3928,4486,1565,2921,255,313,2344,2612
"n410022","410022",1140,246,894,9,202,679,863,812,233,579,9,110,450,556
"n610056","610056",4237,676,3561,150,98,3332,3387,2909,552,2357,121,55,2174,2209
"n1134501","1134501",3841,1117,2724,399,900,1419,2271,2884,956,1928,296,665,939,1591
"n1131310","1131310",7540,1816,5724,80,1917,3740,5555,5367,1594,3773,57,1258,2419,3644
"n1214208","1214208",2293,1398,895,331,129,380,507,1552,996,556,196,94,230,323
"n2790005","2790005",810,265,545,2,9,531,539,594,220,374,2,2,368,370
"n3470027","3470027",2670,212,2458,24,1891,546,2413,1786,143,1643,15,1312,325,1624
"n419009N","419009N",1703,1136,567,15,306,187,488,1261,855,406,11,230,115,343
"n4393580","4393580",0,0,0,0,0,0,0,0,0,0,0,0,0,0
"n4570015","4570015",1357,1249,108,8,17,39,56,1009,933,76,5,11,28,39
"n505001A","505001A",149,7,142,0,2,141,141,107,5,102,0,2,101,101
"n1410147","1410147",2798,107,2691,13,34,2662,2672,2130,85,2045,4,14,2029,2033
"n1590401","1590401",1590,1349,241,9,14,156,165,1303,1132,171,8,7,103,109
"n2010831","2010831",165,19,146,3,11,133,141,118,16,102,3,8,93,98
"n2010908","2010908",0,0,0,0,0,0,0,0,0,0,0,0,0,0
"n2010245","2010245",6382,2725,3657,448,896,2248,3089,4464,2068,2396,324,556,1426,1962
"n2150161","2150161",3776,180,3596,204,58,3352,3386,2851,154,2697,173,33,2492,2518
"n292113","292113",253,24,229,38,51,147,188,170,24,146,22,23,99,122
"n1134525","1134525",3722,484,3238,126,791,2287,3048,2628,409,2219,107,549,1529,2058
"n1131410","1131410",5157,693,4464,56,1414,2980,4372,3485,588,2897,37,929,1916,2830
"n1410170","1410170",7023,380,6643,22,60,6577,6604,4942,304,4638,13,38,4593,4608
"n1610015","1610015",460,369,91,3,41,34,73,350,291,59,1,27,19,45
"n1890202","1890202",954,85,869,2,108,751,855,692,75,617,1,83,522,604
"n277004B","277004B",2530,2117,413,8,106,104,205,2022,1748,274,3,70,66,136
"n277002G","277002G",959,712,247,5,94,104,197,738,570,168,4,72,64,135
"n3430302","3430302",1698,1069,629,19,422,121,537,1279,846,433,12,308,59,367
"n4150012","4150012",3251,1588,1663,21,156,1446,1583,2410,1312,1098,16,109,928,1031
"n4393510","4393510",3472,2736,736,280,111,252,357,2810,2261,549,213,75,180,250
"n2010145","2010145",2479,29,2450,5,1900,555,2436,1698,25,1673,5,1326,347,1661
"n2010808","2010808",17,5,12,0,3,6,9,11,5,6,0,0,3,3
"n2010931","2010931",164,105,59,30,4,18,21,133,82,51,28,4,16,19
"n2010268","2010268",3238,2046,1192,766,80,308,385,2318,1516,802,524,55,197,252
"n2150138","2150138",1095,24,1071,3,5,1066,1069,805,12,793,1,2,792,792
"n2170002","2170002",3063,2525,538,14,33,373,402,2353,2003,350,7,15,228,242
"n291007","291007",2078,89,1989,12,14,1953,1961,1616,76,1540,8,10,1512,1520
"n294110","294110",1963,743,1220,52,136,1025,1138,1588,652,936,39,106,787,877
"n850131","850131",4191,2812,1379,333,426,519,922,3126,2175,951,235,296,351,635
"n1132808","1132808",5458,2218,3240,2452,183,535,709,3730,1662,2068,1544,122,347,464
"n1134602","1134602",4107,965,3142,302,230,2595,2792,3093,867,2226,249,163,1786,1937
"n1214163","1214163",5697,2379,3318,517,906,1795,2652,4005,1792,2213,375,607,1139,1720
"n4970015","4970015",1971,1653,318,13,27,219,242,1569,1353,216,8,21,136,156
"n2010785","2010785",6810,1722,5088,754,1775,2591,4235,4510,1270,3240,540,1058,1641,2635
"n2150115","2150115",5505,163,5342,11,16,5316,5320,3957,127,3830,8,11,3806,3810
"n3990007","3990007",1485,930,555,3,50,475,515,1168,785,383,1,33,327,354
"n4393036","4393036",4784,1956,2828,517,607,1379,1961,3452,1526,1926,388,349,965,1300
"n4530374","4530374",3288,2737,551,83,33,349,379,2624,2242,382,43,21,246,267
"n4650012A","4650012A",318,14,304,5,4,294,295,225,10,215,3,3,207,207
"n1410193","1410193",3634,797,2837,229,173,2479,2605,2652,639,2013,173,109,1732,1830
"n1573175","1573175",2386,379,2007,293,687,1059,1705,1813,323,1490,249,489,752,1224
"n1572094","1572094",21,5,16,0,6,10,16,18,5,13,0,6,7,13
"n1910202","1910202",609,382,227,7,32,186,212,511,338,173,3,26,140,161
"n2010122","2010122",2846,93,2753,28,1313,1428,2720,2168,73,2095,17,1078,1003,2070
"n2010617","2010617",8799,1331,7468,582,2566,4426,6804,6309,1078,5231,471,1694,3080,4688
"n1133010","1133010",1155,29,1126,6,678,443,1117,734,24,710,3,436,270,705
"n1214186","1214186",2735,2495,240,37,32,116,148,2673,2459,214,34,30,95,125
"n1211064","1211064",3566,2728,838,92,175,439,598,2805,2235,570,69,108,302,402
"n1410214","1410214",14,2,12,1,5,7,12,9,0,9,0,4,5,9
"n1572031","1572031",4779,85,4694,50,2565,2120,4619,3538,80,3458,38,2009,1442,3413
"n1574095","1574095",8445,2791,5654,1652,2081,1880,3893,5818,1993,3825,1162,1327,1296,2580
"n4393696","4393696",7181,4132,3049,565,703,1629,2287,4808,2918,1890,366,410,994,1384
"n4530396","4530396",4036,2678,1358,93,82,1019,1086,3168,2237,931,50,51,681,726
"n4590020","4590020",166,116,50,8,28,11,38,126,105,21,6,14,2,15
"n49903-3","49903-3",5138,3990,1148,47,621,237,850,4192,3253,939,37,530,175,699
"n1950009","1950009",195,99,96,1,1,88,89,141,85,56,0,1,48,49
"n2010099","2010099",5666,1127,4539,53,916,3514,4382,4146,985,3161,31,649,2407,3033
"n2010762","2010762",3031,415,2616,706,456,1459,1882,2259,356,1903,549,330,1013,1333
"n2010222","2010222",3744,2846,898,435,99,324,407,3132,2424,708,348,69,251,313
"n2010640","2010640",8243,2829,5414,726,1666,2950,4535,6026,2329,3697,543,1057,2001,3031
"n2110401","2110401",718,350,368,8,5,333,337,510,265,245,6,1,220,221
"n294156","294156",2037,390,1647,153,705,824,1467,1510,309,1201,109,514,579,1078
"n293114","293114",2808,1824,984,122,69,752,805,2182,1511,671,57,40,520,554
"n33002A","33002A",95,79,16,0,1,15,16,74,63,11,0,0,11,11
"n410108","410108",0,0,0,0,0,0,0,0,0,0,0,0,0,0
"n1132109","1132109",0,0,0,0,0,0,0,0,0,0,0,0,0,0
"n1131065","1131065",7996,731,7265,211,3005,4047,6991,5342,593,4749,161,1962,2608,4546
"n4530332","4530332",3470,1970,1500,146,191,1092,1255,2870,1718,1152,91,142,843,969
"n4690005","4690005",5041,1178,3863,68,486,3281,3731,3880,1013,2867,51,389,2372,2751
"n4910301","4910301",10329,4027,6302,4569,456,1131,1551,6709,2865,3844,2713,299,714,998
"n21303WS","21303WS",2309,1893,416,16,67,201,266,1861,1566,295,12,49,135,182
"n2150075","2150075",194,7,187,0,2,185,185,135,5,130,0,2,128,128
"n223004A","223004A",2934,1868,1066,33,218,738,947,2178,1503,675,26,133,448,579
"n3050012","3050012",604,402,202,6,16,176,186,432,298,134,4,8,114,120
"n4394503","4394503",2626,478,2148,54,70,1996,2060,1895,407,1488,43,58,1364,1419
"n4392306","4392306",2531,1779,752,99,231,370,587,2061,1521,540,65,175,247,417
"n1132412","1132412",12,3,9,2,6,3,9,9,3,6,0,4,2,6
"n1770002","1770002",3061,1136,1925,30,501,1432,1863,2317,1013,1304,25,340,937,1257
"n1990019","1990019",2492,2098,394,34,48,215,261,1843,1592,251,19,17,142,159
"n2011077","2011077",6519,733,5786,331,2813,2617,5331,4656,626,4030,265,1989,1725,3667
"n2010331","2010331",6530,2148,4382,776,1154,2475,3516,4450,1572,2878,518,730,1600,2278
"n2010082","2010082",5259,2905,2354,634,498,1121,1585,4013,2315,1698,485,336,778,1099
"n291030","291030",485,58,427,17,70,346,404,290,34,256,10,43,206,245
"n293008","293008",100,55,45,17,3,23,26,80,40,40,15,3,21,24
"n590001","590001",1556,1275,281,16,26,168,188,1222,1037,185,10,10,112,120
"n770015","770015",570,496,74,4,9,42,49,454,395,59,4,5,36,40
"n850108","850108",4860,1942,2918,1883,473,490,941,3788,1657,2131,1378,357,332,684
"n1134076","1134076",9031,641,8390,71,1178,7140,8258,6509,566,5943,63,964,4896,5829
"n4790134","4790134",4450,78,4372,3,11,4360,4365,2937,54,2883,3,5,2876,2881
"n4950202","4950202",943,568,375,6,8,349,356,670,422,248,5,7,226,233
"n2010685","2010685",545,275,270,23,38,204,238,435,242,193,15,29,145,170
"n2570010","2570010",3923,2958,965,34,158,601,744,2946,2311,635,25,126,358,472
"n3030051","3030051",350,152,198,3,11,178,187,252,128,124,3,8,110,116
"n3750427","3750427",2578,413,2165,102,258,1811,2041,1853,351,1502,81,195,1218,1399
"n4394086","4394086",2872,2505,367,39,61,209,266,2400,2121,279,25,35,163,198
"n4530178","4530178",2592,1245,1347,207,393,706,1078,2102,1057,1045,164,322,516,825
"n1213141","1213141",4862,3891,971,358,123,321,441,3698,3054,644,219,81,221,302
"n1391026","1391026",4694,2815,1879,65,433,1265,1652,3668,2290,1378,41,336,901,1207
"n1571004","1571004",5592,2761,2831,1149,418,1177,1561,4126,2164,1962,795,289,800,1072
"n2011017","2011017",819,72,747,16,176,573,727,541,57,484,15,112,364,466
"n2010722","2010722",10266,197,10069,65,4191,5894,9970,7139,159,6980,47,2981,3970,6904
"n2010391","2010391",2445,1420,1025,333,254,420,642,2132,1317,815,278,192,307,483
"n293068","293068",5998,1179,4819,360,766,3743,4390,4610,1061,3549,272,551,2724,3218
"n1132201","1132201",2334,2019,315,105,39,113,146,1734,1538,196,64,19,78,94
"n1134011","1134011",1574,282,1292,31,40,1218,1244,1237,249,988,19,35,922,946
"n1572085","1572085",5332,2142,3190,328,1004,1780,2736,3955,1705,2250,244,692,1244,1916
"n1810206","1810206",3572,2278,1294,207,439,490,906,2855,1946,909,157,298,319,604
"n2150038","2150038",5406,592,4814,81,61,4683,4712,4044,508,3536,64,25,3442,3460
"n3590103","3590103",180,152,28,3,2,21,23,139,119,20,3,2,13,15
"n4230030","4230030",6679,5140,1539,209,482,700,1149,4779,3847,932,137,277,397,664
"n4391481","4391481",1818,152,1666,9,50,1604,1647,1251,137,1114,3,34,1074,1105
"n4392112","4392112",2495,1897,598,69,153,283,428,2014,1604,410,55,104,176,274
"n4630011","4630011",779,319,460,5,11,422,431,581,251,330,1,9,297,305
"n2150121","2150121",185,16,169,3,0,163,163,124,9,115,1,0,111,111
"n2270208","2270208",8,2,6,1,0,6,6,2,0,2,0,0,2,2
"n3090037","3090037",2171,688,1483,26,495,956,1412,1555,579,976,16,311,628,922
"n3210004","3210004",2052,1254,798,5,40,713,743,1594,1024,570,3,29,497,521
"n3390101","3390101",5157,2487,2670,626,514,1436,1911,3651,1863,1788,407,372,929,1280
"n3390025","3390025",3398,2134,1264,85,121,955,1060,2602,1742,860,62,80,634,705
"n50005","50005",3543,1417,2126,52,1030,1000,2013,2631,1214,1417,42,697,638,1327
"n293054","293054",228,71,157,13,22,124,142,206,71,135,11,20,105,123
"n291113","291113",5119,1398,3721,384,817,2574,3286,4117,1234,2883,295,629,1982,2546
"n530010","530010",2158,1705,453,11,25,315,334,1739,1429,310,8,14,208,218
"n850025","850025",5114,2349,2765,1737,545,393,921,3530,1666,1864,1157,385,268,642
"n850062","850062",3438,1982,1456,230,334,768,1083,2786,1724,1062,173,235,540,767
"n4391279","4391279",3740,846,2894,131,1783,995,2720,2778,754,2024,94,1279,645,1890
"n4393665","4393665",21,11,10,1,2,8,10,12,10,2,1,0,2,2
"n4530390","4530390",6080,3922,2158,843,347,848,1161,4314,2915,1399,560,227,539,745
"n2670009","2670009",721,531,190,6,5,163,166,591,452,139,6,4,119,122
"n3030142","3030142",254,145,109,4,10,92,99,210,125,85,2,7,71,75
"n3490204","3490204",390,231,159,4,66,77,140,308,194,114,3,51,49,99
"n3630023","3630023",2836,1937,899,104,120,610,719,2143,1542,601,71,69,385,453
"n3710010","3710010",2287,368,1919,21,197,1692,1880,1825,341,1484,16,188,1274,1458
"n1710012","1710012",3294,2400,894,9,19,790,805,2651,2052,599,4,10,526,534
"n250005","250005",1126,577,549,6,4,506,507,875,493,382,2,1,354,354
"n37006B","37006B",2741,2021,720,130,356,127,475,2119,1620,499,99,233,87,318
"n850137","850137",3068,1524,1544,1047,220,233,448,2338,1262,1076,715,170,163,329
"n930002","930002",2942,1629,1313,17,36,1184,1211,2220,1356,864,11,18,778,793
"n1134109","1134109",131,1,130,0,33,97,130,95,1,94,0,31,63,94
"n1133328","1133328",74,25,49,2,5,39,44,55,24,31,2,2,26,28
"n2990410","2990410",5188,4335,853,62,38,554,580,4278,3647,631,41,21,380,395
"n3290402","3290402",1595,1140,455,24,67,323,376,1184,884,300,21,33,209,235
"n3550061","3550061",1744,61,1683,3,239,1452,1672,1272,44,1228,3,181,1042,1219
"n3870029","3870029",446,336,110,5,52,43,93,398,310,88,5,43,30,73
"n4392453","4392453",4626,1189,3437,558,2096,754,2830,3349,938,2411,382,1468,520,1978
"n4910208","4910208",2713,1806,907,71,111,626,723,1930,1355,575,49,74,374,439
"n1410113","1410113",4255,345,3910,64,160,3717,3838,3297,297,3000,48,122,2841,2940
"n1490425","1490425",3982,2497,1485,26,491,969,1409,3136,2126,1010,23,335,634,947
"n2010963","2010963",2365,313,2052,83,324,1648,1940,1561,249,1312,58,212,1033,1228
"n2010043","2010043",5249,779,4470,303,197,3947,4104,3868,713,3155,255,141,2725,2853
"n2210211","2210211",3205,2387,818,35,60,594,647,2434,1894,540,23,37,392,428
"n2510021","2510021",2538,2008,530,8,56,382,429,2009,1656,353,3,30,246,269
"n292122","292122",4078,874,3204,812,560,1883,2349,3202,777,2425,613,395,1412,1771
"n730028","730028",2210,1230,980,16,562,367,921,1944,1026,918,12,531,345,869
"n1132039","1132039",3794,2907,887,203,109,498,592,3076,2410,666,137,79,380,451
"n1131174","1131174",3571,2361,1210,106,328,687,1000,2859,1986,873,73,249,484,723
"n1134145","1134145",0,0,0,0,0,0,0,0,0,0,0,0,0,0
"n11332A1","11332A1",0,0,0,0,0,0,0,0,0,0,0,0,0,0
"n2950303","2950303",512,376,136,3,2,100,101,399,303,96,2,1,68,68
"n391002B","391002B",341,203,138,3,5,121,122,277,174,103,0,3,92,93
"n4392541","4392541",3886,841,3045,729,1425,912,2286,2817,652,2165,541,985,637,1602
"n4394454","4394454",4941,2657,2284,160,472,1587,2011,3593,2085,1508,105,301,1047,1319
"n4730416","4730416",569,291,278,5,35,230,262,451,250,201,5,27,159,185
"n1214192","1214192",2168,1494,674,17,53,512,557,1624,1181,443,13,43,311,351
"n1350314","1350314",2626,1070,1556,51,297,1198,1448,1949,878,1071,33,198,811,989
"n1574117","1574117",2803,878,1925,552,777,586,1328,1931,650,1281,377,512,381,877
"n2010609","2010609",6832,2167,4665,1465,616,2568,3138,5195,1884,3311,1108,463,1699,2143
"n2090400","2090400",0,0,0,0,0,0,0,0,0,0,0,0,0,0
"n2170011","2170011",1227,854,373,8,59,276,327,950,695,255,8,32,182,214
"n50030","50030",1499,1392,107,3,18,42,59,1167,1094,73,1,10,26,36
"n293117","293117",3836,2169,1667,150,138,1354,1460,3188,1906,1282,114,99,1032,1114
"n292142","292142",1611,311,1300,45,126,1108,1214,1218,258,960,32,87,819,898
"n293123","293123",1827,648,1179,57,81,1021,1092,1249,486,763,35,48,652,696
"n1133039","1133039",3218,49,3169,22,1845,1326,3144,2474,47,2427,15,1607,817,2411
"n1134061","1134061",5707,250,5457,26,115,5315,5398,4175,222,3953,17,85,3846,3911
"n4530107","4530107",4321,2438,1883,646,370,840,1171,3627,2131,1496,506,292,660,924
"n4530115","4530115",1799,226,1573,34,291,1250,1513,1405,219,1186,26,237,911,1133
"n4530343A","4530343A",3671,2398,1273,626,115,484,580,2556,1744,812,385,72,322,384
"n4910116A","4910116A",1869,1299,570,208,87,260,334,1415,1013,402,159,54,169,218
"n2010589","2010589",6011,1552,4459,263,1131,3091,4116,4593,1333,3260,202,809,2257,2992
"n2011086","2011086",7843,4045,3798,233,385,3009,3355,5766,3200,2566,159,248,2032,2261
"n3030041","3030041",3531,2128,1403,21,52,1282,1316,2539,1582,957,7,21,890,908
"n3090087","3090087",4483,1316,3167,25,727,2380,3060,3173,1112,2061,18,457,1534,1970
"n325003E","325003E",181,127,54,0,4,46,46,155,114,41,0,0,35,35
"n3550103","3550103",4640,1528,3112,43,140,2888,2979,3272,1215,2057,27,89,1884,1950
"n1132010","1132010",1738,1330,408,127,36,202,235,1297,1028,269,81,27,139,166
"n1134653","1134653",919,65,854,8,79,763,842,638,49,589,7,66,511,577
"n1133950","1133950",7389,1512,5877,52,2917,2936,5804,5581,1422,4159,33,2149,1962,4107
"n1214214","1214214",3247,2191,1056,381,215,410,610,2459,1710,749,271,145,282,422
"n2010423","2010423",7941,263,7678,82,489,7199,7558,5245,209,5036,68,347,4667,4945
"n2010417","2010417",1989,529,1460,103,271,1091,1336,1504,459,1045,91,206,743,934
"n270202","270202",7647,3298,4349,520,2017,1672,3510,5528,2600,2928,350,1332,1049,2301
"n294059","294059",3602,1325,2277,175,515,1594,2053,2781,1120,1661,128,380,1124,1480
"n293100","293100",5543,2097,3446,330,663,2479,3051,3944,1628,2316,208,410,1656,2027
"n530019","530019",5552,4247,1305,65,104,1005,1086,4416,3569,847,45,60,628,681
"n1810107","1810107",2622,2182,440,26,47,208,242,2074,1786,288,21,29,126,147
"n2010937","2010937",4221,2384,1837,691,360,768,1103,3769,2204,1565,587,300,635,925
"n4910428","4910428",4200,2227,1973,45,404,1455,1813,3078,1780,1298,31,253,949,1189
"n3550081","3550081",4996,3873,1123,155,94,775,842,4156,3312,844,112,59,567,623
"n3650002","3650002",3123,2151,972,38,528,349,866,2341,1709,632,27,357,208,561
"n3670305","3670305",4178,3350,828,53,123,520,637,3058,2548,510,39,73,299,372
"n4391056","4391056",1771,610,1161,23,863,227,1074,1506,587,919,15,672,178,840
"n4530312","4530312",5768,1768,4000,2035,520,1518,1974,5722,1755,3967,2019,516,1501,1957
"n4850410","4850410",598,448,150,22,33,67,98,537,406,131,22,29,54,82
"n2010274","2010274",3704,2308,1396,381,302,676,943,2982,1879,1103,276,243,553,774
"n2010440","2010440",3867,2765,1102,690,36,313,344,2820,2076,744,494,14,193,204
"n2490020","2490020",1135,82,1053,11,14,1023,1028,862,52,810,9,8,789,791
"n3090023","3090023",4177,3380,797,172,155,355,488,3039,2557,482,118,85,201,278
"n3090065","3090065",2040,1553,487,8,101,297,396,1552,1236,316,6,74,176,250
"n3290201","3290201",5690,2162,3528,30,94,3281,3362,4060,1774,2286,13,45,2128,2171
"n10016","10016",1184,911,273,9,128,101,227,915,718,197,8,97,65,161
"n294036","294036",4623,465,4158,29,1754,2457,4110,3427,424,3003,21,1354,1664,2970
"n410077","410077",1375,365,1010,2,53,908,952,946,301,645,2,31,569,592
"n910404","910404",5641,3998,1643,170,129,1212,1327,4147,3038,1109,110,91,806,888
"n1131141","1131141",1961,1228,733,53,410,244,641,1409,917,492,24,291,151,437
"n1391006","1391006",4922,2435,2487,147,985,1206,2149,3391,1794,1597,114,629,730,1355
"n4910395","4910395",283,250,33,15,2,11,13,280,248,32,15,1,11,12
"n2990108","2990108",998,907,91,6,8,32,38,944,861,83,5,8,28,34
"n3090046","3090046",937,160,777,4,209,551,750,616,123,493,1,112,369,477
"n3670110","3670110",2996,2270,726,39,56,478,526,2285,1809,476,27,21,313,330
"n38703-4","38703-4",730,587,143,4,82,47,125,632,510,122,3,75,35,107
"n4394724","4394724",1567,1202,365,37,41,234,269,1146,896,250,24,23,155,177
"n4790273","4790273",3420,121,3299,8,3,3287,3287,2344,79,2265,8,0,2258,2258
"n1410119","1410119",4183,456,3727,78,224,3447,3626,3288,392,2896,64,161,2674,2817
"n1870209","1870209",2137,245,1892,8,192,1692,1855,1594,197,1397,5,146,1234,1368
"n2011129","2011129",0,0,0,0,0,0,0,0,0,0,0,0,0,0
"n2010297","2010297",7293,700,6593,951,1155,4584,5571,5375,596,4779,808,791,3252,3935
"n2070009","2070009",353,310,43,3,11,29,33,279,257,22,2,4,11,15
"n2410011","2410011",605,530,75,1,37,26,63,462,410,52,0,24,20,44
"n50010B","50010B",392,73,319,6,146,157,302,233,49,184,3,95,75,170
"n292165","292165",3887,1463,2424,304,234,1902,2086,2946,1199,1747,222,156,1349,1489
"n1134085","1134085",1924,59,1865,6,57,1806,1851,1438,55,1383,5,42,1335,1372
"n1131105","1131105",154,8,146,2,27,117,139,107,4,103,1,20,81,97
"n1133615","1133615",4132,285,3847,49,3257,570,3781,3123,257,2866,34,2454,385,2811
"n1391029","1391029",1015,529,486,9,51,403,447,774,436,338,9,32,277,308
"n3810429","3810429",5969,4066,1903,130,378,1254,1597,4519,3324,1195,81,208,773,968
"n4391619","4391619",89,1,88,0,19,72,88,45,1,44,0,15,32,44
"n4394620","4394620",545,111,434,10,44,370,412,364,85,279,9,32,233,263
"n4392381","4392381",2012,272,1740,94,1102,591,1640,1489,235,1254,76,777,416,1168
"n4510348","4510348",2465,1379,1086,19,30,957,984,1902,1155,747,12,20,658,677
"n4790154","4790154",10891,253,10638,17,36,10580,10591,6642,135,6507,9,29,6472,6483
"n2011106","2011106",3665,205,3460,83,1452,1934,3330,2685,182,2503,62,921,1509,2401
"n2010566","2010566",8161,1274,6887,965,2651,3360,5849,6440,1112,5328,783,2077,2521,4490
"n2090200","2090200",2,0,2,0,0,1,1,1,0,1,0,0,0,0
"n2230014","2230014",1790,1271,519,28,40,402,438,1361,1011,350,21,19,264,282
"n2350400","2350400",379,310,69,7,4,46,48,309,251,58,6,3,37,38
"n3030013","3030013",1500,731,769,28,201,550,721,1180,647,533,24,122,379,494
"n850180","850180",6710,2528,4182,2147,1052,891,1888,4570,1868,2702,1412,651,571,1202
"n1131085","1131085",3900,217,3683,11,139,3534,3644,2735,185,2550,5,95,2435,2520
"n1134510","1134510",5157,580,4577,265,315,3986,4274,3695,498,3197,213,203,2767,2954
"n1133114","1133114",0,0,0,0,0,0,0,0,0,0,0,0,0,0
"n1132121","1132121",3934,291,3643,85,2774,807,3529,2954,264,2690,70,2069,556,2595
"n1213130","1213130",13057,2989,10068,1386,1692,6900,8473,9203,2554,6649,883,1173,4469,5585
"n3550018","3550018",6027,3133,2894,242,406,2069,2401,4703,2603,2100,179,283,1450,1695
"n3690201","3690201",1888,304,1584,3,25,1554,1572,1315,237,1078,3,19,1055,1071
"n4050009","4050009",1145,1048,97,6,25,25,49,956,885,71,3,16,19,34
"n4391090","4391090",4101,228,3873,133,2145,1614,3730,2601,162,2439,75,1379,975,2345
"n4930205","4930205",4231,2575,1656,20,41,1544,1566,3257,2097,1160,12,33,1067,1086
"n1391049","1391049",910,585,325,7,60,230,283,696,491,205,4,39,136,172
"n1430035","1430035",398,215,183,0,68,106,172,385,208,177,0,64,104,166
"n2470005","2470005",3,0,3,0,0,3,3,2,0,2,0,0,2,2
"n2810003","2810003",3942,2398,1544,54,120,1260,1356,3028,1935,1093,39,73,891,947
"n3090003","3090003",10963,6358,4605,1487,1234,1798,2932,10060,5976,4084,1383,1020,1569,2521
"n3370007","3370007",1309,1130,179,1,5,102,107,1038,909,129,1,3,62,65
"n270408","270408",9094,2112,6982,775,3884,2386,5947,6234,1639,4595,530,2471,1521,3844
"n293184","293184",623,185,438,9,13,420,430,478,163,315,4,8,303,309
"n410096","410096",11,7,4,0,1,3,4,8,7,1,0,0,1,1
"n1132612","1132612",1705,204,1501,1063,223,195,406,1317,180,1137,796,184,140,320
"n1133013","1133013",3396,526,2870,8,618,2214,2796,2276,431,1845,5,421,1377,1781
"n1150013","1150013",234,179,55,0,4,53,54,168,137,31,0,3,29,30
"n4910263","4910263",5147,2919,2228,483,377,1258,1608,3673,2215,1458,333,232,805,1029
"n3150008","3150008",1031,799,232,12,176,23,195,874,706,168,9,125,17,140
"n323002C","323002C",6627,82,6545,21,20,5791,5801,4401,63,4338,13,13,3862,3867
"n3550123","3550123",3282,1299,1983,34,88,1839,1895,2403,1028,1375,17,49,1265,1305
"n3610021","3610021",359,283,76,2,2,52,54,281,226,55,2,1,42,43
"n4393706","4393706",4967,2792,2175,543,619,921,1504,4395,2603,1792,464,494,739,1206
"n4530412","4530412",3239,1710,1529,151,308,1024,1305,2602,1525,1077,112,201,726,910
"n1211024","1211024",6057,3198,2859,1835,372,538,899,3936,2191,1745,1105,245,325,565
"n1870115","1870115",451,316,135,2,4,118,120,332,230,102,2,3,85,87
"n2010900","2010900",30,6,24,0,1,23,24,21,6,15,0,0,15,15
"n2010354","2010354",8046,778,7268,270,3346,3714,6944,5929,679,5250,216,2440,2595,4977
"n2150064","2150064",9927,100,9827,23,25,9774,9785,6349,64,6285,18,14,6250,6258
"n2570022","2570022",1803,1399,404,27,57,260,308,1366,1098,268,17,42,162,196
"n292023","292023",3841,326,3515,34,85,3404,3458,2976,309,2667,19,60,2578,2620
"n291099","291099",4202,869,3333,252,524,2556,3019,3319,740,2579,189,398,1948,2322
"n292181D","292181D",500,119,381,53,88,246,321,294,87,207,32,34,145,174
"n293080","293080",1624,794,830,65,65,686,740,1347,687,660,44,51,539,584
"n610019","610019",4132,193,3939,23,37,3898,3914,2657,151,2506,14,13,2480,2487
"n850051","850051",3696,985,2711,212,418,2053,2443,2840,876,1964,190,302,1447,1733
"n4790252","4790252",5181,103,5078,8,21,5053,5063,3601,80,3521,5,11,3505,3512
"n4850211","4850211",117,36,81,8,11,61,71,83,26,57,7,3,45,48
"n2150207","2150207",3984,442,3542,153,38,3335,3360,2915,351,2564,127,30,2389,2413
"n2410005","2410005",173,137,36,3,17,9,26,151,122,29,3,15,4,19
"n4391547","4391547",0,0,0,0,0,0,0,0,0,0,0,0,0,0
"n4393043","4393043",5340,3733,1607,161,405,895,1258,3571,2593,978,96,238,547,772
"n4530491B","4530491B",0,0,0,0,0,0,0,0,0,0,0,0,0,0
"n4650021","4650021",3167,52,3115,1,28,3097,3106,2214,45,2169,0,10,2166,2169
"n1572116","1572116",2847,71,2776,22,2293,505,2742,2192,60,2132,18,1799,329,2102
"n1674191","1674191",0,0,0,0,0,0,0,0,0,0,0,0,0,0
"n2010460","2010460",9564,750,8814,531,2763,5578,8209,6869,627,6242,401,2053,3789,5781
"n2010794","2010794",2548,133,2415,39,1084,1316,2351,1699,107,1592,37,728,835,1541
"n2010546","2010546",3016,2517,499,124,57,247,295,2232,1906,326,81,44,156,191
"n2010708","2010708",1807,139,1668,9,80,1572,1645,1261,115,1146,7,46,1084,1125
"n294228","294228",964,547,417,59,50,299,347,871,522,349,51,39,249,286
"n370019","370019",1024,885,139,21,34,19,51,832,723,109,14,25,12,35
"n790303","790303",91,51,40,0,1,38,38,69,40,29,0,0,27,27
"n1134039","1134039",1710,41,1669,14,397,1278,1655,1201,33,1168,8,330,841,1160
"n1134000","1134000",1998,195,1803,111,331,1352,1671,1455,179,1276,106,237,927,1155
"n1573155","1573155",5464,508,4956,2550,1006,1394,2375,4069,384,3685,1970,734,960,1680
"n3450001","3450001",271,223,48,3,4,37,39,202,169,33,1,3,23,25
"n4392026","4392026",3059,1850,1209,77,250,828,1071,2476,1620,856,51,188,567,751
"n4410204","4410204",3430,2127,1303,131,323,764,1071,2651,1747,904,106,199,520,711
"n4474005","4474005",117,104,13,1,3,8,9,94,88,6,1,1,3,4
"n2010105","2010105",6232,322,5910,43,169,5704,5841,4454,275,4179,37,128,4022,4128
"n2011149","2011149",5720,2099,3621,411,1573,1653,3127,3945,1529,2416,285,1080,1016,2063
"n2010068","2010068",5952,162,5790,36,4970,848,5715,4253,122,4131,25,3586,547,4073
"n2030021","2030021",988,643,345,9,219,98,314,794,521,273,4,189,62,248
"n2310105","2310105",1843,829,1014,15,205,762,957,1265,648,617,8,122,464,581
"n3390090","3390090",5513,4431,1082,110,150,663,805,3813,3138,675,63,109,401,507
"n410034","410034",5339,2530,2809,960,710,1132,1798,4432,2194,2238,827,493,873,1346
"n610062","610062",5095,245,4850,33,32,4800,4810,3846,199,3647,24,28,3605,3614
"n850094","850094",5778,2561,3217,2321,443,388,804,4293,2002,2291,1662,310,270,563
"n97004C","97004C",4504,2687,1817,100,345,1220,1542,3325,2205,1120,75,226,690,908
"n1410076","1410076",2031,135,1896,24,37,1845,1871,1680,116,1564,21,30,1517,1541
"n1571156","1571156",3252,2270,982,293,169,420,572,2404,1754,650,210,106,276,377
"n4210201","4210201",504,151,353,1,8,339,345,344,116,228,0,4,218,220
"n4394138","4394138",2734,773,1961,25,51,1850,1887,1943,661,1282,16,27,1206,1226
"n4391407","4391407",79,32,47,2,9,29,38,73,32,41,2,9,23,32
"n4392636","4392636",4997,2557,2440,211,1023,1120,2092,3693,2108,1585,136,633,751,1358
"n1670356","1670356",4821,3724,1097,271,131,562,673,3594,2851,743,188,87,368,447
"n1870414","1870414",6243,2797,3446,309,1300,1841,3019,4301,2086,2215,194,807,1167,1927
"n2150250","2150250",753,21,732,4,6,723,723,464,14,450,4,4,443,443
"n2150001","2150001",2664,61,2603,5,5,2599,2601,1699,43,1656,2,0,1654,1654
"n2450023","2450023",2939,676,2263,36,1882,340,2187,2307,610,1697,28,1440,208,1636
"n2650312","2650312",5547,3009,2538,93,198,2140,2286,4393,2588,1805,67,146,1484,1600
"n490212","490212",985,816,169,0,17,125,140,806,686,120,0,8,89,97
"n490308","490308",715,617,98,5,5,55,60,572,509,63,2,1,30,31
"n850243","850243",1886,1290,596,277,96,187,278,1319,924,395,184,69,115,180
"n850237","850237",3812,1513,2299,841,755,618,1348,2565,1054,1511,564,514,378,882
"n1410176","1410176",1458,340,1118,36,47,1029,1062,1132,286,846,27,33,780,806
"n1410182","1410182",8096,1345,6751,199,803,5754,6429,5828,1175,4653,160,528,3917,4399
"n4393552","4393552",6224,2966,3258,810,1109,1245,2285,4294,2170,2124,557,675,794,1435
"n4910368","4910368",6989,3099,3890,208,531,3132,3575,5159,2549,2610,134,342,2094,2403
"n2510041","2510041",6397,4944,1453,110,319,854,1161,4678,3717,961,69,209,537,735
"n2510035","2510035",6303,4581,1722,77,159,1271,1423,4955,3744,1211,51,117,864,977
"n3650010","3650010",410,252,158,3,119,30,143,333,212,121,2,94,15,108
"n4310001A","4310001A",269,200,69,6,2,51,52,217,177,40,2,0,28,28
"n4310002E","4310002E",58,19,39,1,2,38,39,35,10,25,0,1,24,25
"n4391071","4391071",5742,2138,3604,258,2181,1171,3268,4801,1991,2810,220,1656,918,2518
"n1830003","1830003",3601,2271,1330,76,693,472,1156,2979,2008,971,55,517,327,842
"n1830009","1830009",5863,3774,2089,174,1172,643,1777,4792,3265,1527,138,853,441,1274
"n2010943","2010943",3015,79,2936,161,715,2097,2743,2081,70,2011,133,484,1407,1851
"n2150150","2150150",3817,363,3454,117,35,3306,3320,2880,330,2550,91,24,2429,2441
"n2150107","2150107",4575,260,4315,43,39,4216,4240,3313,210,3103,32,29,3016,3034
"n2150101","2150101",1145,134,1011,38,12,971,979,841,108,733,32,7,695,702
"n130006","130006",712,258,454,6,15,432,439,514,211,303,4,9,285,288
"n294122","294122",119,56,63,1,3,55,56,92,48,44,1,2,39,40
"n390069","390069",4179,858,3321,1483,1207,651,1806,2785,604,2181,986,810,383,1155
"n1110006","1110006",1014,450,564,4,21,522,542,710,347,363,2,14,336,349
"n1132074","1132074",1914,612,1302,666,368,253,606,1597,562,1035,489,316,213,517
"n1214172","1214172",3892,1996,1896,446,690,743,1395,3730,1930,1800,430,659,694,1316
"n3030118","3030118",3056,1272,1784,61,344,1357,1676,2284,1103,1181,26,228,886,1111
"n3750221","3750221",5326,888,4438,230,398,3845,4158,3700,787,2913,144,230,2547,2739
"n411003B","411003B",588,286,302,7,2,282,284,416,226,190,2,0,176,176
"n4394340","4394340",3716,3011,705,41,62,481,530,2962,2465,497,28,35,325,355
"n4530160","4530160",4899,1532,3367,363,1261,1759,2926,3455,1208,2247,255,830,1142,1918
"n4970025","4970025",1649,1208,441,18,25,323,348,1235,955,280,9,13,196,209
"n1410033","1410033",2334,713,1621,75,47,1497,1526,1899,622,1277,56,26,1177,1191
"n1930009","1930009",255,228,27,2,2,19,19,201,188,13,2,1,7,7
"n2010211","2010211",8809,551,8258,774,477,6994,7427,6440,500,5940,622,397,4888,5266
"n2011043","2011043",3548,2113,1435,138,287,952,1225,2691,1695,996,106,188,655,830
"n2090448","2090448",2520,2027,493,48,38,340,372,1862,1544,318,31,23,214,233
"n2750301","2750301",769,374,395,6,71,314,367,588,318,270,2,45,201,246
"n294222","294222",396,292,104,12,14,75,85,300,232,68,11,8,47,51
"n292079","292079",1633,49,1584,25,50,1522,1556,1049,33,1016,9,27,981,1001
"n292128","292128",5421,233,5188,65,218,4936,5090,3715,181,3534,48,154,3340,3461
"n370024","370024",732,638,94,3,29,50,78,569,512,57,1,16,29,45
"n730022","730022",1135,702,433,6,230,159,386,865,560,305,4,149,112,260
"n810004A","810004A",778,589,189,4,2,174,174,611,471,140,0,1,126,126
"n397003C","397003C",4230,3505,725,134,136,310,430,3060,2575,485,102,80,204,275
"n4392263","4392263",6776,1030,5746,241,566,4876,5388,4653,873,3780,187,336,3190,3512
"n4490005","4490005",367,321,46,0,6,28,33,279,248,31,0,4,17,21
"n475001E","475001E",2636,639,1997,28,259,1730,1959,1864,494,1370,21,161,1193,1344
"n2010652","2010652",4352,166,4186,735,2382,1100,3429,3480,157,3323,630,1894,816,2670
"n2010111","2010111",5606,2308,3298,679,1070,1542,2543,3857,1666,2191,467,697,992,1659
"n2050101","2050101",612,351,261,5,13,236,247,416,262,154,2,11,140,149
"n2310111","2310111",1382,844,538,42,207,249,449,1031,679,352,28,136,154,288
"n2970003","2970003",1650,555,1095,9,18,1054,1067,1277,457,820,5,13,784,793
"n3470012","3470012",2969,2318,651,37,192,335,521,2317,1861,456,23,145,213,352
"n1134047","1134047",1914,13,1901,4,722,1198,1894,1309,11,1298,0,565,743,1296
"n1131168","1131168",3880,3161,719,201,70,350,408,2956,2514,442,115,50,226,267
"n1133971","1133971",5182,2407,2775,325,1039,1333,2331,4073,2058,2015,262,745,931,1653
"n1131706","1131706",8680,1027,7653,1213,631,5812,6405,6257,870,5387,954,433,4003,4411
"n1350406","1350406",6899,985,5914,32,428,5486,5838,4923,786,4137,24,292,3834,4085
"n1574163","1574163",2118,328,1790,810,638,325,956,1591,244,1347,632,468,231,693
"n292140","292140",3468,553,2915,189,544,2204,2687,2526,465,2061,140,369,1540,1885
"n610077","610077",5739,98,5641,11,17,5625,5627,4104,67,4037,6,13,4025,4026
"n1132502","1132502",2460,2073,387,149,32,158,185,1723,1475,248,104,14,90,102
"n2010080","2010080",5822,524,5298,41,1487,3813,5226,4348,452,3896,31,1183,2697,3843
"n292055","292055",3116,1865,1251,299,148,785,920,2946,1780,1166,283,139,720,850
"n3550033","3550033",2579,863,1716,30,170,1475,1632,2233,831,1402,23,127,1206,1328
"n1410005","1410005",6611,643,5968,111,155,5738,5840,4683,497,4186,83,89,4018,4089
"n2011015","2011015",0,0,0,0,0,0,0,0,0,0,0,0,0,0
"n570010","570010",1938,1326,612,78,16,473,485,1553,1100,453,62,14,340,351
"n3510022","3510022",588,293,295,1,269,13,282,468,219,249,0,231,9,240
"n4391652","4391652",800,27,773,18,683,78,754,419,16,403,7,351,45,396
"n2510011","2510011",5402,4176,1226,75,116,808,917,4238,3396,842,52,70,538,606
"n2550006","2550006",243,221,22,0,2,16,18,189,176,13,0,1,10,11
"n1132155","1132155",2997,2122,875,157,195,457,634,2226,1611,615,110,140,311,443
"n1133048","1133048",3755,121,3634,18,2510,1132,3603,2840,113,2727,9,2019,715,2713
"n2011058","2011058",496,90,406,47,202,168,361,389,80,309,41,156,117,269
"n610034","610034",2884,655,2229,22,15,2174,2183,2209,590,1619,19,13,1570,1579
"n4770121","4770121",133,69,64,3,22,34,53,108,65,43,0,18,19,34
"n2690001","2690001",64,55,9,1,1,6,7,54,47,7,0,0,5,5
"n690307","690307",438,143,295,2,5,287,290,319,119,200,2,4,193,196
"n293009","293009",29,9,20,4,0,16,16,18,9,9,1,0,8,8
"n292097","292097",4187,1004,3183,80,334,2790,3070,3118,836,2282,52,229,1990,2196
"n2011161","2011161",0,0,0,0,0,0,0,0,0,0,0,0,0,0
"n3030036","3030036",3598,1916,1682,7,156,1453,1582,2709,1560,1149,4,97,983,1072
"n2010418","2010418",10152,1010,9142,1383,2672,5119,7684,7289,866,6423,1079,1792,3533,5282
"n293199","293199",5392,2359,3033,589,441,1957,2353,3883,1772,2111,395,315,1329,1624
"n2010269","2010269",2987,2243,744,201,162,333,481,2612,2002,610,165,132,261,386
"n1133208","1133208",4425,719,3706,73,1160,2461,3591,3219,667,2552,55,835,1642,2465
"n4910151","4910151",7371,4107,3264,931,679,1576,2164,5920,3470,2450,747,474,1143,1568
"n3810421","3810421",6879,4446,2433,87,572,1619,2137,5421,3724,1697,55,368,1109,1468
"n2070007","2070007",165,108,57,0,4,49,52,144,102,42,0,4,35,38
"n4790422","4790422",1004,34,970,3,8,966,968,775,27,748,1,7,744,746
"n1410194","1410194",5537,1334,4203,320,933,3067,3791,3658,962,2696,194,579,1937,2429
"n4394045","4394045",3455,2726,729,92,82,450,519,2710,2233,477,57,53,282,329
"n277003G","277003G",741,679,62,4,11,15,25,583,548,35,3,2,7,9
"n2010226","2010226",6689,197,6492,172,211,6144,6315,4940,175,4765,143,157,4481,4617
"n1573035","1573035",2812,760,2052,1380,246,412,651,2198,601,1597,1094,186,298,479
"n850112","850112",3974,2343,1631,1175,154,256,403,3084,1868,1216,917,103,165,264
"n1430033","1430033",1998,1386,612,41,70,405,465,1640,1185,455,34,50,286,331
"n2090445","2090445",2999,2433,566,148,41,311,350,2279,1910,369,99,28,188,216
"n3750125","3750125",5729,3627,2102,131,434,1349,1734,4596,3117,1479,77,295,931,1210
"n850006","850006",2409,1008,1401,698,395,279,663,1686,712,974,494,265,188,450
"n2010355","2010355",3236,205,3031,169,1972,943,2855,2352,173,2179,111,1473,617,2056
"n292157","292157",0,0,0,0,0,0,0,0,0,0,0,0,0,0
"n2950308","2950308",237,182,55,2,1,46,46,188,151,37,1,1,30,30
"n1571005","1571005",2084,1445,639,85,185,327,497,1612,1176,436,49,132,209,332
"n850069","850069",5071,2984,2087,1106,398,470,853,4024,2542,1482,800,259,329,582
"n4710206","4710206",1473,1000,473,59,185,172,348,1209,854,355,43,143,120,257
"n1571148B","1571148B",0,0,0,0,0,0,0,0,0,0,0,0,0,0
"n2132PSS","2132PSS",3916,3333,583,34,106,270,372,3240,2821,419,17,65,179,244
"n293156","293156",7,0,7,0,0,7,7,0,0,0,0,0,0,0
"n1134015","1134015",2408,653,1755,55,740,938,1667,2033,610,1423,45,664,681,1344
"n1410108","1410108",2860,478,2382,70,128,2208,2306,2282,448,1834,57,101,1679,1765
"n4850408","4850408",1666,1249,417,13,115,234,345,1291,1025,266,3,70,142,210
"n2010972","2010972",3958,2796,1162,456,152,485,623,2773,2030,743,298,105,285,387
"n1133106","1133106",6100,751,5349,85,3604,1712,5212,4310,634,3676,62,2507,1137,3579
"n3670250","3670250",1724,1456,268,23,27,151,174,1357,1176,181,5,13,110,121
"n2870402","2870402",189,75,114,0,99,8,104,167,69,98,0,89,3,92
"n1134040","1134040",1358,26,1332,7,535,798,1326,1004,24,980,4,455,521,974
"n1410171","1410171",5773,93,5680,18,37,5630,5647,3998,53,3945,10,22,3909,3920
"n2010038","2010038",4049,2717,1332,447,149,653,785,3555,2461,1094,351,110,551,653
"n2010332","2010332",7939,234,7705,346,1964,5453,7336,5782,183,5599,275,1443,3900,5298
"n4392697","4392697",5935,2211,3724,384,2363,920,3214,4254,1694,2560,263,1634,585,2190
"n2010203","2010203",2487,168,2319,17,494,1806,2288,1825,147,1678,12,359,1302,1651
"n4393530","4393530",3928,2697,1231,624,119,394,511,2965,2137,828,408,83,263,345
"n293095","293095",5519,1810,3709,720,708,2267,2913,4747,1591,3156,621,574,1919,2469
"n2090344","2090344",4103,3322,781,58,54,525,573,3244,2699,545,49,32,347,376
"n3630005","3630005",633,410,223,5,10,196,204,513,352,161,3,6,143,149
"n291153","291153",2097,561,1536,126,314,1125,1390,1342,406,936,59,196,673,849
"n293098","293098",1756,835,921,143,62,730,771,1309,672,637,104,38,500,527
"n750101","750101",2509,1082,1427,31,418,943,1356,2145,906,1239,20,409,779,1186
"n4910257","4910257",6667,3948,2719,418,590,1599,2131,4758,2982,1776,291,382,990,1348
"n3910002","3910002",1084,683,401,5,28,361,380,851,556,295,4,19,261,277
"n1410111","1410111",2821,159,2662,34,47,2590,2623,2073,121,1952,18,35,1899,1921
"n1133211","1133211",3180,438,2742,35,309,2393,2679,2162,377,1785,22,212,1542,1743
"n4393249","4393249",6085,3019,3066,755,1098,1069,2122,4869,2601,2268,591,759,786,1527
"n2010246","2010246",7505,2808,4697,1060,1605,2023,3545,5699,2278,3421,823,1151,1393,2501
"n2011121","2011121",2494,90,2404,26,401,2021,2375,1644,54,1590,23,298,1306,1566
"n710018","710018",2703,2014,689,86,103,423,516,1769,1366,403,53,56,229,284
"n1574124","1574124",8082,2428,5654,3008,1364,1259,2579,6387,2016,4371,2202,1124,1021,2117
"n2011078","2011078",4008,1356,2652,441,613,1609,2180,2921,1042,1879,301,429,1136,1538
"n2010289","2010289",3790,387,3403,56,109,3276,3334,2743,340,2403,37,63,2317,2354
"n293072","293072",6720,3045,3675,604,554,2519,2987,4637,2190,2447,402,365,1634,1962
"n4910344","4910344",2097,1556,541,131,116,277,375,1797,1364,433,113,93,201,285
"n4690006","4690006",883,117,766,27,157,600,739,711,90,621,25,141,466,595
"n4790342","4790342",4189,220,3969,60,35,3867,3897,3081,175,2906,46,26,2825,2850
"n4392712","4392712",4633,1957,2676,689,1224,725,1910,3319,1474,1845,471,851,458,1298
"n2150102","2150102",1560,829,731,12,5,697,699,1427,828,599,10,2,567,569
"n3550053","3550053",1423,151,1272,9,53,1232,1263,1088,129,959,3,34,926,951
"n292117","292117",1647,71,1576,5,37,1540,1573,1080,59,1021,2,30,990,1018
"n1133807","1133807",3643,371,3272,25,2594,676,3217,2756,333,2423,16,1936,477,2383
"n3730004","3730004",6717,3175,3542,99,1652,1701,3325,5984,2762,3222,84,1571,1494,3044
"n277004D","277004D",2129,1820,309,16,67,126,188,1609,1416,193,8,51,71,121
"n850049","850049",2794,2106,688,203,139,271,399,2301,1800,501,153,93,191,280
"n1132601","1132601",6192,1064,5128,3686,800,555,1335,4539,958,3581,2414,643,436,1073
"n2730035","2730035",1746,348,1398,6,8,1380,1382,1310,301,1009,2,1,1000,1001
"n1410154","1410154",3399,56,3343,21,34,3308,3327,2611,32,2579,16,28,2551,2567
"n293052","293052",2464,901,1563,369,279,942,1186,1754,705,1049,234,174,646,804
"n4690026","4690026",1219,687,532,10,43,457,489,897,566,331,7,26,284,304
"n2090254","2090254",3348,1404,1944,181,218,1548,1733,2498,1149,1349,131,147,1063,1195
"n2150019","2150019",285,55,230,2,2,226,228,221,37,184,1,2,181,183
"n1572050","1572050",3854,94,3760,64,3133,623,3693,3017,79,2938,46,2484,441,2884
"n3670450","3670450",3331,2639,692,45,46,463,508,2514,2088,426,26,31,269,300
"n2010120","2010120",5114,1481,3633,511,426,2666,3056,3864,1296,2568,429,342,1756,2077
"n1132806","1132806",4463,2135,2328,1334,323,603,907,3211,1670,1541,875,208,400,601
"n1133091","1133091",0,0,0,0,0,0,0,0,0,0,0,0,0,0
"n4730314","4730314",2525,659,1866,74,144,1631,1763,1853,526,1327,64,98,1138,1235
"n4392299","4392299",3164,443,2721,1101,1107,524,1608,2259,341,1918,793,778,339,1106
"n3610019","3610019",2955,2597,358,26,33,228,257,2311,2059,252,20,16,152,168
"n1490422","1490422",901,783,118,1,17,95,106,711,640,71,0,6,59,65
"n850155","850155",4172,2491,1681,571,586,445,1013,2937,1784,1153,387,398,302,691
"n4393709","4393709",2285,1429,856,217,177,432,585,1560,1033,527,139,111,246,349
"n850092","850092",6619,3034,3585,494,1037,1945,2933,5244,2669,2575,379,750,1332,2054
"n2594050","2594050",4001,2273,1728,25,38,1512,1543,3240,2002,1238,20,30,1063,1090
"n1410215","1410215",8381,527,7854,76,272,7576,7751,5367,389,4978,45,174,4771,4908
"n4392521","4392521",2054,1142,912,148,291,429,701,1572,931,641,103,196,286,478
"n3670100","3670100",5395,4395,1000,71,92,653,734,4264,3551,713,51,58,446,503
"n213001M","213001M",3575,2250,1325,36,566,628,1188,2767,1862,905,27,398,404,800
"n3770001","3770001",601,145,456,5,5,438,443,483,122,361,4,2,346,348
"n4790250C","4790250C",140,1,139,2,1,136,137,94,0,94,2,1,91,92
"n1573092","1573092",1169,354,815,49,457,320,759,904,303,601,38,350,210,558
"n292137","292137",1983,499,1484,79,165,1268,1388,1600,465,1135,62,101,971,1054
"n850037","850037",3967,2831,1136,46,72,852,919,2900,2205,695,20,35,517,549
"n2010217","2010217",3591,2511,1080,460,140,436,565,2814,2076,738,265,100,342,436
"n294005","294005",2812,389,2423,58,307,2081,2330,2150,333,1817,46,212,1548,1733
"n730034","730034",2200,1932,268,32,43,138,178,1639,1463,176,21,27,89,115
"n2010429","2010429",9533,541,8992,1091,2923,4999,7753,6763,439,6324,954,2122,3221,5260
"n4393131","4393131",3106,1854,1252,90,328,752,1053,2463,1592,871,68,206,510,711
"n1134074","1134074",4079,1482,2597,79,352,2114,2445,3260,1276,1984,55,305,1564,1857
"n2090425","2090425",1011,714,297,15,3,256,257,802,586,216,10,1,182,183
"n3030049","3030049",381,59,322,96,195,16,211,375,59,316,96,190,15,205
"n870101","870101",663,537,126,2,17,101,116,490,419,71,2,7,58,65
"n4790404","4790404",3737,61,3676,2,9,3673,3673,2554,38,2516,2,9,2513,2513
"n2810009","2810009",2474,1766,708,89,163,353,500,1956,1465,491,59,114,226,331
"n3090012","3090012",6024,519,5505,20,4573,955,5410,4163,445,3718,13,3178,521,3655
"n293086","293086",2227,1256,971,106,87,765,840,1790,1041,749,72,61,597,654
"n1573172","1573172",3264,516,2748,621,551,1592,2110,2490,439,2051,508,396,1150,1526
"n3090054","3090054",4017,2573,1444,125,524,724,1211,2776,1889,887,86,310,421,714
"n294091","294091",1621,612,1009,122,147,736,847,1337,559,778,99,102,559,644
"n1134617","1134617",336,95,241,27,23,189,207,254,95,159,18,13,123,134
"n2010303","2010303",4849,3652,1197,442,216,453,657,3965,3011,954,339,179,351,524
"n4790218","4790218",4304,103,4201,22,22,4163,4169,3059,83,2976,17,14,2944,2949
"n2150070","2150070",5212,105,5107,9,16,5079,5085,3505,73,3432,4,8,3411,3414
"n11331A5","11331A5",0,0,0,0,0,0,0,0,0,0,0,0,0,0
"n294174","294174",2563,589,1974,83,298,1613,1861,1906,494,1412,64,224,1121,1316
"n1134122","1134122",0,0,0,0,0,0,0,0,0,0,0,0,0,0
"n1410142","1410142",1781,56,1725,12,20,1707,1712,1405,50,1355,10,11,1344,1346
"n1571130","1571130",8417,3911,4506,1757,610,2048,2620,6063,2889,3174,1213,421,1460,1863
"n2010598","2010598",6808,849,5959,337,1523,4118,5559,4679,656,4023,241,990,2765,3715
"n2150116","2150116",4589,482,4107,66,46,4012,4034,3368,419,2949,56,24,2865,2886
"n3670335","3670335",5483,4807,676,43,60,391,445,3812,3362,450,29,42,238,280
"n2010091","2010091",4131,2206,1925,441,604,872,1419,3417,1903,1514,351,446,677,1099
"n4392657","4392657",102,22,80,2,55,20,74,80,21,59,1,46,11,56
"n1430011","1430011",1098,730,368,7,36,290,322,881,608,273,4,29,205,231
"n4394373","4394373",411,294,117,9,1,83,84,336,257,79,8,0,51,51
"n293066","293066",2542,1057,1485,48,116,1334,1402,2064,955,1109,32,79,997,1043
"n850126","850126",7019,3955,3064,923,1055,944,1955,4995,2922,2073,649,685,631,1298
"n4790462","4790462",957,30,927,2,6,921,924,714,26,688,0,4,685,687
"n3710001","3710001",4564,1137,3427,80,302,3029,3300,3649,1031,2618,61,271,2261,2524
"n3850001","3850001",718,540,178,7,8,154,161,592,473,119,1,3,105,108
"n3190101","3190101",1000,779,221,5,13,182,189,798,643,155,1,7,127,128
"n3730018","3730018",2086,935,1151,17,606,450,1054,1554,760,794,13,446,276,720
"n293023","293023",88,59,29,2,1,23,24,65,50,15,0,1,11,12
"n1133100","1133100",3462,542,2920,71,2067,815,2831,2530,474,2056,57,1467,532,1982
"n293129","293129",4489,1455,3034,405,240,2408,2610,3539,1231,2308,320,185,1799,1959
"n3890006","3890006",307,104,203,3,2,193,195,231,81,150,3,2,140,142
"n4394587","4394587",564,8,556,3,184,367,551,407,8,399,1,139,257,396
"n293190","293190",802,242,560,108,67,379,438,641,203,438,72,59,294,350
"n1572009","1572009",4094,2486,1608,836,284,435,710,3496,2201,1295,729,210,318,522
"n850206","850206",3014,1873,1141,410,299,361,651,2061,1365,696,261,195,192,386
"n1133601","1133601",2384,472,1912,48,1589,277,1839,1970,416,1554,46,1301,199,1487
"n4910138","4910138",2908,963,1945,331,769,863,1581,2398,871,1527,291,581,652,1207
"n1134006","1134006",1853,936,917,65,83,735,810,1434,768,666,53,60,531,587
"n2110201","2110201",802,505,297,9,7,258,262,544,382,162,3,3,149,152
"n2630302","2630302",46,45,1,0,0,1,1,39,38,1,0,0,1,1
"n2010260","2010260",2900,641,2259,1131,353,746,1078,2221,533,1688,862,260,529,780
"n2010555","2010555",7019,321,6698,244,2546,4073,6407,4961,271,4690,209,1873,2718,4458
"n4410306","4410306",6507,4868,1639,322,323,879,1176,4838,3786,1052,222,177,564,728
"n294048","294048",3507,295,3212,59,93,3082,3147,2681,247,2434,49,52,2336,2372
"n2010197","2010197",4162,50,4112,50,2702,1368,4038,3138,47,3091,39,2100,965,3035
"n670019","670019",706,589,117,9,34,30,63,539,449,90,5,22,24,45
"n1134674","1134674",0,0,0,0,0,0,0,0,0,0,0,0,0,0
"n2010492","2010492",5873,1778,4095,378,2123,1670,3663,4311,1457,2854,297,1408,1193,2512
"n4393387","4393387",2738,2182,556,74,75,325,382,2141,1765,376,60,41,213,247
"n2090217","2090217",80,19,61,1,13,44,57,62,16,46,0,10,36,46
"n4970010","4970010",812,657,155,4,6,121,125,616,513,103,3,2,77,79
"n2150193","2150193",1135,62,1073,34,9,1027,1035,777,38,739,27,8,699,707
"n910208B","910208B",93,52,41,6,9,25,34,69,44,25,4,6,15,21
"n4394736","4394736",2695,2167,528,42,70,306,371,1990,1654,336,29,40,185,222
"n1630010","1630010",3817,621,3196,31,519,2607,3119,2827,532,2295,17,472,1798,2265
"n4430004B","4430004B",43,31,12,0,2,10,12,35,24,11,0,2,9,11
"n3090049","3090049",1076,309,767,12,167,597,739,742,262,480,9,101,358,456
"n4090116","4090116",4923,3060,1863,313,124,1348,1448,3711,2427,1284,206,99,900,983
"n2010549","2010549",5612,194,5418,335,1836,3296,5071,4158,158,4000,285,1434,2327,3716
"n4030003","4030003",875,559,316,2,246,50,286,630,407,223,2,175,28,197
"n3090090","3090090",705,375,330,7,85,225,307,561,326,235,5,64,153,216
"n321001D","321001D",3453,746,2707,24,376,2312,2644,2500,621,1879,17,262,1589,1833
"n294168","294168",4164,805,3359,149,1213,2106,3193,2919,653,2266,98,818,1379,2139
"n2010592","2010592",5925,547,5378,712,960,3710,4616,4216,460,3756,540,694,2504,3171
"n4910437","4910437",8323,4250,4073,1574,871,1528,2334,5910,3179,2731,1062,569,982,1524
"n4510215","4510215",4095,2487,1608,152,219,1144,1321,3099,2012,1087,99,134,768,886
"n1134662","1134662",918,147,771,23,31,708,736,654,126,528,21,16,482,497
"n2010635","2010635",5500,3546,1954,187,371,1284,1621,4062,2775,1287,146,224,830,1044
"n1211013","1211013",4419,2778,1641,132,615,712,1294,2834,1891,943,65,333,415,729
"n294211","294211",43,21,22,8,1,13,14,40,19,21,8,1,12,13
"n4190004","4190004",1031,779,252,4,191,48,234,837,650,187,0,151,25,173
"n50016","50016",4402,1294,3108,23,1014,2055,3043,3315,1089,2226,13,765,1426,2186
"n1670227","1670227",5227,3970,1257,60,104,938,1033,3967,3115,852,41,70,609,677
"n5030016","5030016",775,681,94,5,9,51,59,617,557,60,2,7,34,40
"n970003","970003",853,736,117,12,4,79,80,636,568,68,6,0,43,43
"n329109A","329109A",28,8,20,0,0,19,19,19,6,13,0,0,13,13
"n1212099","1212099",3633,2531,1102,403,257,364,604,3007,2173,834,308,208,244,446
"n2150236","2150236",934,81,853,25,11,822,827,651,71,580,20,5,554,559
"n2010720","2010720",3904,2080,1824,277,542,969,1477,3217,1785,1432,242,416,753,1143
"n2270104","2270104",225,134,91,3,8,83,85,165,100,65,3,5,57,59
"n1131115","1131115",3049,640,2409,25,199,2153,2332,2294,584,1710,17,148,1510,1651
"n37012A","37012A",58,56,2,1,0,2,2,36,36,0,0,0,0,0
"n390038","390038",819,663,156,15,24,78,99,720,597,123,11,17,59,74
"n2010763","2010763",3020,194,2826,37,73,2709,2761,2134,165,1969,33,47,1874,1912
"n294194","294194",2092,633,1459,98,246,1146,1330,1597,521,1076,83,178,817,965
"n2230036","2230036",1470,1224,246,12,46,163,204,1123,967,156,11,20,101,119
"n1131063","1131063",3773,628,3145,48,242,2816,3032,2817,555,2262,44,169,2000,2159
"n1134641","1134641",1130,309,821,41,26,740,760,850,271,579,26,14,526,538
"n4230025","4230025",2941,2209,732,96,276,277,547,2372,1846,526,55,193,210,402
"n90012","90012",113,101,12,2,0,2,2,87,80,7,2,0,0,0
"n930010","930010",694,544,150,1,4,128,129,566,457,109,1,2,93,94
"n3290102","3290102",5702,2500,3202,361,522,2241,2745,3834,1782,2052,254,333,1395,1723
"n1670458","1670458",2247,1735,512,4,25,412,433,1728,1377,351,4,18,275,290
"n270211","270211",2373,664,1709,159,989,560,1472,1709,536,1173,130,630,370,967
"n1830018","1830018",4677,1927,2750,34,1744,908,2632,3714,1677,2037,24,1404,549,1947
"n1211056","1211056",1964,1150,814,23,29,691,713,1467,952,515,18,24,411,432
"n4393653","4393653",0,0,0,0,0,0,0,0,0,0,0,0,0,0
"n4910320","4910320",1716,1351,365,70,24,214,237,1321,1063,258,52,18,142,159
"n1573111","1573111",2123,901,1222,583,239,378,602,1604,737,867,437,141,264,403
"n294065","294065",4002,587,3415,108,960,2470,3297,2788,463,2325,86,610,1653,2221
"n1134161","1134161",2250,123,2127,86,575,1487,2033,1535,107,1428,75,366,999,1354
"n3030075","3030075",1481,1142,339,40,43,235,270,1192,940,252,35,29,167,188
"n850226","850226",6834,3663,3171,780,1355,937,2250,4796,2698,2098,551,864,592,1441
"n850120","850120",4945,3171,1774,916,328,456,768,3633,2461,1172,616,204,285,485
"n4394492","4394492",2421,1593,828,111,328,369,673,2271,1540,731,98,287,328,593
"n2010446","2010446",1201,119,1082,26,37,1026,1048,826,100,726,17,28,679,699
"n294002","294002",1901,122,1779,11,157,1623,1755,1446,103,1343,2,121,1215,1329
"n4394115","4394115",743,651,92,21,17,39,53,586,531,55,16,8,21,26
"n1572068","1572068",813,474,339,6,54,273,319,577,376,201,4,37,147,184
"n3030021","3030021",4112,1673,2439,60,377,1970,2294,2984,1385,1599,45,212,1272,1475
"n3090032","3090032",1608,1132,476,10,205,260,438,1300,1007,293,8,106,171,262
"n38719-1","38719-1",301,259,42,1,4,27,29,246,215,31,1,4,19,21
"n2150047","2150047",3797,112,3685,22,44,3636,3649,2835,75,2760,14,31,2721,2732
"n4010215","4010215",3156,1930,1226,15,451,675,1113,2324,1491,833,10,317,427,741
"n70001","70001",3109,2318,791,17,35,635,666,2587,2035,552,10,27,426,450
"n294108","294108",6844,2156,4688,224,1020,3489,4351,5091,1822,3269,164,666,2413,3007
"n1134071","1134071",1689,63,1626,6,109,1516,1615,1172,50,1122,5,82,1033,1112
"n4530176","4530176",86,31,55,6,11,40,49,54,29,25,5,2,20,20
"n230001","230001",863,709,154,4,26,101,124,656,565,91,1,14,59,73
"n1750021","1750021",1402,630,772,20,92,660,728,1083,514,569,16,56,494,536
"n4910118","4910118",4647,2802,1845,479,288,987,1249,3606,2327,1279,330,206,656,851
"n4350301","4350301",890,469,421,9,15,394,400,672,386,286,4,8,272,275
"n2190032","2190032",3841,1251,2590,27,231,2324,2515,2808,1037,1771,18,153,1574,1719
"n2150176","2150176",3758,219,3539,4,16,3502,3505,2432,187,2245,4,10,2224,2227
"n2010677","2010677",4411,247,4164,54,149,3973,4089,3057,206,2851,41,98,2704,2792
"n1214162A","1214162A",804,557,247,35,55,137,185,608,425,183,22,37,104,138
"n2010383","2010383",5503,687,4816,146,1053,3627,4624,4041,596,3445,115,813,2502,3299
"n1810407","1810407",647,339,308,12,161,101,249,446,272,174,8,79,53,130
"n213004A","213004A",2397,1151,1246,50,500,662,1138,1923,1022,901,48,383,436,811
"n3390003","3390003",5937,3465,2472,562,352,1425,1739,4149,2529,1620,360,214,958,1145
"n2010575","2010575",8882,2904,5978,1331,1856,2752,4493,6206,2180,4026,912,1211,1821,2977
"n2250019","2250019",890,692,198,3,144,35,174,729,572,157,1,119,19,136
"n211004","211004",3014,1546,1468,46,524,814,1312,2322,1284,1038,30,379,548,921
"n4530146","4530146",1043,335,708,28,24,664,684,734,284,450,18,18,417,431
"n2210317","2210317",2875,2421,454,31,39,275,310,2266,1970,296,16,24,180,203
"n1690003","1690003",2696,476,2220,26,196,2027,2176,2424,402,2022,22,152,1863,1982
"n4530205","4530205",4010,3188,822,249,81,410,477,3401,2742,659,177,54,340,386
"n4230045","4230045",2740,2270,470,32,112,236,342,2147,1839,308,23,84,128,209
"n2150256","2150256",519,102,417,3,3,413,414,393,75,318,2,3,316,317
"n3330009","3330009",863,644,219,4,8,177,185,669,506,163,4,8,127,135
"n4230002","4230002",2193,98,2095,7,420,1667,2073,1493,80,1413,4,291,1108,1397
"n4910410","4910410",7679,3590,4089,239,858,2941,3658,5260,2642,2618,149,544,1837,2326
"n2150130","2150130",3044,235,2809,10,12,2778,2785,2170,218,1952,7,3,1933,1935
"n4010212","4010212",1141,834,307,6,181,102,278,926,698,228,4,137,70,207
"n1574069","1574069",9879,1992,7887,2639,3333,1944,5156,6471,1359,5112,1805,2064,1212,3235
"n294105","294105",1709,620,1089,115,207,801,960,1299,515,784,81,133,582,694
"n49901-2","49901-2",3234,2739,495,13,44,345,381,2772,2430,342,12,19,233,248
"n410023","410023",127,80,47,0,8,35,43,95,63,32,0,5,25,30
"n1131091","1131091",5506,319,5187,40,1094,4069,5128,3919,284,3635,30,901,2706,3588
"n1214204","1214204",4254,3280,974,254,151,438,574,3233,2557,676,163,109,308,406
"n17704/6","17704/6",3025,750,2275,20,88,2150,2226,2148,635,1513,17,66,1412,1475
"n30001","30001",4698,1784,2914,26,67,2765,2816,3245,1338,1907,18,41,1792,1830
"n1670173","1670173",1618,1016,602,188,134,241,371,1115,705,410,129,82,174,254
"n4410303","4410303",2860,2453,407,8,26,280,300,2057,1802,255,5,12,155,164
"n294045","294045",4273,1093,3180,157,514,2497,2966,3332,979,2353,136,384,1812,2170
"n2150173","2150173",4177,555,3622,5,7,3588,3594,2822,522,2300,4,6,2271,2277
"n890402","890402",4402,1212,3190,12,946,2251,3127,3301,1034,2267,3,662,1575,2221
"n270315","270315",6235,3314,2921,341,938,1656,2462,4160,2332,1828,216,591,983,1512
"n4530262","4530262",6330,2498,3832,2838,225,663,867,4977,2215,2762,1981,179,523,686
"n325001D","325001D",1880,999,881,13,32,820,838,1437,824,613,7,23,570,584
"n1211036","1211036",5733,3012,2721,980,863,778,1588,3845,2110,1735,611,558,468,1005
"n1131148","1131148",0,0,0,0,0,0,0,0,0,0,0,0,0,0
"n2010783","2010783",2518,72,2446,58,949,1462,2381,1638,47,1591,42,658,909,1545
"n4530372B","4530372B",89,51,38,17,1,15,16,68,43,25,12,0,11,11
"n370011","370011",1174,932,242,6,128,66,191,892,732,160,0,91,38,127
"n3050006","3050006",667,320,347,11,35,294,326,495,259,236,8,21,196,217
"n850183","850183",108,88,20,1,0,12,12,80,70,10,0,0,4,4
"n2010489","2010489",3491,619,2872,193,829,1861,2658,2717,553,2164,157,680,1329,1987
"n294214","294214",2999,454,2545,35,108,2406,2478,2061,360,1701,24,60,1613,1659
"n390018","390018",6753,3903,2850,472,727,1510,2194,4844,2857,1987,318,534,1023,1540
"n1211016","1211016",6627,3517,3110,1155,940,901,1802,4094,2224,1870,702,576,497,1052
"n4230028","4230028",6306,4631,1675,108,693,713,1390,4475,3448,1027,67,410,403,812
"n3010003","3010003",26,25,1,1,1,0,1,20,19,1,1,1,0,1
"n4394252","4394252",1622,911,711,37,56,571,622,1311,797,514,26,49,398,446
"n1134665","1134665",0,0,0,0,0,0,0,0,0,0,0,0,0,0
"n37002B","37002B",1005,289,716,12,584,91,674,667,212,455,10,373,48,420
"n1212079","1212079",4802,3115,1687,746,358,465,801,3716,2542,1174,515,263,298,545
"n2010595","2010595",5501,277,5224,155,1459,3651,5048,3875,247,3628,129,1075,2440,3486
"n2010426","2010426",2504,429,2075,623,231,1217,1432,1971,400,1571,525,196,839,1027
"n850246","850246",3607,2064,1543,1027,231,231,454,2839,1711,1128,762,167,151,315
"n50040","50040",1309,564,745,27,402,305,695,989,493,496,21,262,196,454
"n1134542","1134542",0,0,0,0,0,0,0,0,0,0,0,0,0,0
"n1572123","1572123",4021,61,3960,29,2638,1351,3919,2747,50,2697,21,1830,864,2663
"n2010532","2010532",2349,871,1478,67,488,916,1367,1727,725,1002,48,314,620,923
"n4490011","4490011",622,171,451,6,11,430,434,422,134,288,6,6,273,277
"n3170004","3170004",965,620,345,7,29,300,325,665,435,230,3,21,198,218
"n4394568","4394568",102,65,37,1,3,27,29,85,56,29,0,2,19,21
"n850140","850140",6339,4682,1657,418,535,597,1119,4699,3542,1157,301,370,397,759
"n5030024","5030024",3692,2371,1321,21,58,1141,1189,2769,1893,876,12,30,753,781
"n930006","930006",488,311,177,0,8,153,158,391,273,118,0,6,99,103
"n2150067","2150067",4239,475,3764,72,59,3633,3672,3309,413,2896,49,48,2789,2822
"n1213142","1213142",1028,576,452,57,40,322,359,714,427,287,50,25,190,213
"n1610007A","1610007A",1183,799,384,8,210,145,350,899,620,279,2,160,93,249
"n150414","150414",2438,1119,1319,33,176,1076,1216,1766,916,850,25,104,672,765
"n1573166","1573166",146,112,34,13,13,6,19,137,109,28,9,13,4,17
"n410003","410003",1890,770,1120,5,237,844,1077,1363,621,742,1,197,519,712
"n1070011","1070011",1141,365,776,7,44,710,747,836,305,531,7,32,474,506
"n3390023","3390023",8119,3991,4128,96,1014,2848,3816,5705,3081,2624,62,658,1749,2394
"n294151","294151",803,546,257,14,11,213,224,639,454,185,9,5,151,156
"n2010658","2010658",5181,2098,3083,237,993,1761,2700,3725,1679,2046,153,653,1149,1788
"n4530123","4530123",3291,675,2616,168,637,1820,2419,2412,581,1831,109,510,1208,1693
"n3090052","3090052",939,833,106,23,28,40,66,853,785,68,14,20,20,39
"n270104","270104",4960,3778,1182,109,149,772,900,3805,3023,782,65,80,508,576
"n4910317","4910317",1765,650,1115,939,22,145,165,1135,467,668,557,11,87,98
"n410043","410043",1122,393,729,10,292,426,717,1102,388,714,10,292,411,702
"n2010846","2010846",675,49,626,4,116,498,614,492,46,446,3,100,336,436
"n3390080A","3390080A",6836,4425,2411,302,437,1522,1930,4895,3299,1596,212,289,977,1254
"n1132002","1132002",1965,1095,870,99,98,616,714,1553,926,627,72,79,431,510
"n2390006","2390006",1395,561,834,26,122,672,780,1010,468,542,19,59,447,501
"n291048","291048",3996,300,3696,19,49,3642,3670,2918,255,2663,12,35,2623,2645
"n4391198","4391198",1507,295,1212,73,54,1073,1125,1071,250,821,53,32,725,755
"n410087","410087",0,0,0,0,0,0,0,0,0,0,0,0,0,0
"n4391080","4391080",2843,97,2746,25,1494,1254,2710,1933,69,1864,22,1053,791,1832
"n1214223","1214223",3949,2446,1503,247,549,594,1127,2822,1860,962,173,336,365,695
"n2010803","2010803",6355,3322,3033,702,787,1461,2197,4876,2753,2123,519,536,963,1481
"n3390041","3390041",7011,4703,2308,61,173,1864,2020,5063,3592,1471,32,113,1166,1273
"n4530294","4530294",3324,2237,1087,227,75,699,771,2760,1949,811,169,59,511,568
"n1870201","1870201",1178,311,867,10,83,770,844,869,262,607,8,60,533,590
"n1131712","1131712",3974,1556,2418,114,298,1941,2216,2966,1332,1634,74,200,1286,1474
"n391004B","391004B",154,86,68,4,5,64,67,128,73,55,0,2,52,54
"n4394163","4394163",1700,1366,334,64,44,184,225,1192,1003,189,27,25,104,129
"n4910371","4910371",4269,2730,1539,95,328,1059,1347,3401,2343,1058,78,219,708,907
"n2150110","2150110",3441,72,3369,19,27,3333,3344,2112,49,2063,16,14,2042,2047
"n850203","850203",3914,3025,889,154,269,389,635,2968,2373,595,106,176,259,423
"n4330004","4330004",339,252,87,3,7,75,80,269,210,59,3,6,48,53
"n2310319","2310319",2759,2305,454,23,78,236,309,2115,1813,302,14,48,148,195
"n2010552","2010552",5627,4085,1542,223,366,829,1173,4216,3172,1044,161,239,550,778
"n4394820","4394820",0,0,0,0,0,0,0,0,0,0,0,0,0,0
"n4090119","4090119",1652,1007,645,44,45,484,525,1308,846,462,30,35,347,380
"n10003","10003",1925,1408,517,25,150,294,435,1473,1151,322,15,97,159,256
"n3030124","3030124",2389,1682,707,51,69,522,584,1939,1406,533,43,43,388,426
"n1134115","1134115",444,299,145,20,9,103,112,340,238,102,14,9,69,78
"n1870405","1870405",3302,2048,1254,50,89,1075,1148,2526,1680,846,30,63,707,766
"n3370016","3370016",452,393,59,2,1,42,43,340,297,43,2,1,30,31
"n1650004","1650004",5417,3098,2319,50,92,2135,2203,3532,1971,1561,32,55,1423,1472
"n4190007","4190007",1017,673,344,6,273,53,325,794,538,256,6,208,34,242
"n50019","50019",1952,1248,704,126,340,187,525,1535,1022,513,95,247,124,370
"n2150239","2150239",6425,450,5975,18,32,5927,5947,4402,398,4004,15,24,3961,3979
"n1213122","1213122",5130,1832,3298,401,1787,1093,2820,4277,1659,2618,341,1354,873,2197
"n321003A","321003A",4248,1010,3238,444,153,2642,2775,3129,842,2287,352,107,1814,1913
"n294171","294171",1744,737,1007,47,102,844,927,1332,608,724,28,76,603,665
"n2010638","2010638",4789,116,4673,129,2586,1995,4511,3543,105,3438,99,1956,1387,3304
"n2190036","2190036",982,178,804,3,44,757,794,725,155,570,3,34,533,563
"n1670462","1670462",4616,3055,1561,760,141,555,688,3089,2120,969,469,92,339,430
"n3290304","3290304",5782,633,5149,36,696,4437,5060,4090,504,3586,29,485,3066,3526
"n2010700","2010700",4263,2900,1363,45,167,1043,1199,3118,2190,928,32,116,686,799
"n4450201","4450201",2028,718,1310,18,124,1157,1264,1476,562,914,14,92,794,880
"n1134614","1134614",707,417,290,42,44,197,235,534,347,187,25,25,122,143
"n3110002","3110002",143,80,63,1,3,58,59,109,59,50,1,2,46,47
"n1574170","1574170",350,102,248,3,144,104,245,350,102,248,3,144,104,245
"n2010509","2010509",5397,1612,3785,417,1160,2209,3249,4139,1363,2776,305,843,1612,2385
"n2150153","2150153",912,17,895,1,4,888,888,597,7,590,1,1,588,588
"n2250022","2250022",386,272,114,0,55,46,99,338,236,102,0,52,39,89
"n990309","990309",1036,874,162,5,19,97,110,806,700,106,2,11,63,71
"n1790003","1790003",169,147,22,2,0,14,14,137,120,17,2,0,9,9
"n3090009","3090009",2481,482,1999,19,578,1406,1931,1748,393,1355,14,413,913,1303
"n2010615","2010615",3786,1035,2751,310,1170,1276,2386,2916,915,2001,256,840,892,1699
"n2150216","2150216",2568,105,2463,19,26,2421,2434,2058,85,1973,13,8,1951,1955
"n4394369","4394369",5684,3642,2042,300,414,1226,1594,4209,2833,1376,210,298,775,1047
"n3090071","3090071",1367,845,522,3,289,183,457,1001,672,329,1,181,108,285
"n4910267","4910267",3632,2251,1381,193,216,910,1089,2526,1647,879,122,134,566,688
"n4394640","4394640",1082,518,564,44,97,411,497,962,502,460,43,82,323,396
"n310303","310303",1046,850,196,7,8,143,149,926,768,158,5,8,109,115
"n397004A","397004A",7319,4367,2952,314,859,1610,2419,4831,2990,1841,189,550,964,1496
"n4230048","4230048",2653,678,1975,14,424,1512,1917,1859,582,1277,10,311,925,1223
"n130015","130015",4280,1205,3075,28,73,2919,2956,3084,959,2125,20,49,2008,2039
"n4530233","4530233",4342,3385,957,388,82,396,475,3405,2743,662,271,59,272,329
"n1131067","1131067",38,9,29,1,0,27,27,19,5,14,1,0,12,12
"n4510436","4510436",5748,3718,2030,77,193,1657,1808,4491,3063,1428,53,99,1150,1241
"n4070007","4070007",2546,1961,585,22,364,120,479,2199,1755,444,17,268,95,360
"n4970013","4970013",995,744,251,4,14,188,202,768,599,169,3,14,113,127
"n910301B","910301B",0,0,0,0,0,0,0,0,0,0,0,0,0,0
"n1211059","1211059",3584,2360,1224,130,333,644,946,2944,2044,900,119,248,436,670
"n4270012","4270012",7168,148,7020,54,22,6946,6958,4799,99,4700,41,18,4647,4659
"n1212076","1212076",5465,2439,3026,248,891,1737,2610,4060,1989,2071,190,572,1177,1744
"n2010697","2010697",5895,430,5465,407,1380,3714,5027,4351,375,3976,356,1083,2556,3591
"n3290211","3290211",6365,2886,3479,179,557,2653,3168,4089,1982,2107,107,308,1615,1903
"n390015","390015",4176,2928,1248,57,243,855,1080,3223,2291,932,32,199,611,805
"n1213119","1213119",308,122,186,142,15,18,33,235,95,140,106,14,14,28
"n3050003","3050003",762,309,453,0,5,440,445,565,236,329,0,5,317,322
"n4394483","4394483",138,23,115,4,2,110,111,110,20,90,3,1,85,86
"n370028","370028",888,779,109,1,12,47,59,731,654,77,1,6,35,41
"n2010740","2010740",503,319,184,12,16,150,164,384,262,122,6,12,95,105
"n4490008","4490008",3467,495,2972,20,448,2488,2912,2378,401,1977,10,317,1623,1928
"n3170001","3170001",1355,634,721,10,24,678,695,1004,502,502,8,19,468,482
"n1131405","1131405",1368,169,1199,6,382,807,1182,907,152,755,6,216,524,739
"n1870105","1870105",4851,2706,2145,38,149,1832,1963,3730,2232,1498,18,113,1264,1372
"n3090029","3090029",2000,728,1272,42,612,635,1191,1648,639,1009,39,498,473,933
"n1134538","1134538",2408,341,2067,82,553,1406,1927,1659,276,1383,68,343,940,1272
"n2010529","2010529",6850,4769,2081,146,436,1358,1772,5324,3855,1469,102,288,959,1237
"n2330023","2330023",1072,707,365,23,42,236,261,780,546,234,23,22,134,155
"n4391126","4391126",2324,682,1642,125,1109,382,1465,1864,596,1268,97,867,271,1126
"n4150007","4150007",3393,1933,1460,41,90,1288,1364,2454,1550,904,20,47,798,843
"n1190001","1190001",947,852,95,3,32,36,67,724,656,68,2,18,26,44
"n4230005","4230005",6261,4798,1463,105,501,674,1162,4545,3627,918,56,316,397,710
"n1670388","1670388",6205,3757,2448,557,461,1351,1774,4628,2857,1771,425,327,941,1251
"n291028","291028",1407,87,1320,12,18,1294,1296,1058,69,989,12,10,968,969
"n850163","850163",4499,1947,2552,1402,519,567,1068,2980,1372,1608,881,328,361,687
"n4391431","4391431",3402,2285,1117,86,324,619,919,2542,1805,737,65,212,385,591
"n2210409","2210409",6512,5273,1239,163,98,759,845,4899,4101,798,113,64,463,522
"n1131041","1131041",2400,233,2167,22,1650,481,2107,1770,225,1545,18,1178,332,1494
"n170002","170002",1754,866,888,9,15,842,852,1307,731,576,6,9,542,549
"n390058","390058",5473,1822,3651,1184,1676,781,2413,3753,1267,2486,800,1179,491,1638
"n4930311","4930311",3614,2652,962,38,60,784,833,2781,2073,708,22,42,575,613
"n1134023","1134023",155,61,94,0,68,27,93,141,61,80,0,62,19,80
"n229003N","229003N",240,89,151,1,3,138,138,186,74,112,0,2,103,103
"n2010655","2010655",7060,3049,4011,1027,938,1947,2820,5188,2330,2858,800,647,1309,1929
"n294148","294148",270,77,193,4,14,176,188,210,62,148,4,12,135,145
"n2010572","2010572",7319,2582,4737,672,1939,2128,3968,6301,2382,3919,591,1625,1696,3248
"n3790102","3790102",1088,936,152,21,19,64,81,878,782,96,13,11,34,43
"n2010680","2010680",262,177,85,21,25,32,57,253,171,82,21,24,30,54
"n4510424","4510424",3675,2027,1648,151,194,1233,1391,2903,1716,1187,114,129,867,990
"n2150090","2150090",5706,130,5576,13,36,5505,5512,3924,95,3829,11,13,3781,3787
"n270107","270107",1067,565,502,19,81,394,457,804,439,365,12,55,271,324
"n1670274","1670274",1078,940,138,18,15,83,92,993,877,116,12,6,76,81
"n4510230","4510230",4892,3018,1874,148,324,1373,1642,3831,2471,1360,103,219,988,1189
"n2150133","2150133",353,16,337,8,5,329,329,238,10,228,7,5,221,221
"n1574073B","1574073B",0,0,0,0,0,0,0,0,0,0,0,0,0,0
"n970007","970007",2447,1950,497,15,86,283,362,1853,1550,303,15,29,178,205
"n1070044","1070044",1403,594,809,17,47,746,775,1060,525,535,11,32,487,512
"n294022","294022",508,96,412,16,48,350,390,366,76,290,14,25,247,271
"n910103","910103",4904,3847,1057,129,87,746,821,3832,3096,736,87,62,494,553
"n1134092","1134092",305,84,221,2,23,191,213,229,72,157,1,21,128,149
"n1610009A","1610009A",386,235,151,2,27,114,141,293,187,106,2,16,82,98
"n110201","110201",343,272,71,6,8,47,51,267,225,42,6,4,21,24
"n294128","294128",219,87,132,4,18,109,122,194,77,117,4,12,95,107
"n4030006","4030006",2118,1783,335,19,156,89,236,1780,1512,268,16,118,63,180
"n4910470","4910470",4107,2185,1922,147,321,1375,1638,2934,1693,1241,109,205,852,1034
"n4530151A","4530151A",4358,2043,2315,660,686,959,1601,2887,1425,1462,411,463,560,1000
"n2150027","2150027",1962,74,1888,8,5,1872,1876,1510,52,1458,7,2,1445,1447
"n294085","294085",85,42,43,5,5,34,38,68,42,26,1,5,21,25
"n4910216","4910216",1742,1213,529,157,44,293,331,1335,968,367,122,40,178,214
"n2010403","2010403",2265,1662,603,173,107,285,388,1668,1279,389,121,60,183,241
"n1134516","1134516",654,158,496,1,170,328,494,563,149,414,1,169,248,413
"n211007","211007",2394,1514,880,53,172,602,762,1923,1300,623,40,132,396,527
"n1131094","1131094",3641,102,3539,18,774,2771,3519,2545,89,2456,13,637,1823,2438
"n49902-1","49902-1",702,575,127,4,29,72,100,560,471,89,3,17,47,64
"n1810207","1810207",1302,1037,265,14,21,151,170,1037,853,184,9,14,101,114
"n294191","294191",23,1,22,1,16,9,20,13,0,13,1,11,5,11
"n2150259","2150259",2528,28,2500,0,4,2495,2496,1678,19,1659,0,0,1656,1656
"n4230077","4230077",1313,673,640,14,299,308,598,1045,607,438,8,209,197,402
"n1573053","1573053",100,55,45,16,13,11,23,85,55,30,10,12,8,20
"n1690006","1690006",169,142,27,0,1,24,24,153,137,16,0,0,15,15
"n30004","30004",4637,1472,3165,33,107,2978,3052,3252,1133,2119,25,73,1983,2041
"n2150196","2150196",1762,660,1102,20,6,1076,1079,1484,650,834,18,5,811,813
"n323004D","323004D",6082,53,6029,7,14,6010,6012,4227,33,4194,5,7,4182,4182
"n293164","293164",2819,1591,1228,151,145,902,1026,2054,1209,845,103,109,603,701
"n1131308","1131308",5262,954,4308,77,818,3446,4202,3685,827,2858,66,563,2229,2757
"n1134634","1134634",7709,2735,4974,2251,1491,1160,2598,6528,2489,4039,1779,1221,970,2157
"n370007","370007",6117,3542,2575,83,1849,422,2252,4552,2819,1733,67,1247,260,1504
"n3970004B","3970004B",0,0,0,0,0,0,0,0,0,0,0,0,0,0
"n4391015","4391015",2077,699,1378,68,112,1173,1269,1687,623,1064,60,83,900,976
"n4890001","4890001",711,60,651,5,3,645,646,512,51,461,4,2,455,456
"n2010466","2010466",7183,1902,5281,819,1984,2474,4387,5729,1725,4004,687,1540,1752,3249
"n37009A","37009A",286,241,45,2,12,21,33,236,199,37,1,12,15,27
"n4392680","4392680",0,0,0,0,0,0,0,0,0,0,0,0,0,0
"n3630003","3630003",1118,978,140,4,3,84,85,999,888,111,4,3,57,58
"n4770115","4770115",1528,804,724,15,229,454,681,1183,694,489,12,173,280,452
"n1750011","1750011",1226,442,784,12,94,679,751,940,364,576,7,68,504,557
"n277003E","277003E",1592,1388,204,7,20,74,92,1238,1100,138,6,11,49,60
"n4393164","4393164",3752,2130,1622,91,259,1139,1384,2950,1841,1109,68,162,765,921
"n293093","293093",4053,1989,2064,546,213,1290,1466,3002,1537,1465,353,154,913,1054
"n850004","850004",3558,2260,1298,220,507,433,904,2583,1744,839,150,314,268,563
"n1133029","1133029",1935,36,1899,16,1403,489,1864,1329,31,1298,7,980,309,1279
"n3650028","3650028",3139,2244,895,30,411,402,805,2470,1829,641,29,301,273,568
"n1410192","1410192",6929,1034,5895,165,219,5527,5688,4941,840,4101,114,160,3797,3933
"n4392302","4392302",4720,524,4196,257,2197,1776,3901,3099,400,2699,214,1363,1120,2451
"n2010078","2010078",3174,257,2917,23,99,2779,2859,2505,244,2261,20,84,2144,2217
"n292053","292053",1972,226,1746,25,45,1693,1717,1576,207,1369,18,32,1320,1342
"n4710204B","4710204B",889,573,316,6,185,94,271,732,480,252,6,149,69,213
"n4530323","4530323",3501,2526,975,558,69,298,359,2461,1878,583,334,30,184,210
"n291140","291140",2342,443,1899,105,385,1435,1772,1572,355,1217,63,228,913,1133
"n550305","550305",891,475,416,6,33,352,379,678,393,285,5,10,247,256
"n710002","710002",1016,526,490,11,283,146,426,783,406,377,11,231,96,327
"n890101","890101",3912,2026,1886,54,631,1200,1788,2990,1692,1298,35,469,776,1225
"n1131078","1131078",3757,301,3456,27,1432,2010,3412,2664,262,2402,25,1086,1289,2362
"n4590005","4590005",852,638,214,0,74,115,188,634,482,152,0,65,67,131
"n4910489","4910489",4875,2591,2284,756,488,943,1406,3376,1859,1517,474,338,628,955
"n2010042","2010042",1422,18,1404,3,966,444,1397,1042,12,1030,1,767,273,1028
"n2010373","2010373",339,9,330,5,105,220,318,252,8,244,1,90,146,236
"n2010539","2010539",3439,1090,2349,539,631,1171,1776,2449,826,1623,401,418,786,1193
"n4394532","4394532",1578,1325,253,36,37,139,167,1321,1139,182,22,22,99,116
"n4391710","4391710",2833,1297,1536,77,323,1111,1404,2137,1064,1073,62,205,764,959
"n4393637","4393637",4461,2083,2378,662,719,928,1611,3209,1577,1632,465,451,635,1074
"n1132905","1132905",521,420,101,43,23,31,54,455,376,79,39,13,22,35
"n1133327","1133327",11,1,10,0,0,10,10,11,1,10,0,0,10,10
"n1132503","1132503",3431,2927,504,175,67,184,248,2426,2105,321,125,35,112,144
"n1214171","1214171",713,388,325,58,67,182,241,603,367,236,35,39,145,177
"n1490423","1490423",1074,786,288,1,142,140,274,876,671,205,1,102,92,193
"n1870208","1870208",5996,3628,2368,99,215,1970,2147,4520,2925,1595,69,141,1296,1425
"n293140","293140",57,13,44,1,1,43,43,43,11,32,1,0,31,31
"n590006","590006",1507,1264,243,15,39,137,172,1185,1016,169,6,23,90,113
"n730027","730027",1473,894,579,7,286,267,553,1136,724,412,2,224,167,391
"n850113","850113",5670,2918,2752,512,850,1290,2097,4251,2383,1868,383,544,855,1380
"n1132038","1132038",4592,3609,983,290,147,469,594,3886,3078,808,230,122,387,495
"n1132605","1132605",4750,577,4173,3805,134,203,324,3195,460,2735,2485,94,116,205
"n2490019","2490019",643,219,424,0,8,406,413,452,168,284,0,8,270,277
"n2950207B","2950207B",10,1,9,0,0,9,9,8,1,7,0,0,7,7
"n3290110","3290110",4224,3092,1132,257,64,741,796,3010,2278,732,175,39,457,491
"n3550037","3550037",2212,228,1984,18,75,1891,1947,1657,168,1489,6,55,1419,1464
"n4290005","4290005",113,109,4,1,0,0,0,91,90,1,0,0,0,0
"n4910155","4910155",6409,2494,3915,738,1034,2098,3062,5070,2171,2899,560,759,1504,2235
"n11332A0","11332A0",0,0,0,0,0,0,0,0,0,0,0,0,0,0
"n1350313","1350313",2346,1274,1072,20,93,901,983,1775,1025,750,15,52,624,675
"n2010608","2010608",4893,223,4670,118,50,4503,4534,3195,176,3019,93,33,2892,2919
"n2010019","2010019",2175,1010,1165,244,436,462,881,1998,952,1046,214,387,420,792
"n2090372","2090372",578,134,444,20,100,319,412,349,87,262,14,48,189,235
"n2170010","2170010",3861,2368,1493,33,300,1031,1307,2851,1863,988,20,217,648,852
"n250004","250004",861,390,471,6,5,447,452,656,315,341,5,5,321,326
"n292098","292098",2733,397,2336,55,142,2162,2262,2027,334,1693,39,89,1568,1642
"n410033","410033",4054,1900,2154,325,858,1006,1783,3528,1791,1737,302,593,871,1394
"n850136","850136",2776,1715,1061,256,385,372,744,2375,1536,839,204,298,290,582
"n1134108","1134108",146,0,146,0,36,108,144,88,0,88,0,24,63,87
"n1132009","1132009",2690,2037,653,73,71,440,506,2005,1544,461,51,48,311,358
"n4770312","4770312",1674,1170,504,17,129,314,437,1298,968,330,13,89,195,280
"n2450102","2450102",3737,856,2881,32,1250,1617,2831,3717,851,2866,32,1246,1606,2820
"n2930102","2930102",834,685,149,7,32,72,100,642,532,110,6,21,49,69
"n2990307","2990307",5326,3914,1412,49,109,1059,1143,4223,3273,950,30,75,679,743
"n3550060","3550060",1953,71,1882,3,52,1820,1864,1457,58,1399,2,28,1359,1385
"n4392451","4392451",495,135,360,12,203,136,335,351,112,239,11,137,84,220
"n4530266","4530266",4322,2622,1700,641,221,755,964,3915,2452,1463,530,193,662,846
"n1134652","1134652",3233,237,2996,74,73,2847,2910,2222,213,2009,58,53,1893,1942
"n1350110","1350110",6178,2219,3959,226,427,3238,3613,4052,1621,2431,162,215,1976,2178
"n1410112","1410112",10357,745,9612,155,441,9126,9440,7588,594,6994,124,293,6616,6841
"n1574024","1574024",700,317,383,12,21,339,358,479,240,239,10,14,205,218
"n2010253","2010253",3522,72,3450,13,2185,1262,3429,2467,62,2405,5,1641,757,2391
"n2090314","2090314",1978,1502,476,30,35,376,405,1693,1347,346,15,14,283,294
"n270201","270201",6365,2529,3836,268,1759,1713,3324,4658,2070,2588,191,1200,1059,2199
"n294058","294058",3182,1410,1772,140,233,1373,1555,2534,1227,1307,108,163,987,1122
"n293099","293099",5237,1964,3273,943,255,2080,2290,3709,1425,2284,641,166,1464,1609
"n530018","530018",2564,1571,993,18,43,850,889,2022,1361,661,14,21,547,566
"n1133614","1133614",1470,102,1368,10,1070,292,1339,1067,91,976,5,801,164,955
"n1214191","1214191",2907,2143,764,18,70,534,593,2225,1690,535,13,36,371,403
"n4910427","4910427",4147,2339,1808,67,357,1310,1637,3310,2025,1285,43,232,923,1142
"n3090064","3090064",2013,1283,730,42,181,441,613,1568,1074,494,27,118,294,408
"n3550080","3550080",2554,116,2438,19,357,2084,2411,1894,80,1814,11,276,1529,1794
"n3670300","3670300",2563,1987,576,16,104,361,454,2023,1623,400,7,62,247,303
"n4391034","4391034",4883,3357,1526,99,262,1014,1259,3719,2675,1044,61,191,663,843
"n4530311","4530311",5286,2717,2569,1552,241,769,995,4443,2264,2179,1314,191,650,833
"n4850409","4850409",992,796,196,8,56,104,157,797,660,137,7,42,71,110
"n1391028","1391028",4284,2338,1946,25,217,1592,1790,3136,1851,1285,21,147,1013,1153
"n1574113","1574113",14424,782,13642,4741,5911,3120,8868,10176,594,9582,3629,3825,2191,5912
"n2011062","2011062",4292,1665,2627,170,124,2309,2398,3238,1425,1813,128,72,1588,1646
"n2010565","2010565",8509,200,8309,442,1632,6365,7804,5789,133,5656,337,1245,4155,5274
"n2090145","2090145",2476,982,1494,77,312,1118,1378,2098,882,1216,54,252,895,1123
"n2310104","2310104",1489,953,536,11,65,410,471,1155,798,357,10,48,256,304
"n294035","294035",37,18,19,3,2,14,16,26,15,11,1,2,8,10
"n510301","510301",2181,1449,732,19,187,485,660,1716,1188,528,13,131,343,469
"n610098","610098",10268,405,9863,114,86,9684,9726,6866,273,6593,82,56,6465,6491
"n1214213","1214213",2096,1434,662,228,134,245,374,1340,929,411,141,90,149,235
"n2011085","2011085",3421,2616,805,53,95,536,624,2598,2047,551,37,63,355,414
"n2011079","2011079",5084,246,4838,155,1476,3246,4655,3524,199,3325,139,979,2208,3164
"n3810112","3810112",7394,4040,3354,95,598,2524,3035,5378,3247,2131,54,344,1573,1896
"n38703-1B","38703-1B",83,24,59,2,30,28,57,69,21,48,1,27,20,47
"n4370003","4370003",1091,617,474,6,59,390,437,856,528,328,5,41,260,298
"n4391544","4391544",26,5,21,0,0,20,20,23,5,18,0,0,17,17
"n4391501","4391501",1104,375,729,53,395,285,666,774,294,480,34,258,192,443
"n4910394","4910394",3051,2860,191,39,24,85,109,3031,2856,175,35,23,77,100
"n2010416","2010416",7016,2840,4176,548,1443,2134,3488,5541,2434,3107,438,1027,1556,2540
"n2010913","2010913",724,36,688,75,110,503,607,511,29,482,59,72,351,421
"n2210202","2210202",5823,4625,1198,66,77,800,868,4637,3825,812,43,37,541,573
"n325003D","325003D",8004,2151,5853,64,676,5075,5718,6387,1820,4567,48,641,3838,4460
"n3630006","3630006",1151,1015,136,17,7,77,80,982,884,98,12,3,50,52
"n3670105","3670105",3129,2524,605,45,23,405,421,2422,2018,404,28,17,265,275
"n292164","292164",3612,1101,2511,373,357,1763,2089,2999,1001,1998,314,280,1380,1640
"n410053","410053",312,199,113,14,11,73,84,296,194,102,14,10,66,76
"n910202B","910202B",0,0,0,0,0,0,0,0,0,0,0,0,0,0
"n1134084","1134084",1496,21,1475,3,230,1250,1466,1090,17,1073,2,183,890,1071
"n1131104","1131104",7020,281,6739,21,1792,4926,6679,4796,249,4547,13,1287,3225,4502
"n1410095","1410095",4212,583,3629,76,146,3409,3518,3345,534,2811,61,112,2624,2716
"n3650001","3650001",2488,1702,786,11,345,370,711,1910,1363,547,11,268,220,486
"n3810426","3810426",6248,4317,1931,129,291,1348,1588,4630,3451,1179,84,129,806,930
"n4392379","4392379",6345,1139,5206,1238,2679,1279,3892,4489,899,3590,881,1838,835,2643
"n4394615","4394615",0,0,0,0,0,0,0,0,0,0,0,0,0,0
"n4790136","4790136",268,10,258,4,4,254,255,200,10,190,3,1,186,187
"n1870114","1870114",1919,905,1014,17,60,907,958,1423,719,704,12,33,632,662
"n2010936","2010936",368,32,336,10,90,232,317,258,32,226,8,57,162,217
"n2011105","2011105",579,8,571,2,519,49,567,331,7,324,2,297,24,320
"n2010273","2010273",2945,2169,776,413,48,243,277,2280,1694,586,329,35,173,200
"n2350300","2350300",378,259,119,6,7,110,115,291,210,81,1,2,76,77
"n3090022","3090022",1193,279,914,11,419,474,870,822,245,577,9,254,289,538
"n10015","10015",1317,973,344,9,139,163,301,1072,851,221,6,88,103,191
"n190101","190101",2188,1687,501,24,26,382,407,1807,1429,378,15,24,277,300
"n292141","292141",1957,497,1460,154,189,1129,1285,1500,405,1095,120,136,833,947
"n293073","293073",2105,921,1184,209,123,863,969,1727,803,924,160,97,662,749
"n410027","410027",3510,2598,912,53,105,662,753,2716,2109,607,37,57,440,493
"n1134060","1134060",6995,268,6727,150,1950,4680,6563,4651,226,4425,117,1165,3155,4297
"n4392305","4392305",2918,1566,1352,235,623,449,1060,2215,1275,940,173,426,295,719
"n4490019","4490019",1670,594,1076,6,175,872,1035,1194,507,687,4,130,529,653
"n4770202","4770202",222,166,56,0,19,25,44,209,153,56,0,19,25,44
"n489011A","489011A",3407,459,2948,141,398,2410,2794,3144,447,2697,139,391,2166,2549
"n2070008","2070008",212,157,55,0,0,49,49,176,141,35,0,0,30,30
"n2310426","2310426",966,731,235,3,23,167,188,731,566,165,3,14,108,121
"n2470004","2470004",1280,100,1180,23,4,1141,1142,905,68,837,17,2,810,810
"n2990102","2990102",779,693,86,1,3,58,61,724,658,66,1,3,44,47
"n3090045","3090045",1110,480,630,22,332,268,582,861,422,439,15,233,172,400
"n3550102","3550102",2200,670,1530,22,31,1454,1476,1623,543,1080,17,19,1013,1031
"n1391005","1391005",5110,3227,1883,116,751,899,1631,3732,2506,1226,81,519,549,1057
"n1410069","1410069",6883,338,6545,41,124,6384,6463,5461,302,5159,24,83,5035,5096
"n1410118","1410118",3332,373,2959,70,139,2790,2896,2703,347,2356,55,102,2220,2306
"n1670482","1670482",387,241,146,5,13,118,124,284,185,99,3,5,80,84
"n1770009","1770009",1663,517,1146,11,176,957,1100,1268,435,833,7,125,677,792
"n2010296","2010296",3044,666,2378,583,173,1616,1771,2425,593,1832,478,130,1208,1327
"n410095","410095",0,0,0,0,0,0,0,0,0,0,0,0,0,0
"n670015","670015",453,394,59,2,38,4,42,358,318,40,1,27,3,30
"n1134038","1134038",3654,293,3361,31,1106,2243,3316,2696,261,2435,21,908,1518,2408
"n1133012","1133012",420,11,409,5,212,190,397,272,11,261,4,129,127,254
"n1211023","1211023",3939,2375,1564,939,269,274,528,2638,1684,954,564,183,149,323
"n1310005","1310005",577,74,503,2,5,453,458,441,70,371,2,2,339,341
"n3430401","3430401",3156,2158,998,14,607,340,936,2421,1755,666,5,431,191,621
"n3610020","3610020",2603,2334,269,12,18,170,185,1968,1790,178,8,13,103,113
"n3890011","3890011",1429,73,1356,5,34,1311,1340,1008,57,951,5,21,917,937
"n4230052","4230052",3016,2246,770,47,304,297,598,2279,1758,521,20,233,175,408
"n4910262","4910262",3536,2302,1234,188,208,751,931,2650,1797,853,126,136,503,629
"n1410132","1410132",1031,84,947,35,57,873,913,799,70,729,25,46,674,708
"n1573016","1573016",5875,1076,4799,3258,774,757,1507,4677,901,3776,2604,575,589,1153
"n2011148","2011148",2720,163,2557,273,578,1727,2281,1970,139,1831,236,409,1198,1593
"n2150063","2150063",1659,122,1537,34,15,1484,1493,1367,111,1256,29,12,1209,1217
"n2230013","2230013",1815,1106,709,15,66,562,627,1307,865,442,13,47,333,380
"n323002B","323002B",4370,46,4324,9,8,4289,4295,3066,32,3034,7,4,3013,3017
"n294121","294121",462,205,257,4,19,226,238,362,178,184,2,11,159,166
"n291134","291134",17,1,16,1,9,16,16,5,1,4,1,2,4,4
"n292022","292022",2866,113,2753,6,46,2710,2734,2113,94,2019,6,35,1990,2010
"n610018","610018",4823,243,4580,15,23,4531,4540,3530,198,3332,14,20,3297,3305
"n910403","910403",3577,2751,826,55,75,570,634,3083,2433,650,41,58,434,481
"n1131084","1131084",4830,984,3846,77,1875,1889,3715,3823,871,2952,71,1529,1339,2833
"n4970024","4970024",3298,2220,1078,36,59,811,857,2433,1744,689,14,36,489,518
"n2570035","2570035",7991,2737,5254,244,3057,1929,4876,4911,1904,3007,146,1658,1148,2770
"n2810002","2810002",4890,3750,1140,83,97,796,878,3746,3009,737,54,58,492,544
"n3370006","3370006",1489,1168,321,20,25,180,204,1089,904,185,12,4,102,106
"n3690101","3690101",2576,777,1799,10,56,1732,1763,1873,651,1222,7,33,1175,1197
"n4391089","4391089",2928,145,2783,14,1381,1430,2760,2085,111,1974,10,1103,883,1955
"n4650020","4650020",162,113,49,1,1,41,42,138,97,41,1,1,33,34
"n1133113","1133113",22,0,22,2,20,3,22,19,0,19,0,19,1,19
"n1213129","1213129",3034,1467,1567,576,402,538,906,2415,1259,1156,425,310,376,666
"n1430034","1430034",1625,1400,225,21,14,117,129,1251,1097,154,12,6,77,81
"n2010545","2010545",3288,875,2413,698,502,1224,1683,2558,762,1796,538,382,872,1237
"n2011042","2011042",5089,887,4202,836,1131,2227,3309,3672,688,2984,629,747,1582,2306
"n2150206","2150206",2734,135,2599,45,59,2499,2541,1873,109,1764,35,35,1690,1720
"n270406","270406",7387,2177,5210,340,2654,2208,4654,5619,1875,3744,291,1869,1486,3265
"n294178","294178",8,0,8,1,1,4,4,7,0,7,1,1,3,3
"n370018","370018",6170,3195,2975,45,1657,1100,2735,5339,2652,2687,35,1487,1029,2505
"n490204","490204",4256,2087,2169,64,453,1559,1973,3093,1651,1442,38,307,1014,1294
"n1131098","1131098",4771,221,4550,35,1201,3316,4492,3344,203,3141,26,930,2188,3099
"n1133984","1133984",2340,1241,1099,159,218,605,817,1784,1003,781,118,147,429,572
"n4530354","4530354",4867,3873,994,260,95,520,601,3788,3035,753,194,72,379,443
"n2150100","2150100",5449,275,5174,21,27,5136,5142,3867,224,3643,11,16,3621,3627
"n3390089","3390089",7286,5289,1997,332,271,1165,1416,5178,3866,1312,204,180,750,920
"n3550122","3550122",6052,3110,2942,369,274,2228,2460,4382,2388,1994,285,185,1465,1630
"n4392007","4392007",2749,1963,786,142,270,316,578,2286,1690,596,106,218,218,435
"n4393365","4393365",5654,4535,1119,299,167,478,630,4089,3365,724,186,111,315,420
"n4473003","4473003",383,336,47,2,4,36,40,284,256,28,2,1,21,22
"n1150012","1150012",124,70,54,1,0,53,53,92,51,41,1,0,40,40
"n1573147","1573147",10271,1374,8897,6736,1444,685,2087,6844,967,5877,4496,909,446,1329
"n1810106","1810106",5166,3629,1537,59,255,1011,1249,3663,2738,925,36,145,578,715
"n2010104","2010104",2978,49,2929,17,1697,1216,2893,2194,33,2161,13,1391,750,2135
"n2010353","2010353",8604,354,8250,258,3072,4998,7960,6236,301,5935,214,2266,3484,5702
"n2030020","2030020",3955,2557,1398,15,647,625,1255,3083,2063,1020,9,502,406,902
"n50029","50029",2177,1840,337,12,59,245,298,1665,1450,215,10,34,156,188
"n292181C","292181C",254,92,162,11,20,134,150,152,47,105,9,15,85,96
"n293079","293079",4222,2193,2029,197,269,1511,1752,3609,1961,1648,160,210,1228,1416
"n850050","850050",7520,1777,5743,1977,1097,2635,3684,5489,1449,4040,1491,775,1729,2480
"n1132120","1132120",6456,1186,5270,608,2859,1780,4582,4862,1058,3804,441,2129,1207,3304
"n1391048","1391048",2838,1613,1225,44,383,732,1095,2164,1322,842,32,269,486,749
"n4850210","4850210",865,366,499,18,158,297,450,653,295,358,16,111,204,313
"n3090002","3090002",1403,339,1064,24,495,530,1000,1046,314,732,17,299,383,676
"n4050008","4050008",892,827,65,6,14,33,47,737,686,51,3,12,23,35
"n4210102","4210102",554,171,383,6,19,354,365,390,142,248,4,11,227,234
"n4393041","4393041",8156,3963,4193,441,1255,2309,3488,6173,3272,2901,335,831,1553,2346
"n4530106","4530106",4211,2496,1715,603,250,822,1044,3201,1974,1227,397,174,617,767
"n4790251","4790251",1680,216,1464,18,4,1446,1449,1290,204,1086,12,2,1076,1078
"n1410075","1410075",2192,287,1905,20,32,1862,1875,1803,257,1546,17,21,1511,1524
"n1672323","1672323",507,409,98,10,8,69,74,473,388,85,8,8,57,62
"n2010167","2010167",93,4,89,2,13,78,89,72,4,68,0,7,63,68
"n2010793","2010793",8417,1467,6950,158,727,6051,6685,5923,1307,4616,108,432,4040,4419
"n2010707","2010707",1354,631,723,170,100,445,534,1120,567,553,132,76,341,406
"n2410004","2410004",801,753,48,6,8,16,23,701,666,35,2,3,11,14
"n270111","270111",5321,2692,2629,283,950,1316,2204,4017,2176,1841,201,699,855,1523
"n292036","292036",1917,1120,797,63,45,668,706,1624,978,646,51,39,537,570
"n850236","850236",3900,2669,1231,449,290,392,664,2841,1985,856,301,218,256,461
"n1131165","1131165",2750,2366,384,122,26,157,181,1872,1665,207,51,19,94,112
"n1131173","1131173",1257,1042,215,46,32,114,141,1004,860,144,29,20,72,90
"n1132313","1132313",0,0,0,0,0,0,0,0,0,0,0,0,0,0
"n4410107","4410107",1217,833,384,7,44,282,319,935,670,265,7,29,185,210
"n4530303","4530303",623,475,148,60,21,62,83,604,458,146,60,21,60,81
"n2910004","2910004",796,532,264,9,55,167,218,588,415,173,6,38,99,136
"n2910011","2910011",889,520,369,3,267,76,337,707,407,300,3,229,50,277
"n3090058","3090058",6844,2902,3942,69,1760,2041,3705,5020,2448,2572,53,1139,1274,2376
"n4393527","4393527",3522,2588,934,160,184,486,651,2745,2062,683,112,123,340,457
"n4393545","4393545",3280,2352,928,479,118,247,364,2392,1806,586,289,73,148,220
"n4410203","4410203",8353,3737,4616,139,1540,2905,4303,6325,3186,3139,97,982,1933,2888
"n1133608","1133608",4464,150,4314,65,3770,517,4225,3285,131,3154,52,2787,326,3088
"n1830002","1830002",5715,3935,1780,151,1038,496,1511,4657,3364,1293,116,793,306,1090
"n2010061","2010061",4465,291,4174,60,202,3947,4109,3188,252,2936,38,149,2762,2893
"n2010067","2010067",10537,448,10089,88,1041,9055,9966,7582,387,7195,64,731,6447,7105
"n2010310","2010310",2236,1074,1162,215,169,767,919,1949,993,956,196,132,617,738
"n2510034","2510034",4000,3051,949,60,116,574,679,3015,2411,604,27,66,365,427
"n291098","291098",1543,82,1461,24,26,1412,1428,1195,75,1120,19,18,1077,1093
"n610061","610061",3894,327,3567,64,36,3461,3488,2975,282,2693,58,23,2603,2624
"n970033","970033",630,548,82,7,4,46,50,517,468,49,5,2,24,26
"n1110005","1110005",40,38,2,0,2,1,2,36,36,0,0,0,0,0
"n1133075","1133075",333,26,307,3,135,175,300,254,22,232,1,121,107,226
"n1571149","1571149",6613,5185,1428,222,333,707,1023,4991,3986,1005,159,247,487,719
"n3290401","3290401",2219,1302,917,32,61,766,810,1566,1011,555,16,22,459,478
"n4394137","4394137",1865,1547,318,44,50,189,229,1487,1263,224,26,31,134,164
"n4391404","4391404",5604,1355,4249,784,2349,1066,3340,4796,1261,3535,647,1922,883,2768
"n4394338","4394338",4741,2173,2568,406,644,1424,2023,3398,1663,1735,283,435,943,1361
"n4530491A","4530491A",8907,1561,7346,187,1681,5484,7034,6315,1306,5009,140,1225,3617,4775
"n1870413","1870413",1018,739,279,9,59,176,229,813,609,204,7,39,119,158
"n1930007","1930007",2186,1743,443,15,13,323,336,1715,1389,326,14,8,220,228
"n2010459","2010459",4995,3726,1269,287,206,647,839,3712,2876,836,169,137,424,552
"n2150249","2150249",806,55,751,4,5,738,740,605,44,561,2,3,552,552
"n2650308","2650308",1523,714,809,12,10,747,755,1175,637,538,3,3,500,502
"n2750202","2750202",545,263,282,3,46,214,260,379,208,171,1,28,126,154
"n292078","292078",4382,826,3556,93,252,3188,3403,3249,686,2563,71,189,2272,2443
"n293136","293136",2648,730,1918,125,289,1524,1760,2065,627,1438,99,216,1112,1300
"n730015","730015",6835,2980,3855,100,1152,2484,3605,4932,2468,2464,75,743,1549,2285
"n850193","850193",1903,1275,628,55,52,422,472,1425,1026,399,30,27,265,290
"n1133970","1133970",4089,2332,1757,366,525,759,1256,3306,1986,1320,304,385,546,911
"n1150001","1150001",3804,1025,2779,11,699,2049,2729,3186,901,2285,10,664,1588,2243
"n4530361","4530361",2113,1509,604,103,47,389,432,1713,1280,433,66,30,273,300
"n4690027","4690027",2384,1876,508,16,29,401,426,1733,1402,331,7,19,249,264
"n4910145","4910145",5365,1990,3375,358,770,2254,2942,3956,1586,2370,260,504,1572,2039
"n3150007","3150007",1168,531,637,23,560,31,586,935,457,478,14,418,23,439
"n3390083","3390083",2623,1774,849,35,55,703,749,2001,1436,565,19,38,452,488
"n3550116","3550116",7233,2033,5200,244,508,4445,4874,5634,1718,3916,198,363,3320,3649
"n4310002D","4310002D",37,12,25,0,0,25,25,24,8,16,0,0,16,16
"n4393335","4393335",3227,2042,1185,200,297,599,875,2554,1727,827,135,182,429,603
"n4391752","4391752",0,0,0,0,0,0,0,0,0,0,0,0,0,0
"n1573131B","1573131B",0,0,0,0,0,0,0,0,0,0,0,0,0,0
"n1790007","1790007",4788,2401,2387,37,290,1911,2175,3549,1987,1562,29,207,1201,1396
"n2010850","2010850",293,63,230,18,59,155,208,224,52,172,17,39,115,152
"n2010602","2010602",2336,1132,1204,479,293,390,658,1744,881,863,341,203,277,473
"n2270014","2270014",460,144,316,3,29,283,308,364,115,249,3,21,220,241
"n2490013","2490013",769,23,746,7,5,731,736,595,20,575,3,3,564,567
"n130005","130005",3398,627,2771,13,58,2667,2706,2403,502,1901,8,41,1823,1853
"n293036","293036",7354,2168,5186,1225,687,3329,3886,5726,1819,3907,889,478,2527,2937
"n390068","390068",4347,571,3776,418,1576,1768,3317,3013,449,2564,321,1051,1179,2217
"n850093","850093",403,338,65,5,5,45,49,315,274,41,1,4,28,31
"n1132058","1132058",1766,905,861,122,267,460,711,1411,753,658,95,215,334,539
"n1134509","1134509",3381,815,2566,98,205,2230,2414,2496,699,1797,82,132,1542,1662
"n3030114","3030114",1383,332,1051,44,160,838,971,1010,278,732,30,94,583,673
"n3550017","3550017",5664,1505,4159,297,379,3452,3769,4562,1308,3254,260,278,2661,2911
"n411003A","411003A",666,541,125,8,8,90,98,548,460,88,6,8,60,68
"n4392635","4392635",3188,639,2549,560,1270,735,1965,2293,485,1808,433,901,475,1349
"n4530156","4530156",4698,1867,2831,517,879,1405,2209,3314,1419,1895,364,580,920,1463
"n4790446","4790446",6622,204,6418,30,17,6373,6383,4919,135,4784,20,12,4751,4760
"n1410032","1410032",2807,510,2297,107,80,2121,2178,2322,461,1861,77,67,1703,1758
"n1670355","1670355",4602,2622,1980,220,417,1278,1652,3480,2090,1390,162,296,871,1149
"n2010210","2010210",4301,1126,3175,517,2002,673,2637,3781,1058,2723,469,1702,559,2239
"n2010750","2010750",2908,717,2191,133,422,1619,1985,2077,596,1481,107,264,1075,1324
"n2090446","2090446",3327,2517,810,187,86,454,532,2252,1757,495,126,52,257,307
"n2450022","2450022",4371,1350,3021,122,2170,710,2826,3238,1163,2075,66,1516,450,1939
"n294138","294138",0,0,0,0,0,0,0,0,0,0,0,0,0,0
"n291035","291035",9990,5591,4399,504,2322,1678,3730,9174,5171,4003,436,2166,1519,3427
"n293013","293013",2826,1021,1805,122,142,1521,1634,2322,913,1409,96,101,1181,1268
"n410090","410090",27,13,14,0,3,7,10,18,9,9,0,3,2,5
"n770027","770027",648,523,125,3,19,46,61,497,411,86,3,12,27,37
"n1330002","1330002",522,432,90,3,6,72,76,426,363,63,0,3,50,53
"n467001E","467001E",1452,1082,370,14,120,201,320,1048,819,229,10,72,121,193
"n4910255","4910255",4374,2814,1560,213,324,936,1226,3021,2034,987,134,186,576,747
"n2130004","2130004",2473,1786,687,41,163,419,572,1929,1480,449,30,112,270,377
"n3770005","3770005",1437,46,1391,14,4,1367,1370,1046,39,1007,13,2,987,989
"n4230058","4230058",5546,3834,1712,339,761,479,1211,4413,3128,1285,262,546,354,892
"n4394096","4394096",1420,956,464,62,57,306,361,1143,778,365,48,35,239,273
"n4392235","4392235",8615,1414,7201,605,1745,4828,6477,6107,1178,4929,499,1152,3234,4333
"n4530184","4530184",5358,1328,4030,1145,1090,1783,2803,3977,1113,2864,883,700,1239,1908
"n1410219","1410219",2192,37,2155,3,21,2097,2108,1650,31,1619,1,17,1579,1587
"n1670216","1670216",5172,1142,4030,91,857,3085,3869,3851,976,2875,54,611,2178,2750
"n1990001","1990001",2355,1629,726,40,473,138,606,1797,1271,526,25,352,92,442
"n2010976","2010976",2547,406,2141,62,262,1834,2067,1752,345,1407,42,199,1172,1347
"n2010645","2010645",6920,1592,5328,1031,2524,1763,4206,5490,1345,4145,796,1974,1349,3271
"n2010313","2010313",112,10,102,8,17,81,93,84,10,74,8,11,57,65
"n291012","291012",4222,482,3740,90,296,3407,3632,3115,417,2698,63,216,2418,2604
"n292180B","292180B",118,25,93,15,14,72,80,82,13,69,11,11,52,58
"n2010999","2010999",0,0,0,0,0,0,0,0,0,0,0,0,0,0
"n2010336","2010336",9885,710,9175,894,5777,2616,8208,7213,605,6608,727,4147,1769,5823
"n2010005","2010005",2016,1421,595,82,38,450,479,1744,1273,471,60,31,348,374
"n2010668","2010668",8323,3411,4912,1182,1304,2355,3564,6496,2872,3624,882,963,1696,2602
"n3750126","3750126",5704,2744,2960,659,743,1367,2017,4187,2274,1913,388,440,868,1283
"n4230035","4230035",4170,1547,2623,108,1868,615,2461,3238,1394,1844,92,1331,384,1703
"n4394042","4394042",3466,1038,2428,359,206,1817,1999,2499,865,1634,293,110,1191,1286
"n4392148","4392148",8712,1268,7444,355,1679,5416,7010,6220,1110,5110,303,1239,3549,4758
"n4530154A","4530154A",5155,2686,2469,593,762,1030,1735,3480,1919,1561,351,503,614,1092
"n4650011","4650011",3456,134,3322,3,35,3291,3309,2530,102,2428,3,26,2402,2418
"n2132GBS","2132GBS",3747,3132,615,25,74,397,466,3004,2574,430,23,54,250,300
"n2250005","2250005",1881,1544,337,24,173,94,264,1513,1267,246,16,130,66,193
"n2550007","2550007",787,585,202,0,8,173,180,575,442,133,0,2,113,115
"n3030031","3030031",2497,1653,844,36,42,706,737,1915,1317,598,21,26,485,506
"n3210009","3210009",183,99,84,1,42,36,77,142,82,60,1,36,20,56
"n3510009","3510009",268,193,75,2,68,0,68,227,157,70,2,64,0,64
"n850199","850199",3775,2777,998,326,286,286,564,2373,1790,583,195,171,152,322
"n1133055","1133055",2479,209,2270,19,1842,418,2236,2041,189,1852,12,1580,258,1827
"n1134531","1134531",1276,343,933,21,92,833,903,899,282,617,14,54,555,599
"n1131702","1131702",6252,1290,4962,1068,704,3155,3816,4652,1125,3527,846,516,2104,2595
"n1219202","1219202",0,0,0,0,0,0,0,0,0,0,0,0,0,0
"n1410175","1410175",447,36,411,2,14,400,411,344,36,308,0,9,299,308
"n1610013","1610013",1028,848,180,9,105,56,158,849,703,146,9,89,38,126
"n1890213","1890213",696,216,480,7,23,430,446,477,172,305,6,10,268,276
"n4530247","4530247",4008,1505,2503,587,574,1335,1854,3423,1405,2018,486,476,1021,1464
"n4690033","4690033",6503,3955,2548,242,373,1909,2203,5006,3298,1708,182,229,1240,1447
"n4910345","4910345",1233,927,306,64,58,169,221,1001,784,217,47,36,119,152
"n1134607","1134607",5573,807,4766,178,209,4352,4531,4012,685,3327,152,154,2999,3135
"n1133078","1133078",4922,431,4491,89,2454,1984,4378,3567,385,3182,67,1794,1327,3099
"n1250006","1250006",326,264,62,0,2,54,56,258,216,42,0,0,37,37
"n1410198","1410198",6524,651,5873,114,465,5358,5694,4145,466,3679,65,240,3361,3564
"n1670148","1670148",6353,3035,3318,75,862,2287,3069,4786,2530,2256,51,557,1536,2070
"n1930001","1930001",1490,1245,245,6,12,197,209,1179,1015,164,3,11,122,133
"n4910307","4910307",956,811,145,24,18,86,95,806,713,93,12,8,51,58
"n2010290","2010290",1841,1239,602,33,86,424,493,1505,1064,441,26,60,307,355
"n2010622","2010622",8455,2228,6227,1360,833,4025,4799,6443,1874,4569,1126,583,2812,3361
"n4394144","4394144",2585,1514,1071,86,178,725,880,2056,1306,750,64,113,494,603
"n4392313","4392313",3006,2018,988,167,297,475,759,2384,1673,711,132,230,308,530
"n4530220","4530220",3187,2565,622,148,65,338,383,2341,1951,390,93,40,221,250
"n4690010","4690010",1993,957,1036,76,187,769,938,1555,827,728,57,128,535,660
"n150101","150101",2253,1321,932,21,277,616,881,1677,1047,630,17,188,405,591
"n292042","292042",3268,147,3121,27,222,2912,3088,2246,105,2141,22,117,2010,2115
"n390005","390005",3574,1895,1679,22,262,1310,1551,2713,1517,1196,15,213,909,1111
"n850153","850153",7377,3672,3705,1778,1025,760,1763,5116,2619,2497,1177,696,522,1212
"n1133009","1133009",0,0,0,0,0,0,0,0,0,0,0,0,0,0
"n1132403","1132403",40,7,33,10,8,18,24,20,3,17,6,5,8,11
"n4530404","4530404",1110,105,1005,11,392,614,995,674,74,600,6,224,378,593
"n5010101","5010101",1917,612,1305,9,23,1258,1277,1403,514,889,5,15,854,869
"n2630101","2630101",283,259,24,2,2,20,21,227,205,22,1,1,19,20
"n277003I","277003I",1960,1669,291,6,46,110,156,1540,1358,182,5,29,73,102
"n3390048","3390048",3140,2395,745,233,61,394,448,2577,2070,507,150,43,264,307
"n4010404","4010404",2350,1664,686,25,265,364,619,1826,1356,470,20,203,228,422
"n4393176","4393176",6482,3415,3067,276,966,1640,2565,5050,2930,2120,198,668,1078,1729
"n4393193","4393193",4009,3092,917,388,121,309,416,3132,2478,654,281,90,203,287
"n1212109","1212109",6245,2109,4136,1310,842,1921,2703,4923,1828,3095,1052,580,1368,1927
"n1573027","1573027",35,5,30,1,21,6,27,31,5,26,0,21,5,26
"n2010144","2010144",1616,33,1583,37,1038,539,1542,1217,27,1190,19,832,336,1159
"n2010150","2010150",3059,39,3020,4,2042,992,3010,2089,34,2055,4,1406,654,2046
"n2010813","2010813",9086,1796,7290,796,1797,4703,6368,6432,1415,5017,592,1193,3200,4327
"n2150143","2150143",6200,340,5860,187,84,5601,5658,4115,249,3866,133,55,3688,3730
"n190204","190204",2316,1672,644,28,27,505,529,1944,1452,492,20,17,380,396
"n293197","293197",0,0,0,0,0,0,0,0,0,0,0,0,0,0
"n390028","390028",6216,2634,3582,1015,740,1763,2476,4349,1955,2394,695,508,1134,1629
"n850053","850053",2790,1981,809,196,138,387,516,2237,1668,569,146,78,263,338
"n850176","850176",7726,3614,4112,1741,1163,1073,2178,6831,3371,3460,1460,962,883,1815
"n1133032","1133032",3209,332,2877,28,547,2308,2808,2402,315,2087,14,430,1623,2037
"n5070003","5070003",2512,64,2448,5,39,2405,2428,1839,35,1804,5,22,1779,1794
"n2010127","2010127",4354,2732,1622,87,495,952,1416,3521,2361,1160,63,346,669,1000
"n2150120","2150120",4503,203,4300,3,12,4278,4282,3046,168,2878,0,3,2865,2866
"n4050011","4050011",591,33,558,6,522,32,553,435,27,408,5,383,21,403
"n4393283","4393283",2166,1514,652,168,80,351,417,1762,1305,457,130,55,230,277
"n4530426","4530426",4192,1537,2655,164,596,1881,2413,3397,1451,1946,146,410,1347,1722
"n5050004","5050004",3512,79,3433,10,12,3415,3420,2346,59,2287,5,11,2274,2279
"n1132222","1132222",3969,3401,568,235,37,180,206,2577,2254,323,130,19,93,104
"n1214207","1214207",1712,1386,326,34,16,240,248,1324,1116,208,28,8,145,148
"n1212086","1212086",4196,2441,1755,388,415,849,1238,3294,2039,1255,294,282,595,860
"n1572115","1572115",2866,403,2463,152,1523,814,2285,2170,366,1804,112,1131,562,1668
"n1572091","1572091",1018,257,761,34,458,271,709,765,225,540,27,333,175,504
"n2010790","2010790",7350,1264,6086,731,1784,3646,5278,5094,984,4110,537,1187,2417,3505
"n213017","213017",4301,2359,1942,47,441,1358,1765,3340,1997,1343,31,338,881,1208
"n4010315","4010315",1269,1028,241,1,63,144,206,988,819,169,1,51,83,134
"n990414","990414",539,475,64,2,7,33,38,402,362,40,0,4,21,24
"n1211058","1211058",4796,2560,2236,212,747,1146,1848,3713,2140,1573,161,502,776,1260
"n2010768","2010768",3719,2482,1237,167,253,724,962,2776,1949,827,124,172,470,633
"n2330033","2330033",2807,1538,1269,24,144,993,1097,2099,1251,848,14,81,656,726
"n2450040","2450040",4584,3524,1060,114,107,701,797,3441,2768,673,83,59,431,483
"n2610002","2610002",74,17,57,0,1,57,57,55,13,42,0,0,42,42
"n270213","270213",5215,4292,923,89,109,592,679,4025,3407,618,58,69,369,434
"n292054","292054",2957,748,2209,68,114,2008,2104,2465,693,1772,56,83,1616,1682
"n690408","690408",792,695,97,5,6,83,85,566,507,59,5,3,48,50
"n850171","850171",4122,1604,2518,1626,449,408,825,3098,1343,1755,1095,311,302,602
"n1134644","1134644",58,14,44,14,26,4,27,40,13,27,7,19,1,20
"n1214203","1214203",4759,3511,1248,449,209,447,646,3307,2542,765,302,127,251,371
"n3090076","3090076",3857,2816,1041,44,105,749,837,2999,2278,721,31,64,497,559
"n3790407","3790407",1524,1334,190,13,29,97,123,1209,1079,130,12,17,57,72
"n4391674","4391674",0,0,0,0,0,0,0,0,0,0,0,0,0,0
"n4393248","4393248",5125,3990,1135,352,182,457,627,4004,3203,801,244,137,310,439
"n4890006","4890006",665,58,607,9,16,599,602,494,48,446,9,10,438,441
"n5030023","5030023",3549,2489,1060,39,121,806,918,2709,2017,692,22,81,506,584
"n1410153","1410153",3860,105,3755,27,57,3687,3722,3097,80,3017,15,36,2968,2994
"n1573079","1573079",670,241,429,381,7,35,42,493,176,317,287,7,20,27
"n2010825","2010825",5495,1406,4089,227,1250,2632,3810,3766,1040,2726,172,877,1660,2507
"n2010577","2010577",3368,1614,1754,532,114,1098,1188,2418,1191,1227,363,73,771,834
"n2011163","2011163",0,0,0,0,0,0,0,0,0,0,0,0,0,0
"n2450100","2450100",4277,2071,2206,882,930,348,1268,3304,1712,1592,628,693,227,918
"n294053","294053",3931,1096,2835,252,643,1990,2548,2976,949,2027,185,467,1366,1793
"n390040","390040",3637,1912,1725,65,172,1388,1542,2831,1618,1213,47,119,962,1071
"n1133050","1133050",4062,101,3961,10,1632,2378,3941,2845,79,2766,1,1303,1498,2757
"n1131734","1131734",2235,1017,1218,281,324,582,896,1867,915,952,224,264,427,689
"n1212104","1212104",6226,2179,4047,607,584,2801,3339,4883,1898,2985,493,416,1998,2394
"n1610009C","1610009C",16,10,6,0,1,5,6,8,6,2,0,0,2,2
"n3670245","3670245",1992,1507,485,19,22,367,388,1579,1244,335,8,12,249,261
"n4392349","4392349",2692,605,2087,635,842,587,1408,1999,500,1499,465,593,414,996
"n4510228","4510228",4899,3084,1815,160,319,1257,1527,4005,2631,1374,109,253,935,1151
"n4530451","4530451",2797,1200,1597,187,222,1175,1365,2350,1069,1281,155,177,924,1081
"n4550018","4550018",140,47,93,1,74,14,88,117,34,83,0,66,13,79
"n1890214","1890214",1154,380,774,12,18,741,752,867,311,556,9,10,532,539
"n2010139","2010139",5786,3712,2074,813,368,817,1162,5274,3482,1792,677,321,709,1017
"n2010477","2010477",8819,3963,4856,1254,1215,2277,3423,6400,3101,3299,871,809,1503,2272
"n2090339","2090339",1460,1126,334,16,9,249,257,1228,966,262,12,7,188,195
"n2410020","2410020",1905,725,1180,17,970,162,1130,1525,597,928,12,763,127,888
"n3290107","3290107",5268,2823,2445,339,501,1479,1948,4070,2373,1697,215,341,1035,1363
"n1131128","1131128",773,662,111,12,22,57,78,622,542,80,9,14,35,49
"n1211001","1211001",2463,1791,672,25,77,478,554,1837,1410,427,14,47,296,342
"n1250001","1250001",134,90,44,2,4,40,40,100,70,30,2,4,26,26
"n1410107","1410107",3146,360,2786,33,120,2648,2749,2519,326,2193,27,104,2066,2158
"n1810302","1810302",6807,3575,3232,106,1038,1862,2837,5250,3066,2184,83,744,1157,1882
"n2011117","2011117",4524,1875,2649,212,901,1489,2344,3270,1461,1809,150,609,985,1579
"n4393409","4393409",201,50,151,6,11,130,140,144,45,99,2,6,85,90
"n4530261","4530261",3288,1996,1292,239,301,708,992,2773,1732,1041,180,246,563,802
"n4910192","4910192",919,401,518,78,165,258,411,733,335,398,64,120,203,316
"n2010871","2010871",90,42,48,0,14,36,48,71,33,38,0,10,28,38
"n2010285","2010285",5334,148,5186,38,1979,3188,5126,3985,121,3864,28,1627,2215,3818
"n2010037","2010037",3626,2371,1255,407,203,587,772,3295,2233,1062,335,171,499,655
"n2870302","2870302",1749,1370,379,8,126,159,282,1331,1084,247,3,84,88,171
"n3870011B","3870011B",0,0,0,0,0,0,0,0,0,0,0,0,0,0
"n4394687","4394687",717,147,570,3,11,557,563,514,114,400,2,3,392,394
"n1134129","1134129",2108,1906,202,58,15,99,112,1636,1486,150,44,7,67,74
"n1132031","1132031",6644,3704,2940,911,828,1133,1898,6023,3489,2534,807,686,960,1613
"n1410007","1410007",4153,1053,3100,92,96,2915,2989,3244,913,2331,58,66,2201,2257
"n1450303","1450303",533,476,57,0,11,43,54,442,401,41,0,10,28,38
"n1670204","1670204",1320,1049,271,11,20,194,207,1168,966,202,10,16,138,151
"n1870223","1870223",479,235,244,3,28,210,229,372,198,174,2,18,154,168
"n4530130","4530130",10378,1918,8460,405,1416,6659,7948,7936,1776,6160,313,1133,4700,5751
"n4530448","4530448",4794,1863,2931,181,554,2169,2662,4044,1709,2335,165,414,1708,2082
"n4790341","4790341",2287,142,2145,39,14,2097,2101,1795,120,1675,34,8,1634,1638
"n4910418","4910418",21,7,14,2,0,12,12,15,7,8,1,0,7,7
"n2010185","2010185",4525,357,4168,137,442,3603,4015,3361,320,3041,118,374,2550,2908
"n2010431","2010431",22307,1213,21094,1930,4456,14800,18990,15519,975,14544,1309,3207,10085,13116
"n2010971","2010971",904,221,683,40,113,523,628,624,176,448,33,86,319,400
"n2150178","2150178",44,12,32,0,1,30,30,36,11,25,0,0,24,24
"n4090104","4090104",2666,729,1937,8,54,1854,1886,1949,608,1341,6,31,1280,1305
"n4392523","4392523",5407,1251,4156,661,1517,1947,3405,4080,1056,3024,529,1068,1380,2426
"n291047","291047",3189,205,2984,17,46,2935,2959,2383,162,2221,16,33,2187,2206
"n1134058","1134058",2375,159,2216,17,131,2067,2190,1751,144,1607,15,112,1473,1584
"n1132007","1132007",3820,3111,709,238,101,279,375,2819,2371,448,149,73,164,235
"n1134649","1134649",744,30,714,12,18,684,700,465,23,442,8,10,422,432
"n1350108","1350108",4426,2086,2340,35,117,2065,2166,3217,1637,1580,31,69,1367,1434
"n1410067","1410067",5164,523,4641,94,260,4303,4515,3977,408,3569,74,211,3288,3463
"n3630004","3630004",786,675,111,5,6,89,95,615,525,90,4,4,71,75
"n3810110","3810110",3596,2455,1141,45,54,951,995,2742,1983,759,29,27,617,637
"n4230081","4230081",503,105,398,3,139,256,395,358,89,269,2,108,159,267
"n4394123","4394123",5406,290,5116,27,86,5013,5079,3798,242,3556,17,61,3477,3525
"n4391366","4391366",15,7,8,1,5,3,7,12,7,5,0,3,1,4
"n1573065B","1573065B",0,0,0,0,0,0,0,0,0,0,0,0,0,0
"n1670276","1670276",3095,2168,927,145,209,514,712,2743,1964,779,125,180,417,594
"n2010159","2010159",2484,401,2083,138,1424,540,1928,1805,388,1417,130,906,387,1271
"n2650220","2650220",2740,2384,356,46,20,228,242,2477,2207,270,29,15,162,175
"n325003B","325003B",812,396,416,5,10,391,394,648,329,319,3,6,301,304
"n3390063A","3390063A",5660,4713,947,74,123,550,664,4354,3706,648,58,73,375,441
"n1134082","1134082",2718,882,1836,171,840,850,1648,2505,861,1644,164,771,729,1463
"n1213147","1213147",5918,4046,1872,883,246,569,794,4419,3160,1259,577,175,367,533
"n1350311","1350311",2242,608,1634,57,114,1434,1537,1622,510,1112,41,67,971,1037
"n1573129","1573129",12368,2913,9455,7614,922,858,1755,8620,2279,6341,5116,608,568,1171
"n2010679","2010679",2136,1072,1064,126,75,832,897,1747,930,817,117,65,602,663
"n2010017","2010017",2055,513,1542,269,412,868,1261,1625,457,1168,223,291,650,931
"n2910002","2910002",1758,1431,327,13,88,176,261,1282,1073,209,8,59,112,168
"n3390043A","3390043A",4905,3629,1276,118,312,718,1002,3806,2930,876,92,199,464,655
"n3750327","3750327",8247,3217,5030,131,2033,2771,4776,7442,2845,4597,93,1991,2444,4408
"n4010303","4010303",3400,1170,2230,37,1178,972,2134,2525,944,1581,20,885,650,1522
"n2011011","2011011",110,4,106,17,17,75,89,91,4,87,12,13,65,75
"n2011060","2011060",7422,287,7135,66,5296,1861,6993,5031,232,4799,48,3542,1219,4696
"n2010514","2010514",7771,3600,4171,756,1320,2051,3300,5818,2956,2862,550,904,1337,2207
"n2090141","2090141",1130,703,427,35,63,304,359,1024,642,382,32,53,277,326
"n2150224","2150224",241,71,170,21,1,146,146,196,61,135,19,0,112,112
"n2310102","2310102",708,571,137,1,17,88,105,568,468,100,0,13,61,74
"n250002","250002",619,275,344,10,7,310,315,508,240,268,10,5,239,243
"n294033","294033",6659,927,5732,74,1362,4401,5630,4872,829,4043,38,967,3055,3962
"n292096","292096",5208,1481,3727,633,690,2462,3064,4286,1344,2942,495,512,1948,2420
"n390060","390060",7611,3125,4486,1245,1083,2105,3132,5412,2305,3107,848,766,1421,2165
"n610096","610096",6270,947,5323,58,96,5166,5217,4473,863,3610,31,64,3480,3527
"n850211","850211",5209,3105,2104,700,701,596,1261,3554,2224,1330,440,444,349,778
"n4910392","4910392",4879,3838,1041,153,166,609,753,3647,3010,637,101,85,373,454
"n2150198","2150198",1056,20,1036,0,6,1033,1034,719,16,703,0,3,700,701
"n227012A","227012A",407,147,260,12,32,209,237,318,120,198,11,19,158,175
"n3030103","3030103",712,495,217,5,11,187,192,525,376,149,3,6,127,130
"n4392449","4392449",2846,577,2269,332,886,1074,1927,2079,474,1605,257,608,742,1333
"n4530264","4530264",4285,2834,1451,387,248,721,945,3337,2263,1074,284,191,525,695
"n4710205","4710205",5171,3926,1245,93,411,646,1049,4526,3460,1066,66,368,549,912
"n1133067","1133067",7015,209,6806,56,6170,667,6717,4673,181,4492,45,4054,422,4425
"n1870206","1870206",5895,1099,4796,44,112,4610,4690,4353,906,3447,32,74,3297,3361
"n2010705","2010705",3221,96,3125,10,2577,596,3113,2016,90,1926,8,1560,386,1919
"n2010537","2010537",4386,2454,1932,605,319,958,1249,3618,2197,1421,447,233,677,897
"n2010868","2010868",4692,341,4351,143,605,3622,4175,3390,300,3090,120,448,2517,2950
"n2150035","2150035",7037,365,6672,43,52,6597,6616,5067,297,4770,34,29,4711,4723
"n211009","211009",4538,1945,2593,88,343,2072,2384,3366,1638,1728,51,237,1346,1565
"n294007","294007",7421,3701,3720,643,1432,1593,2916,5904,3005,2899,503,1158,1205,2292
"n390037","390037",5770,2686,3084,379,775,1841,2578,3958,1951,2007,267,497,1161,1650
"n410008","410008",3921,1859,2062,454,765,815,1528,3144,1619,1525,404,480,592,1051
"n850234","850234",3409,1262,2147,1754,177,182,350,2222,887,1335,1077,106,130,230
"n1134619","1134619",2267,880,1387,70,104,1149,1242,1722,756,966,43,68,795,859
"n4530235","4530235",4495,3548,947,286,103,440,530,3524,2869,655,187,58,308,359
"n4910425","4910425",1203,453,750,5,129,606,724,922,378,544,4,105,419,519
"n2450077","2450077",2802,98,2704,9,2531,151,2673,1803,89,1714,7,1602,91,1692
"n2570007","2570007",5100,2480,2620,279,1219,1055,2221,3562,1885,1677,189,782,640,1401
"n321001F","321001F",1748,442,1306,26,115,1151,1251,1287,381,906,21,67,801,864
"n3290108C","3290108C",0,0,0,0,0,0,0,0,0,0,0,0,0,0
"n3550035","3550035",1335,52,1283,7,18,1259,1274,984,50,934,4,15,913,928
"n4290003","4290003",2683,1610,1073,27,182,822,999,2126,1330,796,16,158,580,734
"n1410209B","1410209B",0,0,0,0,0,0,0,0,0,0,0,0,0,0
"n1670419","1670419",4833,2097,2736,212,1184,1327,2439,3489,1597,1892,159,814,876,1655
"n2010351","2010351",4607,3155,1452,215,317,777,1063,3518,2513,1005,148,243,508,733
"n2010228","2010228",1483,137,1346,77,1182,77,1251,1284,124,1160,63,1025,57,1075
"n2010891","2010891",2924,1268,1656,656,557,444,973,2502,1177,1325,558,429,339,744
"n2150012","2150012",287,5,282,1,0,277,277,215,4,211,1,0,207,207
"n170004A","170004A",1544,134,1410,7,31,1364,1387,1033,105,928,3,13,903,914
"n293028","293028",3132,1172,1960,189,280,1459,1707,2460,968,1492,154,205,1107,1289
"n550302","550302",2046,547,1499,30,86,1366,1432,1517,459,1058,19,60,959,1012
"n870401","870401",533,275,258,10,20,217,236,416,234,182,9,18,145,163
"n1131076","1131076",108,6,102,0,39,62,100,78,6,72,0,28,44,72
"n1133105","1133105",3597,758,2839,150,1674,1002,2639,2740,669,2071,108,1269,682,1925
"n3070201","3070201",1794,791,1003,29,82,877,947,1393,655,738,22,59,643,694
"n3550009","3550009",3220,1241,1979,26,64,1877,1911,2469,1024,1445,13,47,1364,1396
"n4392303","4392303",3668,1872,1796,148,423,1164,1571,2838,1623,1215,110,306,741,1038
"n4410308","4410308",2384,2033,351,29,50,214,255,1779,1548,231,21,27,132,157
"n4530207","4530207",4347,2877,1470,436,148,801,930,3913,2622,1291,387,124,696,804
"n4790406","4790406",1974,44,1930,5,7,1908,1909,1429,32,1397,4,4,1380,1381
"n1430032","1430032",3473,2354,1119,69,71,906,957,2570,1865,705,43,42,535,575
"n1830020","1830020",6986,1155,5831,55,3108,2631,5679,5025,990,4035,47,2322,1620,3919
"n1990016","1990016",3982,3409,573,50,51,329,380,2984,2620,364,28,33,192,225
"n2010494","2010494",7787,251,7536,253,2194,5188,7267,5335,196,5139,201,1558,3411,4919
"n2310324","2310324",4036,2876,1160,98,272,543,799,3079,2303,776,74,188,351,531
"n2910031","2910031",6392,1624,4768,33,81,4569,4620,4128,1304,2824,21,51,2692,2726
"n292119","292119",598,160,438,39,104,289,392,478,142,336,37,66,227,292
"n610073","610073",6388,655,5733,146,62,5550,5586,4889,541,4348,129,36,4192,4210
"n990311","990311",9898,4986,4912,564,1962,2212,3967,7381,3870,3511,449,1306,1609,2800
"n1134036","1134036",2046,64,1982,31,509,1463,1948,1471,59,1412,21,389,1015,1387
"n1131044","1131044",4358,2470,1888,171,1007,690,1677,3340,1964,1376,122,753,479,1216
"n1134028","1134028",2107,58,2049,27,648,1358,1992,1566,42,1524,21,544,933,1472
"n4470001","4470001",348,318,30,0,0,23,23,284,264,20,0,0,15,15
"n4510318","4510318",4342,2912,1430,32,132,1114,1227,3311,2354,957,20,92,708,799
"n4730313","4730313",2417,1447,970,27,141,745,876,1909,1246,663,27,105,475,576
"n2350100","2350100",378,244,134,6,8,128,132,274,177,97,2,2,94,95
"n2950202","2950202",197,129,68,2,2,53,54,155,107,48,2,2,37,38
"n4391430","4391430",28,4,24,3,7,14,21,21,2,19,1,7,11,18
"n4391440","4391440",4802,612,4190,258,1706,2254,3903,3363,536,2827,187,1176,1455,2608
"n4392358","4392358",3388,2174,1214,123,501,529,1004,2640,1789,851,86,353,360,703
"n4394429","4394429",4290,2171,2119,245,763,1085,1785,2837,1524,1313,167,480,629,1088
"n1133087","1133087",0,0,0,0,0,0,0,0,0,0,0,0,0,0
"n1131404","1131404",1333,208,1125,33,542,562,1084,996,185,811,31,411,368,772
"n1131740","1131740",7752,2014,5738,1413,1457,2819,4224,5813,1696,4117,1092,1024,1922,2928
"n1950005","1950005",962,397,565,3,6,550,556,664,323,341,1,2,332,334
"n2010471","2010471",4403,2319,2084,58,174,1746,1892,3327,1890,1437,46,118,1180,1280
"n2170008","2170008",3204,2722,482,11,74,269,335,2648,2311,337,9,46,170,216
"n10011","10011",8669,3272,5397,43,3195,2130,5305,8373,3078,5295,38,3155,2088,5223
"n293071","293071",4087,1350,2737,234,305,2218,2445,3357,1216,2141,199,225,1726,1900
"n510211","510211",1518,994,524,3,193,302,472,1213,838,375,1,136,210,339
"n1090002","1090002",553,117,436,9,7,424,425,433,103,330,2,6,324,325
"n1131717","1131717",6886,1595,5291,263,1583,3383,4913,4849,1371,3478,207,993,2217,3184
"n1134559","1134559",0,0,0,0,0,0,0,0,0,0,0,0,0,0
"n3190302","3190302",1027,849,178,6,9,155,164,851,727,124,2,3,109,112
"n3730020","3730020",1172,1021,151,4,16,80,95,958,861,97,2,11,45,56
"n4370001","4370001",1485,553,932,3,176,753,912,1222,488,734,2,155,563,714
"n4394272","4394272",969,683,286,62,46,158,197,826,599,227,51,39,110,147
"n4490017","4490017",1520,216,1304,25,203,1090,1268,1061,191,870,15,136,724,849
"n4850202","4850202",8783,3707,5076,167,2350,2394,4678,7369,3138,4231,129,1991,1952,3913
"n1391003","1391003",3133,1642,1491,28,312,1051,1347,2164,1213,951,19,200,653,845
"n1670480","1670480",2823,1210,1613,167,557,880,1394,2027,950,1077,133,373,543,906
"n2010371","2010371",842,11,831,1,569,268,830,642,9,633,1,463,171,633
"n2011034","2011034",3271,366,2905,345,888,1708,2528,2358,303,2055,292,587,1188,1738
"n2070006","2070006",500,343,157,2,16,122,137,386,282,104,1,13,74,86
"n2450057","2450057",1013,22,991,8,909,74,976,811,20,791,5,739,50,784
"n130018","130018",2503,673,1830,13,30,1755,1781,1883,545,1338,6,20,1287,1306
"n293048","293048",2117,1375,742,109,114,501,600,1780,1193,587,85,84,392,470
"n294013","294013",1576,150,1426,8,35,1372,1393,1253,123,1130,5,32,1082,1100
"n410002","410002",3839,2426,1413,166,219,939,1130,2987,2015,972,131,140,633,761
"n530016","530016",749,613,136,13,7,94,99,602,512,90,10,6,60,64
"n910201","910201",6522,3857,2665,236,322,1998,2277,4821,2979,1842,147,226,1356,1561
"n4910340","4910340",2818,1805,1013,367,127,437,557,2045,1382,663,240,75,299,372
"n3030129","3030129",5145,3133,2012,321,359,1268,1589,4011,2580,1431,234,251,883,1116
"n323001D","323001D",2364,32,2332,2,5,2305,2306,1528,22,1506,2,5,1494,1495
"n3630029","3630029",1773,1109,664,20,80,535,614,1285,825,460,16,55,361,415
"n4391024","4391024",6522,3363,3159,148,1034,1833,2813,4657,2666,1991,94,642,1126,1747
"n4530175","4530175",32,3,29,2,12,22,27,18,3,15,0,5,15,15
"n4810201","4810201",3472,2508,964,20,137,779,895,2674,2021,653,10,91,514,598
"n1134521","1134521",7016,1835,5181,528,1392,3143,4463,5359,1622,3737,419,1045,2180,3186
"n1410044","1410044",6423,1545,4878,384,1039,3557,4398,4583,1215,3368,280,721,2370,3002
"n1670390","1670390",6074,3820,2254,313,641,1219,1835,4440,2928,1512,228,406,800,1202
"n1870112","1870112",675,284,391,7,92,277,368,663,282,381,7,89,271,360
"n2010394","2010394",3064,428,2636,28,138,2469,2576,2235,346,1889,23,94,1766,1842
"n2450034","2450034",1998,130,1868,52,1602,212,1790,1581,92,1489,27,1316,130,1435
"n50027","50027",572,441,131,2,34,76,106,434,352,82,2,10,48,58
"n292139","292139",2663,819,1844,122,187,1554,1699,2072,663,1409,87,147,1174,1293
"n291053","291053",499,60,439,16,30,402,423,345,42,303,10,21,276,293
"n610053","610053",9135,190,8945,6,41,8899,8913,6258,120,6138,2,29,6113,6123
"n850085","850085",4474,2285,2189,805,582,705,1266,3638,1962,1676,709,384,504,877
"n970010","970010",2461,2137,324,18,18,177,189,1978,1761,217,11,9,121,128
"n4530104","4530104",3739,2648,1091,239,221,562,759,3224,2335,889,190,195,461,635
"n4530424","4530424",8665,1498,7167,335,761,6077,6746,6343,1391,4952,262,552,4119,4626
"n4770117","4770117",228,49,179,7,99,70,166,174,42,132,5,81,44,123
"n2150241","2150241",3886,67,3819,2,10,3811,3811,2299,43,2256,0,7,2255,2255
"n2450014","2450014",2845,95,2750,136,1521,1094,2602,2092,83,2009,106,1183,714,1890
"n2650113","2650113",1797,1424,373,29,20,281,296,1483,1218,265,20,15,193,206
"n3030026","3030026",5749,750,4999,36,704,4300,4904,4195,650,3545,22,452,3054,3477
"n4394135","4394135",2410,1229,1181,57,232,840,1053,1905,1053,852,40,170,577,738
"n4392616","4392616",15,1,14,1,11,1,12,13,1,12,1,10,1,11
"n1132001","1132001",65,7,58,0,4,55,58,57,7,50,0,3,47,50
"n1133024","1133024",3345,51,3294,11,2114,1202,3270,2221,36,2185,7,1456,729,2167
"n1870410","1870410",206,90,116,5,6,91,96,164,81,83,1,4,68,71
"n2010414","2010414",5085,2566,2519,71,569,1798,2323,3847,2132,1715,48,375,1209,1563
"n2010165","2010165",5294,1928,3366,291,315,2727,2990,3985,1612,2373,229,218,1900,2078
"n2010663","2010663",930,589,341,68,38,208,242,695,461,234,44,34,139,172
"n292034","292034",3012,938,2074,10,328,1750,2049,2630,919,1711,7,294,1410,1693
"n294133","294133",71,30,41,0,14,25,38,60,30,30,0,9,20,28
"n370016","370016",1889,1652,237,12,100,58,156,1432,1271,161,6,74,36,109
"n730013","730013",1857,1412,445,10,72,317,386,1399,1115,284,7,41,189,229
"n1131096","1131096",4038,174,3864,20,296,3541,3816,2844,150,2694,16,252,2416,2655
"n1133204","1133204",5108,949,4159,60,1488,2617,4043,3718,849,2869,47,1127,1679,2779
"n2830005","2830005",1829,357,1472,6,172,1293,1461,1494,318,1176,4,170,1003,1170
"n3390002","3390002",4423,2029,2394,112,381,1830,2183,3256,1661,1595,80,266,1190,1438
"n4392224","4392224",3874,1130,2744,244,1805,674,2436,3211,1009,2202,218,1414,551,1936
"n4410105","4410105",7824,4089,3735,562,1328,1769,2940,6062,3406,2656,424,891,1188,2025
"n4650043","4650043",73,53,20,3,2,14,15,61,46,15,1,1,11,12
"n49902-3","49902-3",4600,3438,1162,54,331,655,970,3698,2892,806,35,252,414,659
"n1574101","1574101",7563,636,6927,901,2015,4053,5978,5601,518,5083,709,1442,2933,4319
"n2010557","2010557",6156,301,5855,1252,800,3736,4456,4698,272,4426,1077,594,2689,3236
"n2011054","2011054",5947,3037,2910,468,568,1801,2317,4582,2519,2063,355,372,1255,1601
"n2010059","2010059",3564,2538,1026,159,160,647,793,3076,2216,860,122,146,530,667
"n2030018","2030018",2653,1665,988,12,445,485,917,2092,1421,671,2,336,288,618
"n2270012","2270012",1544,319,1225,15,103,1088,1174,1093,239,854,9,68,755,815
"n110301","110301",392,346,46,6,5,21,22,288,257,31,5,1,14,15
"n291090","291090",0,0,0,0,0,0,0,0,0,0,0,0,0,0
"n850048","850048",5805,3492,2313,951,593,645,1214,4798,2967,1831,767,470,492,947
"n910401","910401",4435,3404,1031,51,104,776,864,3660,2911,749,32,73,560,622
"n1134101","1134101",264,3,261,3,30,229,255,196,1,195,1,17,177,192
"n1212084","1212084",5748,2814,2934,248,672,1902,2541,4438,2388,2050,193,436,1307,1726
"n3510006","3510006",1329,721,608,5,543,44,582,1005,574,431,5,382,28,410
"n3650029","3650029",436,396,40,0,7,25,32,331,313,18,0,2,14,16
"n4090121","4090121",4045,1833,2212,137,149,1900,2004,3085,1475,1610,97,103,1381,1454
"n4391197","4391197",6495,3238,3257,979,1023,1117,2094,4714,2432,2282,706,721,741,1437
"n4530473","4530473",3448,1172,2276,242,331,1719,1992,2517,961,1556,173,226,1163,1358
"n4530150B","4530150B",97,38,59,26,9,24,29,53,20,33,15,5,15,16
"n1410024","1410024",4725,1426,3299,172,160,2969,3089,3801,1244,2557,139,96,2308,2387
"n1470019","1470019",3168,2320,848,32,303,389,677,2363,1816,547,18,205,228,424
"n2010202","2010202",2868,96,2772,16,1866,956,2741,1941,86,1855,15,1240,637,1832
"n2010451","2010451",3690,2459,1231,174,447,568,967,3099,2239,860,126,310,373,661
"n2410002","2410002",774,720,54,1,12,16,26,667,623,44,1,7,13,20
"n2570033","2570033",963,485,478,19,231,183,406,813,421,392,15,180,151,325
"n293091","293091",979,713,266,31,14,213,225,801,605,196,17,6,167,173
"n490113","490113",3926,2606,1320,24,327,908,1225,3236,2214,1022,20,278,667,940
"n1132603","1132603",8233,1352,6881,5323,825,676,1468,5974,1205,4769,3635,606,483,1068
"n1132132","1132132",2833,427,2406,139,261,1987,2231,1987,383,1604,110,202,1283,1470
"n1211021","1211021",5284,3157,2127,953,503,543,1020,3783,2328,1455,624,387,352,727
"n1410087","1410087",1254,388,866,87,115,616,719,928,227,701,50,66,546,605
"n3610018","3610018",3107,2747,360,57,16,184,197,2363,2143,220,32,8,100,108
"n4230007","4230007",3588,2084,1504,45,588,792,1366,2645,1709,936,31,356,483,832
"n4393157","4393157",4688,2342,2346,152,797,1273,2017,3469,1918,1551,105,519,829,1323
"n4393517","4393517",4753,2345,2408,328,1199,837,1987,3956,2159,1797,265,858,607,1441
"n4850401","4850401",3525,2476,1049,132,197,624,804,2894,2165,729,101,128,412,533
"n1710002","1710002",1963,1260,703,16,19,634,642,1605,1115,490,12,13,436,443
"n1810412","1810412",1834,1450,384,28,121,124,240,1437,1192,245,24,68,67,133
"n2010805","2010805",3613,2633,980,115,246,542,768,2902,2222,680,78,164,372,525
"n2150098","2150098",6842,257,6585,23,58,6523,6538,5008,222,4786,20,36,4746,4761
"n3090014","3090014",3555,781,2774,52,1942,797,2680,3058,747,2311,48,1625,637,2226
"n3130303","3130303",2869,1200,1669,25,913,666,1571,2092,949,1143,16,655,431,1084
"n294076","294076",7911,1226,6685,518,1503,4848,6118,5474,961,4513,377,955,3201,4064
"n294070","294070",5366,770,4596,125,1289,3239,4410,3877,604,3273,99,1006,2160,3116
"n390023","390023",7727,4058,3669,180,577,2769,3261,5731,3253,2478,128,379,1831,2182
"n390017","390017",5939,1559,4380,65,677,3666,4240,4336,1279,3057,32,464,2544,2960
"n550203","550203",2316,1130,1186,15,138,994,1108,1705,935,770,12,99,616,708
"n1213121","1213121",6262,1705,4557,150,444,3886,4285,4468,1472,2996,116,301,2492,2780
"n4790417","4790417",1441,48,1393,5,5,1387,1388,1034,34,1000,5,1,996,996
"n4910487","4910487",172,133,39,4,9,24,28,135,107,28,3,9,16,20
"n4910472","4910472",774,619,155,9,14,89,100,660,543,117,8,10,64,71
"n2090253","2090253",4941,1815,3126,186,409,2483,2846,3608,1413,2195,129,306,1712,1990
"n3550015","3550015",2084,399,1685,20,84,1565,1621,1428,325,1103,12,42,1022,1059
"n3670445","3670445",2733,2403,330,37,40,180,215,1892,1685,207,32,31,102,129
"n3670410","3670410",2994,2564,430,47,56,252,301,2286,2004,282,21,33,161,192
"n4030008","4030008",463,391,72,1,40,17,55,353,308,45,1,23,11,33
"n4050006","4050006",372,325,47,0,20,19,39,291,259,32,0,11,14,25
"n1213127","1213127",10511,2798,7713,663,3622,3362,6855,8140,2492,5648,524,2694,2342,4952
"n1391046","1391046",394,304,90,3,14,63,77,290,235,55,2,14,35,49
"n1391040","1391040",399,335,64,0,11,35,43,323,279,44,0,8,20,28
"n2010991","2010991",6717,1745,4972,534,1804,2605,4320,4550,1310,3240,383,1166,1637,2767
"n2010997","2010997",5313,506,4807,113,3680,1040,4636,3879,462,3417,99,2621,717,3293
"n2090223","2090223",4391,1551,2840,136,274,2359,2576,3225,1250,1975,82,168,1639,1785
"n294176","294176",1397,737,660,54,60,547,592,1167,655,512,45,47,412,448
"n292076","292076",3491,1100,2391,120,241,2011,2212,2640,913,1727,95,158,1443,1584
"n294219","294219",4,0,4,0,0,4,4,0,0,0,0,0,0,0
"n670004","670004",1041,787,254,7,182,49,222,815,628,187,4,139,33,165
"n1133968","1133968",5570,2670,2900,293,1209,1298,2466,4250,2231,2019,219,805,882,1673
"n1219100","1219100",0,0,0,0,0,0,0,0,0,0,0,0,0,0
"n3390081","3390081",5528,3835,1693,396,229,902,1108,4330,3169,1161,249,155,624,765
"n3810317","3810317",309,194,115,4,11,95,102,271,176,95,4,10,76,83
"n3890008","3890008",1059,127,932,10,23,899,913,792,114,678,4,15,653,664
"n4391594","4391594",0,0,0,0,0,0,0,0,0,0,0,0,0,0
"n4690025","4690025",7016,3304,3712,278,654,2774,3341,5360,2810,2550,215,400,1897,2260
"n1310003","1310003",455,23,432,1,1,426,427,386,23,363,1,0,358,358
"n1572171","1572171",4822,1012,3810,2091,1205,537,1688,3447,765,2682,1417,896,356,1228
"n2011140","2011140",358,111,247,8,155,86,234,270,101,169,8,102,58,156
"n2010600","2010600",8181,1264,6917,1178,1798,3971,5663,6379,1104,5275,975,1343,2968,4224
"n2011097","2011097",2863,524,2339,215,1235,950,2110,2141,471,1670,175,853,671,1483
"n2230001","2230001",3583,2561,1022,65,367,510,868,2696,2011,685,43,261,320,578
"n294027","294027",2556,354,2202,24,202,1982,2163,2059,327,1732,19,173,1533,1694
"n292176","292176",1670,565,1105,214,109,759,859,1262,450,812,154,82,552,630
"n610016","610016",1299,262,1037,7,5,1017,1017,952,255,697,7,1,680,680
"n850042","850042",3106,1927,1179,64,177,852,1013,2176,1388,788,50,111,557,665
"n910303","910303",1402,561,841,15,47,743,780,1143,486,657,12,34,578,608
"n1134097","1134097",2198,374,1824,43,122,1638,1755,1652,343,1309,31,106,1159,1261
"n411002A","411002A",715,591,124,0,10,80,90,584,507,77,0,3,51,54
"n4391211","4391211",4839,247,4592,61,2668,1895,4507,3241,186,3055,38,1926,1093,2996
"n4392426","4392426",3468,2159,1309,201,489,520,987,2588,1685,903,127,336,344,673
"n4530483","4530483",10048,1118,8930,346,753,7877,8525,6913,955,5958,254,517,5171,5638
"n4530154B","4530154B",85,40,45,6,18,23,38,48,21,27,4,6,18,23
"n2090444","2090444",3453,2769,684,87,52,418,467,2635,2194,441,52,33,269,302
"n2150204","2150204",1673,185,1488,12,14,1460,1465,1187,166,1021,12,5,1001,1002
"n2390005","2390005",943,610,333,19,35,256,284,700,466,234,8,27,183,206
"n3030112","3030112",2736,1712,1024,208,148,623,755,2153,1461,692,154,95,396,489
"n3290309","3290309",1732,305,1427,15,235,1160,1382,1147,227,920,10,131,771,895
"n3490406","3490406",385,315,70,2,7,50,55,301,256,45,2,5,30,33
"n1133073","1133073",261,3,258,13,164,81,245,186,3,183,5,136,42,178
"n1212078","1212078",2987,1575,1412,482,407,482,875,2288,1252,1036,373,282,341,617
"n1490316","1490316",2936,1729,1207,20,124,1024,1137,2293,1462,831,11,91,691,776
"n1650006","1650006",961,301,660,1,6,644,649,679,232,447,1,5,435,439
"n2010457","2010457",0,0,0,0,0,0,0,0,0,0,0,0,0,0
"n2010699","2010699",3071,1699,1372,647,130,544,669,2435,1403,1032,498,98,394,490
"n270109","270109",5373,1421,3952,270,2424,1342,3542,4096,1236,2860,215,1723,920,2532
"n293134","293134",4147,1268,2879,253,482,2151,2565,3462,1091,2371,208,398,1750,2105
"n410089A","410089A",18,9,9,0,1,7,8,13,9,4,0,1,2,3
"n850191","850191",1136,520,616,17,12,554,565,826,440,386,13,7,333,339
"n1132311","1132311",2432,175,2257,38,142,2070,2208,1644,144,1500,36,98,1358,1454
"n1134677","1134677",2049,85,1964,1877,52,30,78,1263,56,1207,1160,26,18,43
"n3090056","3090056",1878,437,1441,19,267,1168,1397,1339,376,963,10,159,785,937
"n3550114","3550114",1312,136,1176,41,51,1076,1117,984,111,873,32,31,795,825
"n4230050","4230050",3105,2268,837,42,350,372,717,2455,1889,566,27,242,238,477
"n4393333","4393333",6048,4004,2044,319,584,921,1471,4813,3365,1448,229,398,626,1006
"n4530301","4530301",3451,2158,1293,222,487,515,988,3321,2092,1229,198,470,487,948
"n4910143","4910143",1121,371,750,75,227,410,620,809,280,529,49,165,286,440
"n1410130","1410130",7151,544,6607,186,330,6193,6411,5253,434,4819,123,219,4504,4673
"n1790005","1790005",4532,3255,1277,78,131,944,1061,3368,2581,787,57,76,556,632
"n2010308","2010308",4531,305,4226,91,1043,3127,4114,3305,273,3032,70,768,2216,2943
"n2010848","2010848",3123,522,2601,89,988,1521,2460,2404,473,1931,60,778,1063,1822
"n2150055","2150055",4225,177,4048,17,33,4008,4018,2925,142,2783,13,16,2753,2761
"n2490011","2490011",1238,110,1128,13,11,1106,1114,910,99,811,8,7,797,801
"n270210","270210",6491,1660,4831,434,3012,1492,4225,4492,1236,3256,274,1997,961,2831
"n1134504","1134504",2490,485,2005,133,423,1430,1815,1826,431,1395,99,314,958,1260
"n1133030","1133030",40,10,30,0,9,18,26,24,8,16,0,8,5,13
"n1131313","1131313",583,39,544,29,269,245,512,431,30,401,28,196,178,372
"n1214205B","1214205B",413,166,247,202,27,18,43,265,117,148,116,16,16,30
"n1410150","1410150",3361,124,3237,12,40,3199,3219,2638,108,2530,4,21,2495,2512
"n3470034","3470034",7066,3942,3124,124,1656,1231,2861,6514,3848,2666,103,1292,1168,2441
"n3670430","3670430",4566,3718,848,105,85,544,615,3023,2521,502,69,36,314,348
"n419001N","419001N",2478,1298,1180,41,274,853,1111,1830,1051,779,23,190,544,731
"n4391651","4391651",0,0,0,0,0,0,0,0,0,0,0,0,0,0
"n790101","790101",631,212,419,2,23,387,406,451,170,281,2,19,252,271
"n1133028","1133028",1700,30,1670,6,1145,517,1652,1272,28,1244,1,915,327,1234
"n2150082","2150082",17,1,16,0,0,15,15,10,1,9,0,0,9,9
"n2010057","2010057",4536,3319,1217,212,109,772,862,3714,2775,939,147,67,600,661
"n4550016","4550016",904,647,257,4,167,75,240,689,505,184,1,122,54,175
"n2790006","2790006",743,226,517,2,32,481,508,564,200,364,2,24,334,357
"n4393433","4393433",839,648,191,51,37,83,118,709,553,156,32,36,65,99
"n293176","293176",76,25,51,20,5,21,26,48,19,29,11,3,13,16
"n38702-1A","38702-1A",219,47,172,3,150,16,164,179,39,140,0,129,7,134
"n1133315","1133315",4385,828,3557,98,1501,1940,3400,3038,704,2334,70,1000,1232,2212
"n3550095","3550095",1284,153,1131,10,35,1102,1121,986,118,868,10,17,846,858
"n397002F","397002F",1596,896,700,27,292,353,631,1282,771,511,16,221,240,454
"n489001A","489001A",2234,58,2176,2,18,2153,2168,1561,43,1518,2,12,1498,1510
"n1410048","1410048",3324,422,2902,63,248,2623,2821,2575,370,2205,49,184,1968,2134
"n293115","293115",2107,1204,903,107,47,736,770,1761,1075,686,76,34,560,583
"n4650010","4650010",5102,441,4661,43,84,4536,4585,3667,384,3283,30,59,3191,3230
"n2910003","2910003",4001,3081,920,36,177,617,781,2976,2386,590,24,119,386,498
"n2010183","2010183",3386,2531,855,479,25,296,316,2380,1846,534,293,14,189,202
"n2030019","2030019",5558,3873,1685,30,556,847,1387,4026,2954,1072,25,361,479,835
"n4810402","4810402",3528,1183,2345,15,269,2052,2289,2557,984,1573,11,165,1375,1531
"n292074","292074",1976,98,1878,14,24,1843,1857,1463,71,1392,8,13,1369,1377
"n710001","710001",697,519,178,6,75,79,149,530,402,128,6,56,44,100
"n4393032","4393032",2230,1265,965,69,196,637,821,1758,1091,667,46,130,435,559
"n4393334","4393334",3559,2030,1529,212,617,615,1195,2893,1773,1120,148,442,452,869
"n4850206","4850206",5292,4170,1122,80,304,608,870,4008,3277,731,46,168,387,540
"n4393698","4393698",5856,3171,2685,731,743,1124,1814,3982,2235,1747,498,459,704,1144
"n2010352","2010352",8771,4210,4561,335,562,3559,4047,6590,3434,3156,242,385,2412,2759
"n1133969","1133969",3564,2251,1313,271,467,511,946,2919,1938,981,233,349,353,684
"n2950207A","2950207A",569,302,267,5,1,255,256,411,248,163,2,1,154,155
"n3030011","3030011",378,47,331,6,123,218,324,265,42,223,4,90,134,217
"n1134037","1134037",358,28,330,0,37,295,328,276,26,250,0,32,221,249
"n2870405","2870405",1216,956,260,7,92,126,211,868,723,145,4,52,67,118
"n850029","850029",4679,3303,1376,354,414,515,914,2798,1988,810,213,244,294,530
"n4910203","4910203",194,159,35,11,3,21,22,144,121,23,7,1,15,16
"n2150039","2150039",4890,100,4790,7,44,4753,4780,3313,68,3245,3,26,3223,3237
"n1571145","1571145",5747,2213,3534,1391,653,1407,2037,4027,1621,2406,957,439,953,1375
"n3670265","3670265",2044,1547,497,16,36,352,382,1575,1254,321,9,24,214,237
"n293118","293118",1629,651,978,69,275,620,851,1304,602,702,53,185,441,603
"n4394233","4394233",3542,699,2843,73,246,2510,2717,2689,629,2060,54,171,1813,1969
"n2010438","2010438",6032,3859,2173,497,555,1040,1544,4124,2754,1370,319,345,647,975
"n294014","294014",820,61,759,11,19,727,742,663,58,605,5,18,576,591
"n2010335","2010335",11171,552,10619,586,1141,8893,9940,7525,434,7091,428,767,5908,6619
"n1133109","1133109",4751,1944,2807,312,1533,910,2399,3845,1714,2131,253,1190,618,1783
"n3750122","3750122",5624,3241,2383,213,776,1276,1989,4539,2811,1728,178,519,910,1401
"n3810123","3810123",914,818,96,7,11,66,72,676,615,61,2,2,41,43
"n1133318","1133318",2327,566,1761,104,829,823,1630,1738,505,1233,73,622,524,1135
"n3630030","3630030",1700,822,878,21,154,669,816,1224,631,593,17,114,438,549
"n2010206","2010206",5080,1761,3319,200,152,2924,3054,4166,1545,2621,148,111,2311,2408
"n4790415","4790415",3370,100,3270,5,16,3246,3253,2417,65,2352,3,13,2334,2340
"n1410174","1410174",87,15,72,0,1,70,71,78,15,63,0,1,61,62
"n292180A","292180A",5976,1296,4680,310,566,3904,4346,4128,931,3197,223,341,2639,2933
"n4393526","4393526",1642,1194,448,246,39,109,148,1225,924,301,152,37,73,110
"n850132","850132",4176,2392,1784,469,639,616,1215,3425,2066,1359,389,474,443,899
"n4393037","4393037",3747,2706,1041,206,249,505,730,3029,2331,698,142,153,331,472
"n2090371","2090371",3343,1698,1645,162,201,1262,1422,2538,1352,1186,117,149,884,1014
"n4392442","4392442",4423,2000,2423,1173,703,519,1179,3468,1659,1809,875,524,378,872
"n2570031","2570031",2109,852,1257,38,546,647,1177,1386,628,758,25,320,397,710
"n3550115","3550115",3279,1094,2185,155,260,1745,1957,2622,957,1665,123,183,1312,1476
"n2011098","2011098",3778,127,3651,328,1174,2153,3286,2775,89,2686,271,896,1494,2372
"n1410131","1410131",6485,473,6012,161,335,5544,5820,4255,312,3943,98,207,3638,3816
"n2011141","2011141",0,0,0,0,0,0,0,0,0,0,0,0,0,0
"n2011035","2011035",121,61,60,19,19,24,42,87,46,41,11,12,18,30
"n4392221","4392221",2541,1231,1310,295,673,331,981,1802,911,891,205,456,205,655
"n850175","850175",2771,1570,1201,560,259,313,562,1949,1177,772,365,169,183,347
"n2790010","2790010",841,282,559,1,44,504,545,655,247,408,1,32,365,397
"n4570016","4570016",960,877,83,11,20,19,37,723,670,53,8,9,13,22
"n294057","294057",1950,1144,806,148,180,451,615,1613,996,617,110,137,332,462
"n4393282","4393282",2456,1726,730,68,174,412,576,1956,1421,535,52,130,286,408
"n2650211","2650211",2444,1460,984,65,103,768,859,2152,1326,826,52,91,640,724
"n2010163","2010163",7048,634,6414,38,142,6245,6331,5181,550,4631,35,107,4482,4555
"n2090142","2090142",5153,1334,3819,1901,392,1487,1874,5093,1312,3781,1896,373,1470,1840
"n2510030","2510030",3809,3032,777,30,112,497,590,2699,2198,501,25,75,295,358
"n3950016","3950016",373,303,70,17,12,32,42,291,246,45,12,9,16,23
"n610097","610097",795,66,729,2,4,716,718,645,65,580,2,3,568,569
"n1470004","1470004",2610,1827,783,33,300,382,671,1982,1470,512,27,214,221,430
"n850238","850238",7051,2794,4257,1775,1507,956,2381,4900,2102,2798,1142,1022,592,1576
"n2132GBN","2132GBN",4057,3369,688,54,94,395,479,3168,2692,476,31,64,264,320
"n3590403","3590403",214,166,48,4,5,38,43,162,129,33,2,3,27,30
"n1134508","1134508",2294,373,1921,16,239,1651,1879,1541,293,1248,14,146,1070,1211
"n1133900","1133900",6382,702,5680,44,3560,2090,5581,4435,565,3870,31,2485,1335,3795
"n2010395","2010395",2422,1644,778,194,160,392,539,1935,1370,565,139,102,280,375
"n1573137","1573137",1469,127,1342,235,347,766,1092,1002,99,903,183,239,479,710
"n293032","293032",25,13,12,0,1,9,9,24,13,11,0,0,8,8
"n850072","850072",2706,1308,1398,578,257,520,767,2191,1139,1052,461,172,374,542
"n1133008","1133008",1624,704,920,106,550,261,783,1452,684,768,98,445,219,638
"n4790135","4790135",2540,53,2487,0,9,2480,2483,1758,25,1733,0,3,1726,1729
"n2010292","2010292",3262,96,3166,28,818,2337,3126,2340,80,2260,23,621,1626,2224
"n294120","294120",599,163,436,91,120,212,330,525,158,367,80,100,178,276
"n2690004","2690004",64,62,2,0,0,2,2,39,39,0,0,0,0,0
"n1134083","1134083",2460,624,1836,122,497,1229,1686,2102,613,1489,110,448,934,1351
"n1133071","1133071",3306,65,3241,33,2468,769,3198,2502,58,2444,29,1976,456,2412
"n2010100","2010100",4220,816,3404,34,509,2870,3330,3036,695,2341,25,351,1962,2286
"n730014","730014",2095,1578,517,18,67,402,464,1612,1270,342,12,44,253,295
"n2010229","2010229",2209,151,2058,8,71,1974,2034,1632,142,1490,6,50,1426,1469
"n1410068","1410068",1661,434,1227,69,187,960,1124,1387,410,977,58,150,752,884
"n1572097","1572097",7699,3711,3988,1132,1547,1233,2704,5174,2557,2617,788,994,753,1725
"n2011164","2011164",0,0,0,0,0,0,0,0,0,0,0,0,0,0
"n4910147","4910147",8913,4580,4333,1073,1078,2098,3067,7446,4078,3368,857,795,1607,2339
"n467001A","467001A",3345,2786,559,34,41,373,409,2649,2283,366,17,21,230,248
"n510204","510204",730,539,191,3,79,108,179,585,460,125,1,54,65,118
"n4394136","4394136",6096,2240,3856,73,422,3260,3657,4477,1931,2546,61,282,2101,2373
"n850009","850009",5686,2768,2918,211,1021,1592,2552,4006,2144,1862,157,634,976,1588
"n4394328","4394328",4316,1540,2776,210,326,2136,2445,3200,1304,1896,165,243,1411,1642
"n3030113","3030113",5069,2127,2942,432,744,1783,2435,3673,1714,1959,330,404,1186,1567
"n1410197","1410197",7750,419,7331,153,258,7017,7173,5418,319,5099,99,162,4874,4990
"n1950006","1950006",1110,538,572,0,6,550,554,820,439,381,0,3,362,365
"n293055","293055",4759,2999,1760,218,132,1376,1474,3454,2307,1147,127,71,905,966
"n293029","293029",1605,606,999,116,62,791,847,1324,538,786,94,51,614,663
"n4710303","4710303",1124,527,597,4,214,361,574,864,427,437,2,170,252,422
"n2010143","2010143",6777,2666,4111,1571,1236,1268,2453,4754,2062,2692,1003,783,834,1597
"n2090136","2090136",8714,897,7817,47,164,7612,7717,5833,751,5082,30,102,4930,5008
"n770026","770026",238,220,18,2,1,11,12,192,178,14,1,1,7,8
"n292160","292160",463,145,318,35,77,209,278,310,100,210,26,49,138,181
"n4392524","4392524",2744,2230,514,95,136,215,342,2246,1862,384,73,89,171,255
"n4790132","4790132",10691,972,9719,36,86,9603,9659,7622,888,6734,23,68,6641,6694
"n2030016","2030016",886,770,116,1,52,43,95,678,591,87,1,48,22,70
"n2010186","2010186",1637,33,1604,7,355,1256,1597,1226,14,1212,4,274,941,1208
"n293179","293179",0,0,0,0,0,0,0,0,0,0,0,0,0,0
"n3610016","3610016",3563,3081,482,14,34,294,328,2729,2388,341,8,21,194,215
"n1133094","1133094",42,15,27,3,17,4,20,28,14,14,3,7,0,7
"n4393417","4393417",4562,2437,2125,429,673,890,1520,3149,1765,1384,282,427,588,994
"n2910007","2910007",3001,1564,1437,42,411,931,1332,2181,1235,946,26,266,599,864
"n3630008","3630008",2166,1836,330,21,18,218,228,1713,1475,238,15,15,148,158
"n1133610","1133610",789,167,622,4,374,232,602,622,154,468,2,283,173,455
"n2010501","2010501",3115,2090,1025,272,191,512,695,2546,1748,798,197,160,397,553
"n2570011","2570011",3514,2193,1321,66,471,692,1130,2493,1689,804,40,284,397,667
"n610054","610054",6965,305,6660,72,59,6524,6562,5271,261,5010,62,32,4895,4921
"n1470001","1470001",5164,3149,2015,37,966,935,1889,4558,2758,1800,31,914,789,1696
"n3550073","3550073",2370,221,2149,17,77,2064,2118,1815,182,1633,17,44,1572,1604
"n1134062","1134062",4929,191,4738,11,62,4670,4705,3543,168,3375,11,38,3328,3356
"n4393359","4393359",2930,2162,768,398,76,196,267,2068,1605,463,249,56,108,160
"n1410088","1410088",7440,3171,4269,768,1382,1958,3123,5242,2181,3061,616,951,1341,2129
"n610074","610074",10708,230,10478,40,42,10416,10425,7218,161,7057,25,25,7013,7020
"n730046","730046",1091,820,271,3,81,164,245,851,669,182,2,66,95,161
"n4392613","4392613",4307,616,3691,637,1899,1149,2996,2981,461,2520,468,1276,762,2019
"n2850119","2850119",1037,817,220,6,47,136,181,823,660,163,2,36,100,134
"n2990109","2990109",3328,2966,362,29,28,216,238,3105,2826,279,28,19,154,172
"n2010375","2010375",12491,1162,11329,99,507,10768,11200,8298,969,7329,77,361,6911,7233
"n670005","670005",1019,816,203,6,109,57,161,836,695,141,6,81,37,113
"n4850209","4850209",263,82,181,8,127,55,171,187,63,124,7,82,37,118
"n4393172","4393172",5120,2753,2367,144,720,1356,2038,3840,2268,1572,110,446,905,1326
"n4393585","4393585",31,8,23,2,7,9,15,28,7,21,2,6,8,14
"n2930104","2930104",902,800,102,15,23,39,61,794,704,90,14,17,32,49
"n293138","293138",182,77,105,4,20,81,97,71,36,35,3,6,26,29
"n610011","610011",3929,105,3824,10,14,3789,3796,2861,92,2769,8,7,2745,2749
"n1134141","1134141",180,113,67,14,16,31,47,147,99,48,14,15,16,31
"n1410025","1410025",5514,1154,4360,284,304,3781,4024,4563,1043,3520,236,221,3059,3239
"n2011118","2011118",6496,535,5961,425,3657,1854,5391,4853,454,4399,354,2634,1376,3930
"n2010249","2010249",6363,2352,4011,106,1141,2696,3740,4749,2017,2732,84,757,1802,2522
"n3590202","3590202",222,169,53,3,10,29,39,168,134,34,2,6,19,25
"n1133980","1133980",6032,2517,3515,1504,839,1070,1887,4405,1966,2439,1080,543,719,1261
"n294037","294037",3584,155,3429,35,1178,2282,3378,2613,128,2485,25,962,1519,2444
"n293075","293075",3430,2214,1216,235,62,915,960,2804,1903,901,156,34,681,710
"n4394093","4394093",5273,317,4956,22,122,4816,4896,3667,273,3394,13,75,3296,3347
"n4392134","4392134",3565,461,3104,746,1408,976,2330,2678,356,2322,610,1044,679,1692
"n1410212","1410212",3275,319,2956,105,310,2580,2840,2058,235,1823,79,174,1585,1741
"n2594100","2594100",3317,2610,707,27,13,598,608,2722,2190,532,24,4,443,447
"n4790345","4790345",2910,137,2773,28,15,2721,2729,2199,106,2093,19,11,2054,2059
"n850089","850089",4633,2115,2518,1873,293,285,569,3593,1730,1863,1405,211,196,402
"n3030059","3030059",5600,2519,3081,173,648,2192,2764,4259,2107,2152,150,396,1515,1894
"n1133051","1133051",1261,34,1227,3,772,457,1219,945,31,914,1,641,277,910
"n3630027","3630027",2708,2090,618,27,80,442,502,2080,1665,415,23,53,289,331
"n2090442","2090442",4019,3084,935,247,85,501,581,3116,2470,646,183,50,343,390
"n4690003","4690003",1920,855,1065,17,99,940,1024,1536,752,784,12,66,688,752
"n293012","293012",1616,895,721,94,78,537,600,1220,714,506,57,47,372,415
"n4730311","4730311",6106,41,6065,23,5472,450,5911,5955,37,5918,13,5369,415,5774
"n3670435","3670435",4320,3542,778,76,45,520,558,2978,2522,456,41,19,299,317
"n3090001","3090001",804,328,476,49,230,204,413,658,291,367,43,164,154,310
"n2011055","2011055",5346,1899,3447,1162,1191,1036,2185,3822,1466,2356,786,834,701,1509
"n850026","850026",2589,952,1637,177,373,1028,1388,1935,801,1134,141,229,710,931
"n1132809","1132809",5466,2059,3407,1292,1070,1015,2021,4373,1834,2539,943,814,740,1523
"n4392356","4392356",5009,2196,2813,490,1223,1058,2214,4004,1897,2107,389,907,755,1632
"n1410151","1410151",4729,75,4654,17,53,4584,4606,3539,60,3479,8,37,3423,3445
"n2730043","2730043",2334,182,2152,22,29,2117,2125,1792,148,1644,17,17,1617,1623
"n3730007","3730007",1402,772,630,41,270,293,551,1050,605,445,37,182,205,383
"n2010312","2010312",10494,3492,7002,2031,2121,2876,4844,8525,3000,5525,1526,1747,2259,3885
"n4910396","4910396",1965,1840,125,9,15,63,77,1948,1834,114,8,7,61,68
"n2150122","2150122",6630,111,6519,15,21,6490,6500,4341,59,4282,6,2,4278,4279
"n850215","850215",4145,2334,1811,81,254,1364,1591,2942,1789,1153,52,164,844,995
"n3090021","3090021",2334,1356,978,213,284,317,599,2071,1206,865,191,223,295,516
"n1574026","1574026",4068,1700,2368,1681,241,396,626,3154,1368,1786,1269,193,280,469
"n2010521","2010521",5526,1450,4076,458,1156,2509,3600,4130,1177,2953,352,820,1793,2572
"n294097","294097",4251,1536,2715,292,685,1788,2395,3068,1215,1853,215,462,1179,1601
"n2150165","2150165",1372,98,1274,5,7,1253,1257,1024,88,936,2,4,921,924
"n1134530","1134530",2038,102,1936,33,520,1385,1895,1258,79,1179,25,310,842,1147
"n1610003","1610003",246,190,56,5,15,25,40,179,144,35,3,12,9,21
"n4394432","4394432",280,153,127,2,63,66,126,251,151,100,1,51,49,99
"n294054","294054",5553,1802,3751,471,1043,2269,3206,4268,1486,2782,358,769,1622,2343
"n890103","890103",915,594,321,5,72,236,303,675,466,209,2,49,148,196
"n3030151","3030151",1345,929,416,6,10,344,350,1003,694,309,5,7,248,251
"n4394604","4394604",22,4,18,2,6,7,13,15,0,15,2,3,7,10
"n294011","294011",2450,141,2309,18,656,1672,2274,1739,118,1621,14,493,1126,1599
"n1134130","1134130",2137,1708,429,88,52,253,303,1714,1405,309,59,26,188,214
"n2010478","2010478",6872,2801,4071,670,1453,1947,3307,5358,2432,2926,506,1019,1362,2340
"n910405","910405",7195,4904,2291,113,138,1770,1866,5556,3985,1571,67,79,1181,1238
"n10017","10017",1371,841,530,8,207,292,495,1082,698,384,4,168,191,358
"n1134080","1134080",845,588,257,39,36,165,193,694,498,196,31,24,120,142
"n4394230","4394230",5205,3775,1430,267,426,697,1093,4569,3417,1152,224,328,549,857
"n2010435","2010435",5052,3330,1722,606,296,747,1020,4596,3153,1443,479,254,638,877
"n4910306","4910306",5158,4220,938,156,129,539,649,4096,3416,680,115,101,368,462
"n3030056","3030056",1785,1017,768,14,59,669,717,1314,824,490,7,32,424,455
"n3950008","3950008",284,271,13,1,0,10,10,252,242,10,0,0,8,8
"n4050010","4050010",519,457,62,4,26,29,53,404,360,44,2,19,18,36
"n1573080","1573080",2422,691,1731,1366,206,130,336,1916,601,1315,1033,153,105,258
"n2150079","2150079",4300,91,4209,11,23,4185,4192,2728,52,2676,1,12,2665,2669
"n2010564","2010564",7897,2066,5831,2857,1991,946,2871,7164,1923,5241,2588,1766,846,2563
"n2010349","2010349",3177,1409,1768,167,564,1014,1524,2496,1157,1339,143,435,720,1135
"n1134626","1134626",4702,1792,2910,506,299,2021,2305,3647,1559,2088,402,203,1399,1592
"n1133966","1133966",6149,2460,3689,866,1283,1448,2690,4547,2029,2518,621,829,967,1780
"n294140","294140",0,0,0,0,0,0,0,0,0,0,0,0,0,0
"n850172","850172",7985,4759,3226,259,1038,1661,2654,5577,3514,2063,181,668,1008,1653
"n4850203","4850203",4194,2554,1640,190,691,650,1303,3431,2169,1262,144,523,492,998
"n2090438","2090438",777,474,303,178,6,105,110,470,286,184,110,5,62,66
"n2930406","2930406",197,189,8,0,2,4,4,184,178,6,0,0,2,2
"n4890010","4890010",335,240,95,0,1,86,87,299,223,76,0,1,67,68
"n850086","850086",4082,2222,1860,851,546,392,911,3250,1871,1379,641,393,277,652
"n21304LP","21304LP",3710,2911,799,43,322,315,619,2993,2461,532,27,233,180,404
"n3870017","3870017",550,462,88,7,24,26,48,449,376,73,5,19,22,39
"n4394498","4394498",660,587,73,13,13,40,52,518,463,55,10,8,30,38
"n1572090","1572090",885,396,489,52,297,139,426,730,358,372,43,227,89,315
"n293173","293173",5264,2047,3217,663,358,2226,2525,3855,1588,2267,435,227,1574,1782
"n4910333","4910333",1004,584,420,224,55,145,192,712,441,271,128,42,95,133
"n2010392","2010392",1816,27,1789,10,1459,348,1774,1369,17,1352,9,1141,213,1340
"n4394087","4394087",1503,106,1397,6,34,1358,1383,1087,88,999,4,28,966,990
"n1212108","1212108",3758,960,2798,560,549,1661,2195,2730,829,1901,409,388,1076,1460
"n4410404","4410404",3947,2217,1730,55,306,1317,1563,3039,1855,1184,41,201,879,1068
"n2150225","2150225",682,28,654,6,1,647,647,480,23,457,4,1,451,451
"n294157","294157",2514,526,1988,37,65,1883,1930,2052,483,1569,22,54,1480,1525
"n1134651","1134651",373,23,350,5,10,337,344,251,14,237,1,5,233,235
"n2010729","2010729",560,388,172,45,19,98,116,506,362,144,34,16,82,97
"n1770003","1770003",2830,923,1907,15,146,1744,1867,2127,797,1330,13,119,1186,1293
"n4170101A","4170101A",284,232,52,3,11,34,45,188,159,29,0,2,24,26
"n1610011C","1610011C",0,0,0,0,0,0,0,0,0,0,0,0,0,0
"n2250007","2250007",1276,948,328,14,153,127,275,977,762,215,10,104,71,172
"n390047","390047",4860,2011,2849,228,608,1952,2529,3476,1567,1909,136,402,1286,1675
"n3210005","3210005",3008,1751,1257,21,320,872,1168,2251,1342,909,16,240,604,836
"n4950301","4950301",1956,800,1156,24,56,1074,1109,1414,642,772,18,42,703,735
"n2150139","2150139",1121,74,1047,1,4,1031,1033,895,63,832,1,2,816,818
"n2010624","2010624",2313,1128,1185,117,353,689,1011,1570,828,742,82,215,418,616
"n4230034","4230034",2239,376,1863,31,1029,807,1811,1632,340,1292,19,771,498,1256
"n2010667","2010667",2976,1643,1333,205,297,831,1097,2399,1411,988,167,231,570,781
"n4510319","4510319",5241,3253,1988,172,277,1481,1717,4090,2699,1391,128,179,1015,1182
"n1211045","1211045",4911,3131,1780,154,452,998,1430,3774,2532,1242,99,305,683,972
"n505001B","505001B",134,4,130,1,4,126,127,85,4,81,0,4,80,81
"n1670420","1670420",5179,2652,2527,284,714,1433,2119,3745,2035,1710,228,459,941,1389
"n2010538","2010538",3785,181,3604,46,2642,948,3528,2926,162,2764,38,2108,620,2697
"n1131135","1131135",3733,125,3608,11,788,2799,3574,2668,113,2555,8,636,1895,2526
"n2170009","2170009",2122,1307,815,12,119,618,727,1730,1108,622,12,96,448,539
"n1810306","1810306",6222,5038,1184,73,72,695,760,4675,3964,711,46,32,390,420
"n4393671","4393671",1251,983,268,42,48,137,183,997,807,190,29,34,95,129
"n3810111","3810111",9444,3290,6154,605,640,4796,5340,6707,2747,3960,416,357,3042,3368
"n212016","212016",3710,2816,894,46,132,635,751,2886,2262,624,24,102,425,519
"n4790312","4790312",2544,38,2506,6,17,2473,2479,1732,29,1703,3,9,1678,1681
"n2150036","2150036",5669,175,5494,27,34,5439,5451,4182,127,4055,17,21,4017,4027
"n4393398","4393398",2566,1668,898,130,181,509,680,1963,1339,624,107,115,342,452
"n3070202","3070202",122,108,14,0,1,10,10,105,93,12,0,1,8,8
"n1131051","1131051",325,197,128,15,24,79,100,282,192,90,9,13,52,64
"n3730001","3730001",597,517,80,0,12,48,60,476,413,63,0,10,37,47
"n3290109","3290109",1867,448,1419,45,114,1247,1334,1290,350,940,27,73,810,878
"n3030008","3030008",4579,2494,2085,460,498,1035,1497,4182,2300,1882,405,461,928,1357
"n50006","50006",1554,925,629,5,153,498,599,1273,763,510,2,130,415,493
"n37004D","37004D",139,53,86,6,43,34,76,100,44,56,4,23,26,49
"n3990008","3990008",845,626,219,4,24,177,200,696,531,165,1,21,131,152
"n2010372","2010372",2315,102,2213,190,1147,916,2019,1708,93,1615,169,855,614,1445
"n850066","850066",3398,1784,1614,223,359,952,1300,2651,1517,1134,180,239,653,889
"n1211005","1211005",15,1,14,1,1,8,8,8,1,7,1,0,5,5
"n294203","294203",363,166,197,21,27,147,173,347,164,183,21,27,133,159
"n4393582","4393582",108,46,62,12,10,32,38,85,41,44,9,4,26,28
"n850109","850109",6069,3372,2697,1570,456,593,1039,4733,2767,1966,1148,341,416,754
"n2930101","2930101",2988,1796,1192,30,527,616,1113,2304,1475,829,18,370,399,765
"n2010584","2010584",4449,54,4395,13,3015,1364,4341,3359,48,3311,6,2444,852,3273
"n294160","294160",4335,585,3750,126,1233,2501,3602,2914,442,2472,93,781,1633,2353
"n1134654","1134654",4491,511,3980,57,188,3739,3905,3156,427,2729,41,136,2545,2671
"n4394020","4394020",3962,2013,1949,133,348,1341,1676,2976,1673,1303,103,243,862,1095
"n2990101","2990101",295,245,50,3,2,35,36,235,197,38,2,1,24,25
"n4970002","4970002",4861,3114,1747,67,106,1483,1571,3578,2435,1143,45,55,966,1012
"n294034","294034",2968,443,2525,33,512,2008,2475,2292,394,1898,25,422,1463,1858
"n3090041","3090041",2770,1541,1229,43,503,651,1120,2353,1407,946,38,410,459,855
"n1134603","1134603",224,29,195,0,4,191,195,151,22,129,0,4,125,129
"n2010541","2010541",4803,257,4546,263,3855,479,4245,3884,230,3654,239,3056,392,3385
"n4394703","4394703",5706,2215,3491,378,936,2125,2975,3852,1590,2262,273,561,1365,1891
"n1550301","1550301",272,215,57,2,3,47,48,224,181,43,2,1,35,35
"n2010458","2010458",4304,154,4150,70,1583,2541,4073,3081,134,2947,58,1229,1678,2882
"n1134107","1134107",322,3,319,3,52,263,314,236,3,233,2,42,188,229
"n1573131A","1573131A",2293,874,1419,618,323,460,769,1874,763,1111,477,259,350,599
"n4394288","4394288",1054,40,1014,4,228,777,995,709,27,682,3,147,523,668
"n294077","294077",8541,1269,7272,154,1299,5928,7053,5803,1030,4773,106,858,3823,4608
"n1573011","1573011",2054,1010,1044,636,137,257,385,1613,805,808,514,95,176,266
"n850235","850235",3269,1103,2166,1582,273,261,523,2381,897,1484,1084,176,184,354
"n3670235","3670235",1488,1175,313,19,25,186,211,1183,961,222,9,14,132,146
"n4910144","4910144",1213,526,687,46,135,493,618,904,412,492,37,87,353,436
"n2150013","2150013",8781,690,8091,365,186,7556,7682,6650,590,6060,301,135,5609,5712
"n150103","150103",1960,1486,474,10,138,279,406,1577,1250,327,8,95,188,276
"n293193","293193",239,126,113,13,7,87,94,176,108,68,7,7,53,60
"n3030033","3030033",4907,3160,1747,40,52,1537,1576,3534,2333,1201,20,29,1053,1078
"n2090340","2090340",3261,2067,1194,78,152,928,1058,2811,1833,978,68,126,751,866
"n4530134","4530134",4065,1540,2525,504,620,1384,1959,3357,1414,1943,411,477,1022,1470
"n1212088","1212088",3659,1811,1848,144,407,1190,1576,2838,1501,1337,107,259,874,1122
"n850023","850023",7236,1740,5496,1056,1634,2735,4313,5638,1569,4069,855,1244,1909,3113
"n1134059","1134059",1155,66,1089,47,332,713,1039,735,38,697,43,214,443,653
"n3070401","3070401",1264,802,462,8,27,411,432,950,629,321,7,15,285,300
"n930016","930016",118,105,13,0,2,5,7,89,80,9,0,1,2,3
"n3310212","3310212",3617,1626,1991,22,783,1166,1911,2827,1385,1442,17,591,797,1376
"n3950004","3950004",875,698,177,22,48,103,147,680,544,136,19,37,72,109
"n1670206","1670206",6426,3316,3110,660,950,1404,2301,5571,3038,2533,587,752,1074,1798
"n4910302","4910302",1309,694,615,457,21,116,137,892,519,373,275,16,70,86
"n250006","250006",1619,663,956,11,28,882,899,1250,537,713,10,13,651,663
"n1134077","1134077",1592,526,1066,49,107,907,1004,1257,457,800,42,89,660,744
"n4850402","4850402",1301,851,450,31,112,270,377,970,704,266,19,59,155,213
"n4910189","4910189",6652,3198,3454,1872,300,1185,1439,4501,2275,2226,1221,193,717,886
"n4510106","4510106",3369,838,2531,25,136,2336,2451,2401,679,1722,14,88,1577,1657
"n2150182","2150182",6482,112,6370,15,13,6347,6349,3645,68,3577,8,6,3562,3564
"n4090105","4090105",2729,334,2395,6,39,2338,2371,1931,284,1647,5,29,1600,1626
"n2210103","2210103",4383,3519,864,50,55,604,652,3509,2922,587,43,26,388,409
"n4530110","4530110",4509,1307,3202,151,1649,1420,3022,3612,1184,2428,124,1258,1041,2272
"n294051","294051",2169,1128,1041,97,220,703,905,1875,1037,838,80,183,546,720
"n1590402","1590402",1061,822,239,16,20,137,153,868,712,156,6,9,88,95
"n4910422","4910422",7077,3262,3815,523,1164,2088,3165,5198,2525,2673,359,804,1427,2190
"n325004A","325004A",2712,1305,1407,8,32,1324,1346,2044,1052,992,1,21,929,943
"n4010316","4010316",766,605,161,2,95,44,138,603,489,114,1,74,24,98
"n419009S","419009S",1374,1007,367,6,175,130,303,1065,802,263,2,136,77,213
"n90001","90001",1984,1746,238,16,21,115,131,1507,1355,152,9,12,71,80
"n870402","870402",124,100,24,1,5,19,23,101,86,15,1,3,11,14
"n2150056","2150056",4444,136,4308,14,23,4268,4278,3112,99,3013,6,13,2988,2996
"n1010201","1010201",349,256,93,3,26,62,85,266,221,45,1,11,30,39
"n850192","850192",3887,2578,1309,66,230,849,1078,2753,1922,831,44,132,536,668
"n3150003","3150003",933,665,268,8,148,59,205,724,539,185,8,107,38,143
"n3730021","3730021",3736,2701,1035,38,291,602,881,2988,2228,760,34,215,413,625
"n1571142","1571142",8001,3197,4804,2666,445,1598,2008,5262,2153,3109,1712,279,1043,1306
"n4410109","4410109",421,357,64,1,13,31,43,326,285,41,1,9,18,26
"n10013","10013",3109,1711,1398,42,588,724,1294,2276,1399,877,29,371,424,787
"n3810324","3810324",6652,5012,1640,116,217,1113,1305,5118,4001,1117,79,130,730,853
"n850129","850129",7174,3868,3306,599,1562,1042,2551,5293,3022,2271,430,1048,688,1705
"n2010415","2010415",3223,2100,1123,309,247,519,740,2742,1841,901,260,201,394,578
"n2150119","2150119",2150,35,2115,2,8,2107,2111,1551,25,1526,1,8,1518,1522
"n1450401","1450401",893,740,153,5,25,101,124,666,561,105,4,5,76,81
"n1131080","1131080",2463,219,2244,13,1249,977,2207,1815,193,1622,10,952,653,1589
"n4394508","4394508",7370,3305,4065,900,1130,1876,2929,5523,2728,2795,636,739,1257,1963
"n4393160","4393160",6317,2065,4252,915,1104,1714,2768,4685,1735,2950,671,730,1168,1871
"n2010266","2010266",7246,897,6349,71,547,5761,6253,5076,785,4291,61,333,3896,4208
"n2830006","2830006",621,108,513,2,4,506,506,462,85,377,0,2,372,372
"n1672321","1672321",0,0,0,0,0,0,0,0,0,0,0,0,0,0
"n1133205","1133205",2967,148,2819,65,1792,996,2755,2182,125,2057,42,1324,702,2011
"n293049","293049",2700,1825,875,71,98,639,722,2120,1469,651,55,74,465,534
"n293135","293135",1422,567,855,55,144,650,785,1211,540,671,53,89,519,606
"n1110004","1110004",85,74,11,0,0,11,11,62,52,10,0,0,10,10
"n1410191","1410191",946,62,884,12,36,836,862,633,55,578,10,24,541,561
"n2010647","2010647",13289,457,12832,4620,4996,3338,8188,9721,364,9357,3815,3310,2288,5527
"n130004","130004",2141,518,1623,13,27,1576,1596,1527,413,1114,9,23,1073,1091
"n4790239","4790239",3906,114,3792,33,19,3736,3747,2999,94,2905,25,12,2868,2875
"n323002D","323002D",211,10,201,3,6,194,195,155,10,145,1,3,141,141
"n2070004","2070004",414,279,135,3,22,105,119,341,225,116,2,16,87,100
"n3650027","3650027",2220,1054,1166,35,746,369,1106,1672,836,836,20,564,234,794
"n4210101","4210101",150,73,77,1,7,67,72,117,66,51,1,4,46,48
"n1670354","1670354",7221,4046,3175,574,716,1737,2412,5411,3154,2257,423,520,1163,1669
"n50028","50028",1582,1122,460,12,87,342,427,1217,896,321,8,66,229,294
"n4474006","4474006",236,191,45,3,4,34,37,178,150,28,2,1,19,20
"n1211025","1211025",3393,1475,1918,1342,205,315,509,2181,1028,1153,790,140,183,321
"n2150205","2150205",1050,17,1033,0,6,1030,1030,686,9,677,0,4,674,674
"n910402","910402",6292,4896,1396,110,79,934,996,5234,4248,986,68,51,649,692
"n4391059","4391059",1572,175,1397,195,539,676,1197,1091,155,936,98,403,437,832
"n1490207","1490207",2257,1861,396,3,75,268,336,1914,1635,279,1,48,181,229
"n2010309","2010309",6030,4472,1558,702,183,555,732,4029,3012,1017,437,142,367,507
"n850003","850003",6624,1070,5554,117,1478,3960,5350,4774,940,3834,75,1006,2701,3675
"n1134527","1134527",4876,643,4233,42,110,4061,4150,3440,563,2877,34,71,2745,2804
"n2090231","2090231",6508,2234,4274,221,520,3574,4003,4419,1692,2727,142,352,2229,2537
"n4970023","4970023",3226,2524,702,14,45,463,498,2410,1944,466,13,19,292,307
"n3990005","3990005",224,181,43,2,1,35,36,186,160,26,2,1,19,20
"n2010604","2010604",5707,4118,1589,74,198,1090,1270,4340,3319,1021,45,121,674,790
"n294180","294180",8,0,8,1,4,7,7,4,0,4,1,0,3,3
"n1574015","1574015",2490,1082,1408,43,128,1219,1333,1843,892,951,22,100,809,901
"n293092","293092",3079,2212,867,85,40,680,711,2492,1856,636,56,29,498,519
"n1573071","1573071",1258,146,1112,747,206,152,356,837,106,731,515,117,90,206
"n3030052","3030052",4817,3009,1808,189,239,1301,1503,3405,2246,1159,122,141,800,933
"n2010432","2010432",9341,948,8393,293,923,7168,8014,6840,795,6045,232,722,5067,5751
"n2150076","2150076",98,13,85,0,1,82,83,61,12,49,0,1,46,47
"n2010475","2010475",2408,422,1986,380,293,1320,1591,1780,342,1438,285,205,944,1143
"n2970012","2970012",169,125,44,0,1,34,34,136,102,34,0,1,25,25
"n4394596","4394596",295,32,263,77,3,177,180,211,28,183,65,1,114,115
"n1134127","1134127",598,504,94,34,9,42,50,478,410,68,19,9,26,34
"n3090018","3090018",1905,1065,840,164,305,347,630,1702,994,708,151,243,284,517
"n3870005","3870005",2253,1975,278,10,60,117,173,1731,1546,185,8,34,67,99
"n4050007","4050007",443,357,86,3,37,42,76,353,294,59,1,27,27,52
"n2150162","2150162",1002,219,783,78,21,687,703,801,193,608,57,12,537,547
"n1133206","1133206",3354,1176,2178,98,730,1326,2030,2605,1053,1552,77,563,866,1420
"n214025","214025",4469,1201,3268,25,707,2551,3189,3295,1001,2294,20,499,1744,2227
"n2010821","2010821",6952,209,6743,103,1495,5281,6614,4573,146,4427,80,1025,3401,4327
"n2850101","2850101",2004,1613,391,14,210,167,366,1572,1322,250,7,135,104,234
"n2010036","2010036",8983,529,8454,1090,1575,5926,7344,6465,490,5975,879,1238,3954,5088
"n2510009","2510009",1654,1336,318,14,25,199,219,1278,1077,201,5,15,118,133
"n1131730","1131730",0,0,0,0,0,0,0,0,0,0,0,0,0,0
"n3390097","3390097",4297,3560,737,81,99,480,574,3216,2684,532,67,63,336,397
"n1410003","1410003",5733,513,5220,58,94,5048,5125,4228,453,3775,38,67,3652,3709
"n2011013","2011013",0,0,0,0,0,0,0,0,0,0,0,0,0,0
"n410061","410061",58,48,10,0,5,1,6,41,33,8,0,4,0,4
"n2450033","2450033",5299,2236,3063,74,1205,1691,2863,4289,2010,2279,58,957,1163,2099
"n291128","291128",5399,1089,4310,78,747,3513,4194,4347,977,3370,67,630,2662,3267
"n2450096","2450096",1158,100,1058,60,416,584,992,829,90,739,47,307,380,686
"n4391642","4391642",4490,943,3547,268,2102,1179,3210,3180,754,2426,202,1448,762,2180
"n4391427","4391427",16,10,6,0,1,5,6,13,10,3,0,1,2,3
"n2010907","2010907",584,84,500,14,395,87,478,347,66,281,10,219,52,267
"n610032","610032",5523,906,4617,81,96,4436,4488,4056,775,3281,67,59,3145,3180
"n3550074","3550074",2850,139,2711,20,70,2651,2694,2096,107,1989,13,28,1951,1973
"n4391271","4391271",4666,3205,1461,129,415,798,1179,3407,2496,911,81,232,492,712
"n4392448","4392448",5309,1289,4020,877,1696,1440,3086,4031,1071,2960,684,1268,970,2220
"n292095","292095",3353,1032,2321,96,186,2059,2201,2611,905,1706,66,122,1522,1614
"n2570032","2570032",4012,2154,1858,159,770,814,1549,2676,1527,1149,110,464,481,937
"n467001B","467001B",5286,4068,1218,13,81,954,1031,3974,3205,769,9,37,594,629
"n1290101","1290101",820,654,166,2,38,91,127,708,577,131,2,30,69,97
"n2011099","2011099",27,6,21,0,2,17,18,12,2,10,0,1,9,10
"n2010884","2010884",1723,72,1651,76,788,795,1567,1257,69,1188,60,580,547,1120
"n1132131","1132131",3737,1050,2687,259,1312,1082,2348,3237,991,2246,232,1101,865,1942
"n2450010","2450010",1624,280,1344,29,687,630,1298,1226,255,971,21,505,437,936
"n291066","291066",1723,212,1511,10,22,1477,1491,1294,168,1126,8,13,1102,1112
"n4391740","4391740",0,0,0,0,0,0,0,0,0,0,0,0,0,0
"n550205","550205",433,341,92,3,19,66,80,342,284,58,2,8,42,49
"n2010970","2010970",4793,175,4618,122,1306,3224,4453,3383,151,3232,88,1014,2141,3113
"n3510020","3510020",203,47,156,0,153,0,153,160,32,128,0,125,0,125
"n4530371","4530371",3642,2572,1070,267,105,616,703,2790,2037,753,189,56,431,484
"n1430031","1430031",1777,1402,375,13,8,295,301,1437,1177,260,7,4,197,201
"n2510031","2510031",2762,1953,809,33,95,546,634,2065,1553,512,16,51,342,389
"n3550011","3550011",989,230,759,5,17,743,750,718,190,528,3,6,518,523
"n2010101","2010101",3625,197,3428,31,1005,2436,3379,2509,166,2343,24,739,1610,2310
"n2070005","2070005",584,388,196,1,19,147,163,448,310,138,0,13,99,111
"n1132046","1132046",2383,1910,473,146,53,209,255,1730,1412,318,107,36,135,165
"n1370003","1370003",363,212,151,8,4,134,136,277,182,95,3,2,81,83
"n4530447","4530447",2223,1025,1198,99,114,934,1031,1773,899,874,73,95,657,742
"n1132500","1132500",2472,1618,854,205,116,492,600,2001,1361,640,181,77,343,415
"n470002","470002",1883,369,1514,6,8,1487,1493,1541,356,1185,3,6,1165,1171
"n2010267","2010267",3639,415,3224,27,83,3104,3167,2568,364,2204,19,60,2109,2159
"n2011036","2011036",63,35,28,18,2,7,9,49,28,21,13,0,7,7
"n1950004","1950004",1080,575,505,1,7,488,494,761,430,331,0,6,316,322
"n410064","410064",4452,3417,1035,580,83,284,357,3299,2590,709,416,58,167,220
"n4392052","4392052",7856,2849,5007,2019,1620,1256,2844,7241,2671,4570,1878,1495,1091,2560
"n1131403","1131403",99,24,75,1,6,64,70,77,24,53,0,5,45,50
"n270313","270313",6413,4350,2063,218,665,1066,1663,5312,3832,1480,165,470,712,1155
"n610055","610055",5787,706,5081,36,42,5008,5014,4316,629,3687,23,22,3634,3638
"n2010781","2010781",8601,527,8074,1631,653,5770,6338,6431,473,5958,1368,441,4104,4500
"n2570029","2570029",4850,1528,3322,115,1922,1281,3113,3165,1086,2079,81,1206,761,1924
"n4392435","4392435",4458,2058,2400,424,1195,710,1862,3403,1702,1701,287,846,496,1324
"n3390021","3390021",7592,4120,3472,259,937,2111,2997,6071,3559,2512,191,689,1467,2130
"n2010118","2010118",4150,1917,2233,647,776,729,1475,2733,1276,1457,435,522,446,953
"n1132804","1132804",3613,1992,1621,908,163,469,624,2614,1570,1044,591,96,297,386
"n4690024","4690024",1924,1400,524,8,60,427,475,1488,1115,373,5,41,300,339
"n2010161","2010161",1842,93,1749,19,1077,684,1717,1393,77,1316,12,871,462,1297
"n4530203","4530203",3650,2465,1185,501,84,545,617,3438,2306,1132,477,79,523,590
"n292135","292135",1648,313,1335,53,96,1186,1259,1214,265,949,31,77,835,900
"n4392223","4392223",2293,1625,668,154,236,229,454,1851,1387,464,107,156,156,306
"n2010993","2010993",0,0,0,0,0,0,0,0,0,0,0,0,0,0
"n291151","291151",4508,1320,3188,452,708,2049,2670,3024,940,2084,306,431,1306,1714
"n1133069","1133069",2441,61,2380,21,1879,486,2339,1816,49,1767,14,1467,284,1741
"n3610017","3610017",3033,2774,259,25,28,132,159,2341,2164,177,17,15,96,111
"n1810405","1810405",1503,837,666,106,253,239,482,1092,682,410,62,160,140,297
"n4530475","4530475",2768,612,2156,24,92,2035,2114,2007,529,1478,13,77,1367,1440
"n2010950","2010950",4,0,4,2,1,3,3,4,0,4,2,1,3,3
"n270102","270102",7127,4355,2772,202,999,1523,2420,5894,3710,2184,150,865,1102,1904
"n1890419","1890419",460,296,164,1,0,151,151,322,204,118,1,0,111,111
"n4391479","4391479",507,69,438,10,87,341,420,368,62,306,10,77,217,289
"n1214202","1214202",5038,3798,1240,333,274,516,779,3445,2657,788,210,188,300,481
"n1132086","1132086",3483,2480,1003,188,195,536,718,3053,2207,846,154,149,460,602
"n3470026","3470026",7264,2476,4788,92,1828,2789,4582,5193,2041,3152,70,1295,1713,2990
"n2550001","2550001",2504,748,1756,21,105,1644,1712,1862,613,1249,19,72,1159,1209
"n1410026","1410026",2504,580,1924,65,70,1793,1835,1991,518,1473,49,50,1361,1397
"n292010","292010",4015,770,3245,125,377,2748,3073,3084,687,2397,94,267,2023,2270
"n1132153","1132153",2775,1036,1739,140,582,999,1557,2296,943,1353,127,458,743,1188
"n2410015","2410015",3733,3285,448,14,228,111,333,2879,2549,330,12,160,74,231
"n1870219","1870219",149,80,69,0,7,63,67,118,61,57,0,2,53,55
"n3590203","3590203",207,178,29,0,1,26,26,177,154,23,0,0,21,21
"n4590018","4590018",1221,808,413,7,254,127,372,974,694,280,5,176,77,253
"n3550031","3550031",1309,164,1145,15,57,1058,1104,1035,153,882,13,42,811,847
"n2011119","2011119",32,0,32,9,2,26,28,18,0,18,8,1,13,14
"n292115","292115",7602,2454,5148,443,982,3769,4631,5108,1802,3306,259,596,2391,2954
"n1990012","1990012",1972,1719,253,10,89,113,200,1558,1390,168,9,67,64,129
"n1132108","1132108",2046,643,1403,63,348,960,1305,1357,491,866,42,208,599,805
"n4391109","4391109",3437,668,2769,117,185,2431,2609,2598,608,1990,92,147,1716,1857
"n1410046","1410046",2515,416,2099,90,244,1834,2008,1889,358,1531,67,167,1318,1455
"n2011056","2011056",5544,2017,3527,1323,849,1311,2128,3697,1410,2287,891,542,818,1339
"n1132521","1132521",4109,1992,2117,282,454,1325,1759,3045,1598,1447,212,308,889,1183
"n690401","690401",1026,139,887,10,22,840,857,701,118,583,10,15,545,558
"n1830013","1830013",5398,3670,1728,56,1035,498,1502,4081,2937,1144,43,682,318,978
"n2030017","2030017",2314,1059,1255,21,817,355,1160,1863,876,987,16,673,243,909
"n2310217","2310217",2103,1735,368,16,35,260,286,1726,1446,280,15,20,195,209
"n1410089","1410089",5892,576,5316,118,319,4914,5170,4600,484,4116,86,232,3789,3992
"n610075","610075",6763,137,6626,13,29,6595,6602,4705,90,4615,4,17,4600,4605
"n4391347","4391347",5182,1882,3300,604,1656,1011,2593,3868,1485,2383,455,1209,660,1840
"n1890112","1890112",2221,903,1318,9,342,959,1286,2051,827,1224,9,336,874,1197
"n4690004","4690004",3389,438,2951,26,366,2591,2896,2365,351,2014,22,237,1750,1968
"n1132023","1132023",1861,1455,406,82,108,197,291,1662,1323,339,63,88,163,243
"n4550014","4550014",864,743,121,6,20,58,74,714,629,85,3,8,33,41
"n3550093","3550093",5086,356,4730,90,276,4403,4622,3636,294,3342,58,193,3114,3278
"n2490007","2490007",4001,904,3097,67,35,2969,2983,3002,780,2222,56,18,2118,2128
"n2010887","2010887",747,489,258,69,59,127,183,726,477,249,67,53,124,176
"n291046","291046",4164,248,3916,20,90,3814,3872,2996,220,2776,13,41,2714,2749
"n1391042","1391042",582,394,188,3,59,97,155,446,303,143,1,43,73,115
"n1133026","1133026",1428,19,1409,7,1024,379,1390,1090,19,1071,6,830,232,1055
"n4790250A","4790250A",5606,177,5429,24,30,5381,5392,3534,114,3420,16,17,3391,3398
"n4730312","4730312",2309,286,2023,13,1327,668,1982,1790,220,1570,10,1098,447,1539
"n490411","490411",2617,1336,1281,21,151,1068,1194,1950,1072,878,14,100,724,818
"n1131146","1131146",3199,2615,584,110,91,296,380,2458,2060,398,69,63,195,256
"n4530348B","4530348B",627,307,320,172,18,116,134,431,213,218,122,10,73,83
"n292178","292178",1420,274,1146,24,39,1097,1119,1182,250,932,16,25,901,915
"n3510002","3510002",515,377,138,0,110,11,121,431,325,106,0,87,3,90
"n2450053","2450053",2263,96,2167,31,1481,666,2134,1706,90,1616,18,1143,464,1600
"n4392280","4392280",2115,1290,825,85,403,337,710,1803,1185,618,76,298,237,521
"n2010824","2010824",5336,329,5007,162,1957,2968,4820,3989,277,3712,145,1489,2119,3539
"n291109","291109",44,7,37,6,2,31,33,19,0,19,1,0,18,18
"n4530420","4530420",9155,3061,6094,784,882,4329,5103,7726,2862,4864,618,696,3428,4051
"n2010055","2010055",4158,2270,1888,650,371,819,1173,3843,2178,1665,570,323,716,1034
"n1131710","1131710",4135,163,3972,59,751,3168,3886,2918,127,2791,52,593,2149,2729
"n1350307","1350307",5518,1365,4153,70,355,3714,3997,3842,1067,2775,44,222,2483,2662
"n610012","610012",4506,329,4177,38,27,4112,4120,3493,284,3209,32,23,3155,3163
"n292056","292056",2438,278,2160,21,34,2103,2127,1878,240,1638,15,18,1597,1611
"n570011","570011",985,816,169,4,3,139,141,889,748,141,3,2,114,115
"n530012","530012",2787,2034,753,23,58,561,611,2157,1625,532,19,30,382,408
"n1391022","1391022",5580,2912,2668,71,731,1706,2387,4149,2341,1808,46,493,1118,1593
"n1132200","1132200",2208,1917,291,100,32,104,133,1665,1484,181,55,20,65,84
"n292013","292013",2175,113,2062,29,46,1999,2029,1664,97,1567,21,33,1518,1539
"n410084","410084",10,3,7,0,0,7,7,10,3,7,0,0,7,7
"n4391734","4391734",6181,972,5209,288,3304,1647,4832,4137,784,3353,210,2075,1052,3079
"n1290303","1290303",399,309,90,4,14,52,62,316,256,60,3,11,34,41
"n1132000","1132000",53,9,44,0,1,42,42,44,8,36,0,0,34,34
"n1132128","1132128",3224,1592,1632,134,674,787,1449,2779,1452,1327,118,599,567,1161
"n3490405","3490405",1255,955,300,12,59,177,232,977,754,223,8,40,131,170
"n1391039","1391039",5787,3914,1873,97,671,972,1597,4281,3045,1236,54,415,622,1028
"n1214221","1214221",311,224,87,0,5,68,73,232,173,59,0,2,46,48
"n2450013","2450013",461,8,453,3,422,33,448,360,7,353,0,332,21,352
"n3430102","3430102",483,211,272,2,237,31,264,389,169,220,2,200,12,212
"n4391577","4391577",3833,294,3539,34,951,2550,3465,2435,217,2218,21,641,1555,2174
"n1132307","1132307",1247,507,740,116,135,479,605,992,437,555,83,100,352,448
"n2450056","2450056",4803,3458,1345,183,178,897,1064,3651,2748,903,131,111,575,684
"n3390078","3390078",7079,4690,2389,881,197,1115,1297,5213,3615,1598,578,135,758,884
"n3550008","3550008",8900,3141,5759,688,506,4543,4961,6699,2586,4113,503,373,3164,3481
"n2010801","2010801",1003,69,934,55,111,784,878,734,58,676,48,88,549,624
"n1132049","1132049",2256,1427,829,177,261,353,598,1818,1194,624,132,204,252,450
"n1350412","1350412",2074,484,1590,29,190,1369,1535,1591,428,1163,24,138,989,1117
"n292072","292072",4933,1231,3702,190,368,3183,3476,3656,1039,2617,120,242,2235,2452
"n4530292","4530292",5477,3789,1688,740,188,626,791,3807,2710,1097,452,144,425,551
"n1990015","1990015",2973,2443,530,44,144,218,353,2264,1886,378,30,104,137,238
"n4630013","4630013",4635,594,4041,21,41,3959,3976,3352,448,2904,14,26,2843,2856
"n2011033","2011033",1200,615,585,150,202,215,408,1009,557,452,113,154,160,312
"n291003","291003",3399,693,2706,92,89,2520,2595,2888,669,2219,81,72,2052,2116
"n291131","291131",0,0,0,0,0,0,0,0,0,0,0,0,0,0
"n2510028","2510028",2947,2238,709,26,89,502,577,2336,1873,463,20,55,304,355
"n1870128","1870128",5078,3318,1760,139,144,1364,1484,3644,2507,1137,70,100,896,984
"n47003S","47003S",379,29,350,4,5,337,341,325,24,301,1,4,290,294
"n4530416","4530416",3743,2155,1588,158,204,1180,1358,3253,1990,1263,141,158,899,1045
"n1950001","1950001",1384,596,788,9,16,749,760,970,463,507,8,12,470,481
"n610009","610009",7653,279,7374,18,48,7298,7324,5589,238,5351,8,32,5291,5313
"n2010930","2010930",1395,24,1371,14,315,1040,1349,1006,17,989,10,260,715,973
"n4391189","4391189",3788,1354,2434,271,661,1468,2105,2923,1198,1725,192,487,996,1476
"n292158","292158",0,0,0,0,0,0,0,0,0,0,0,0,0,0
"n610095","610095",892,20,872,4,2,867,869,559,15,544,1,1,543,544
"n1410109","1410109",2518,358,2160,58,129,2020,2104,2024,322,1702,47,84,1596,1653
"n2690002","2690002",67,53,14,1,3,11,13,41,31,10,1,1,9,9
"n1133006","1133006",5861,4204,1657,495,431,617,1032,5667,4104,1563,469,413,567,968
"n2010141","2010141",860,162,698,6,33,646,675,602,134,468,5,16,435,449
"n2010098","2010098",5428,3927,1501,107,313,896,1186,3937,2981,956,81,188,535,711
"n293030","293030",2782,1781,1001,160,78,772,837,2202,1477,725,113,61,547,601
"n390076","390076",2328,1384,944,27,67,753,812,1755,1139,616,16,45,465,510
"n1133107","1133107",3857,349,3508,52,2622,876,3444,2846,295,2551,39,1940,590,2505
"n2570009","2570009",2814,1792,1022,26,268,609,873,2197,1494,703,12,208,378,582
"n4391078","4391078",1851,93,1758,21,847,912,1739,1262,74,1188,13,644,537,1171
"n4530231","4530231",4862,4163,699,186,54,350,397,3613,3156,457,106,36,232,265
"n1410066","1410066",4065,295,3770,49,207,3540,3689,3185,257,2928,39,166,2741,2871
"n1410172","1410172",7918,196,7722,18,35,7683,7699,5747,153,5594,15,28,5567,5581
"n730012","730012",2121,1496,625,20,213,352,560,1575,1155,420,13,162,214,372
"n2011076","2011076",6102,1182,4920,829,1934,2200,4041,4156,866,3290,602,1236,1432,2637
"n2010013","2010013",7254,2339,4915,166,1279,3420,4591,5315,1967,3348,119,876,2250,3068
"n3330006","3330006",272,208,64,1,0,42,42,220,176,44,1,0,28,28
"n2650119","2650119",3106,2268,838,77,39,659,690,2548,1940,608,59,26,472,493
"n2290004","2290004",403,159,244,1,5,226,229,344,136,208,1,3,192,195
"n4530392","4530392",2876,2207,669,176,64,353,403,2342,1871,471,128,41,252,279
"n1870401","1870401",3395,1741,1654,114,171,1304,1452,2567,1404,1163,73,118,903,1013
"n2011139","2011139",7149,435,6714,196,2598,3944,6475,4987,358,4629,158,1774,2716,4456
"n550202","550202",2093,978,1115,28,131,927,1032,1571,811,760,17,83,621,695
"n4391489","4391489",3904,854,3050,385,1907,774,2613,2958,735,2223,309,1377,525,1871
"n2010204","2010204",5497,3435,2062,298,382,1314,1654,4581,2919,1662,239,322,1023,1319
"n2010844","2010844",5858,3788,2070,493,524,951,1450,3823,2572,1251,302,331,552,870
"n291089","291089",96,4,92,0,0,91,91,82,3,79,0,0,78,78
"n292030","292030",3001,91,2910,24,73,2832,2878,2028,73,1955,16,42,1905,1935
"n2010947","2010947",1102,721,381,94,51,227,271,885,593,292,80,32,167,199
"n3550113","3550113",1001,72,929,7,115,818,919,741,53,688,4,86,604,683
"n4570014","4570014",2085,1855,230,19,51,90,140,1635,1465,170,11,39,58,96
"n2450099","2450099",1479,481,998,74,783,147,914,1255,459,796,65,620,108,723
"n3390039","3390039",7280,5767,1513,110,161,960,1098,5363,4401,962,73,107,585,682
"n3470016","3470016",3514,2807,707,87,203,337,535,2737,2229,508,67,156,220,375
"n410021","410021",6050,3221,2829,1386,364,1030,1354,5679,3053,2626,1325,314,943,1221
"n3550051","3550051",4659,833,3826,39,324,3458,3711,3363,736,2627,31,201,2357,2534
"n2450073","2450073",2973,1851,1122,183,566,309,861,2323,1555,768,138,379,211,577
"n4392219","4392219",3487,1999,1488,445,450,522,955,2663,1611,1052,318,330,329,653
"n291026","291026",2489,88,2401,12,30,2368,2382,1821,83,1738,7,16,1713,1720
"n4710301","4710301",8628,2735,5893,112,2613,3030,5582,7106,2463,4643,85,2098,2318,4388
"n4270010","4270010",5492,66,5426,3,14,5399,5404,3653,31,3622,3,11,3604,3609
"n2390004","2390004",525,377,148,6,7,116,123,433,321,112,6,4,88,92
"n3490203","3490203",3229,1935,1294,36,682,483,1156,2561,1640,921,31,481,332,810
"n4650042","4650042",41,22,19,0,0,19,19,28,19,9,0,0,9,9
"n3550071","3550071",2870,255,2615,14,106,2486,2586,2204,222,1982,13,79,1886,1959
"n390056","390056",7232,3881,3351,127,994,2134,3026,5319,3025,2294,104,657,1398,2033
"n291069","291069",1044,318,726,54,106,593,681,859,295,564,41,79,453,525
"n1213160","1213160",4697,3216,1481,299,342,695,1015,3529,2528,1001,211,217,462,663
"n610072","610072",6271,318,5953,135,63,5770,5809,4219,218,4001,104,38,3858,3885
"n2010058","2010058",3473,1888,1585,345,156,1042,1183,2872,1626,1246,263,124,802,921
"n3550054","3550054",2040,152,1888,12,36,1845,1874,1543,136,1407,8,22,1375,1397
"n1410129","1410129",10082,1178,8904,319,844,7928,8550,6299,839,5460,181,522,4791,5218
"n2010738","2010738",1464,39,1425,10,1245,204,1410,1039,38,1001,9,862,143,990
"n4391013","4391013",4090,412,3678,64,1554,2085,3603,2966,374,2592,53,1221,1330,2530
"n2011053","2011053",2988,369,2619,111,1166,1364,2477,2250,329,1921,93,870,955,1803
"n4570017","4570017",2798,1192,1606,24,938,631,1559,2572,1054,1518,22,883,603,1477
"n1132602","1132602",6349,1495,4854,2870,1245,696,1909,4986,1301,3685,2254,893,490,1370
"n4530387","4530387",4015,2134,1881,580,409,837,1210,3074,1720,1354,397,294,604,881
"n4530346","4530346",5889,3886,2003,872,124,875,985,3835,2635,1200,511,82,523,600
"n1870103","1870103",1117,616,501,4,47,418,455,902,555,347,3,31,286,312
"n2011096","2011096",5108,2788,2320,73,255,1891,2124,3857,2213,1644,48,182,1307,1483
"n292033","292033",4272,687,3585,10,596,3013,3555,4034,678,3356,10,585,2792,3331
"n291086","291086",4311,609,3702,124,362,3280,3556,3137,508,2629,94,246,2278,2491
"n2450076","2450076",3199,320,2879,172,1322,1403,2662,2158,260,1898,125,909,879,1749
"n3550028","3550028",315,211,104,2,6,92,96,257,180,77,2,5,66,69
"n3490200","3490200",2862,825,2037,35,868,1037,1881,2072,653,1419,23,657,673,1318
"n1131733","1131733",7391,1998,5393,1171,1098,3092,4123,5498,1703,3795,899,731,2094,2794
"n510114","510114",3374,1783,1591,22,411,1108,1508,2525,1457,1068,19,288,712,996
"n1350304","1350304",1691,225,1466,10,116,1349,1448,1271,201,1070,9,89,976,1054
"n4392609","4392609",0,0,0,0,0,0,0,0,0,0,0,0,0,0
"n4392100","4392100",1128,392,736,41,56,627,675,845,351,494,33,41,405,441
"n2010184","2010184",2790,296,2494,29,389,2070,2437,2152,274,1878,21,340,1514,1842
"n1133049","1133049",2953,53,2900,16,1642,1255,2879,2224,41,2183,11,1406,778,2169
"n1391019","1391019",3920,2245,1675,57,205,1332,1502,2898,1797,1101,39,128,859,974
"n530009","530009",3366,2458,908,24,26,778,792,2745,2110,635,14,15,538,544
"n2010864","2010864",6740,260,6480,230,1198,5100,6237,4753,220,4533,180,783,3585,4337
"n1230202","1230202",2195,1179,1016,24,153,818,955,1728,1008,720,24,115,553,663
"n2594070","2594070",1924,1529,395,24,11,296,304,1596,1315,281,17,7,206,211
"n570008","570008",665,508,157,11,8,116,124,568,457,111,8,7,81,88
"n1350101","1350101",8181,1907,6274,42,147,6005,6109,5603,1514,4089,27,89,3899,3970
"n410103","410103",1078,815,263,11,23,190,210,750,589,161,6,13,114,125
"n4392522","4392522",5904,2751,3153,322,1520,1207,2666,4285,2203,2082,241,948,776,1709
"n2010121","2010121",2736,837,1899,22,267,1587,1845,1920,668,1252,15,169,1042,1209
"n1132807","1132807",3956,1964,1992,1408,144,378,515,2812,1511,1301,916,94,237,330
"n4392354","4392354",2778,659,2119,331,684,1095,1755,2029,559,1470,278,480,694,1163
"n3410401","3410401",2127,1097,1030,9,26,953,976,1490,828,662,9,14,605,618
"n4393035","4393035",4674,3587,1087,368,108,454,544,3643,2899,744,246,75,294,363
"n2730041","2730041",2601,358,2243,155,116,1974,2062,1912,298,1614,132,83,1384,1456
"n3370014","3370014",337,295,42,2,4,12,15,268,237,31,2,3,6,8
"n2010016","2010016",4819,2460,2359,532,815,963,1757,4642,2401,2241,509,773,918,1671
"n610052","610052",2485,1563,922,71,67,743,798,2204,1456,748,68,42,600,637
"n2490010","2490010",3528,179,3349,13,54,3285,3321,2547,149,2398,4,30,2362,2381
"n1213117","1213117",3077,500,2577,493,331,1757,2069,2125,432,1693,334,265,1091,1347
"n291148","291148",2211,344,1867,33,256,1610,1815,1453,266,1187,23,160,1019,1154
"n1132310","1132310",3186,1645,1541,231,103,1119,1211,2588,1425,1163,194,80,818,890
"n1410086","1410086",2236,1331,905,319,282,335,486,2199,1327,872,311,269,314,456
"n4391352","4391352",975,668,307,18,72,179,243,800,586,214,8,40,128,168
"n4530472","4530472",6178,2478,3700,228,564,2886,3353,5023,2316,2707,189,426,2045,2415
"n410041","410041",1694,1401,293,88,41,139,174,1257,1084,173,52,17,83,100
"n292138","292138",2185,480,1705,69,212,1438,1626,1706,436,1270,51,165,1055,1204
"n292075","292075",2372,62,2310,21,101,2204,2280,1700,48,1652,10,71,1581,1638
"n2010990","2010990",278,5,273,46,5,227,227,200,5,195,41,5,153,153
"n1214179","1214179",4905,3116,1789,287,487,934,1387,3775,2539,1236,213,328,619,927
"n1910201","1910201",95,60,35,3,5,32,35,76,58,18,1,1,17,18
"n2330014","2330014",2393,1930,463,27,59,298,353,1764,1486,278,21,32,169,201
"n4391589","4391589",377,169,208,69,87,53,135,317,155,162,49,76,38,112
"n1410023","1410023",1931,632,1299,59,51,1193,1226,1564,585,979,41,39,901,929
"n1132111","1132111",41,31,10,4,2,7,9,41,31,10,4,2,7,9
"n2550004","2550004",3901,1133,2768,52,762,1949,2696,3481,1053,2428,42,739,1630,2360
"n670002","670002",527,395,132,4,77,25,101,416,314,102,3,64,14,78
"n2010927","2010927",5651,3198,2453,454,248,1665,1876,4304,2561,1743,301,166,1194,1346
"n3390056","3390056",7980,4687,3293,788,686,1674,2303,5772,3549,2223,539,449,1113,1538
"n4590015B","4590015B",0,0,0,0,0,0,0,0,0,0,0,0,0,0
"n1410063","1410063",5743,440,5303,60,318,5027,5239,4263,387,3876,46,219,3659,3826
"n3550091","3550091",6687,2619,4068,390,694,2927,3546,5686,2393,3293,317,585,2320,2865
"n4392519","4392519",1886,511,1375,251,646,460,1087,1422,431,991,201,465,300,755
"n2011073","2011073",0,0,0,0,0,0,0,0,0,0,0,0,0,0
"n292112","292112",2384,658,1726,98,120,1516,1610,1997,598,1399,80,86,1223,1296
"n4392341","4392341",739,157,582,91,251,245,487,568,126,442,78,185,178,359
"n2010095","2010095",6213,3030,3183,775,1186,1174,2302,5101,2551,2550,624,947,915,1828
"n4690001","4690001",1053,186,867,6,94,773,852,793,153,640,2,75,560,631
"n2570006","2570006",3375,2427,948,26,119,683,790,2654,2039,615,18,69,426,491
"n4630010","4630010",1755,314,1441,12,25,1396,1409,1314,261,1053,9,15,1017,1026
"n2011030","2011030",1029,91,938,17,35,886,919,734,85,649,11,24,612,634
"n1132518","1132518",2349,1380,969,357,329,232,548,1909,1204,705,246,245,159,403
"n2670007","2670007",413,352,61,6,7,48,52,371,323,48,5,7,36,40
"n3550048","3550048",2265,500,1765,33,82,1644,1701,1731,459,1272,18,48,1182,1220
"n292069","292069",6117,908,5209,292,612,4331,4865,4761,801,3960,219,491,3236,3682
"n1133003","1133003",3256,273,2983,43,1387,1551,2907,2367,230,2137,32,1097,992,2077
"n2593050","2593050",3223,2354,869,62,41,681,711,2457,1877,580,37,21,453,469
"n2010138","2010138",2859,69,2790,18,1471,1334,2767,2152,56,2096,11,1223,875,2084
"n1410149","1410149",4089,160,3929,22,42,3885,3905,3228,134,3094,11,20,3060,3074
"n2010224","2010224",4379,2160,2219,954,489,740,1194,3639,1797,1842,817,421,569,972
"n690206","690206",263,164,99,3,2,91,92,201,133,68,3,2,61,62
"n2011159","2011159",0,0,0,0,0,0,0,0,0,0,0,0,0,0
"n1133089","1133089",116,79,37,6,5,15,20,104,72,32,6,5,10,15
"n293007","293007",5175,1866,3309,1132,418,1771,2133,3736,1455,2281,774,291,1202,1460
"n610049","610049",4619,319,4300,25,25,4251,4260,3391,279,3112,18,8,3075,3079
"n4570010","4570010",1570,1379,191,3,65,74,137,1221,1090,131,2,46,44,90
"n2010052","2010052",4246,2466,1780,611,286,850,1106,3832,2303,1529,495,235,757,968
"n2150077","2150077",3828,345,3483,19,17,3450,3460,2692,323,2369,13,8,2345,2352
"n2010181","2010181",5135,302,4833,25,107,4690,4779,3834,288,3546,21,73,3430,3498
"n292155","292155",0,0,0,0,0,0,0,0,0,0,0,0,0,0
"n4392569","4392569",786,45,741,40,221,478,695,520,27,493,33,152,307,456
"n1410020","1410020",1744,426,1318,37,44,1241,1273,1377,374,1003,28,33,938,964
"n850170","850170",2822,1653,1169,276,384,466,826,2014,1242,772,194,246,307,541
"n2011116","2011116",2823,601,2222,589,437,1206,1613,2021,481,1540,455,301,786,1073
"n610092","610092",432,38,394,0,1,392,392,312,31,281,0,0,280,280
"n294052","294052",3596,1387,2209,176,692,1353,1982,2886,1224,1662,147,511,986,1471
"n4392205","4392205",3567,2380,1187,127,275,694,939,2807,1988,819,115,160,454,605
"n2010347","2010347",8019,2017,6002,343,260,5362,5565,5783,1721,4062,262,183,3571,3726
"n2030011","2030011",940,450,490,8,258,207,464,740,382,358,5,212,128,340
"n3630022","3630022",1382,1104,278,8,15,194,206,1080,905,175,8,6,115,119
"n4890008","4890008",464,51,413,3,1,407,408,348,45,303,3,1,297,298
"n850084","850084",3625,2045,1580,277,686,543,1211,3059,1781,1278,226,566,416,973
"n3810103","3810103",2778,1525,1253,59,385,722,1093,2624,1460,1164,49,369,666,1023
"n2010241","2010241",8179,730,7449,153,335,6951,7245,5590,635,4955,138,249,4559,4790
"n2790001","2790001",1717,522,1195,1,12,1174,1183,1217,416,801,1,6,784,790
"n1133964","1133964",3579,1563,2016,249,839,848,1661,2749,1309,1440,198,574,584,1154
"n4394077","4394077",339,233,106,1,7,90,96,277,207,70,1,6,57,62
"n3030006","3030006",2767,135,2632,10,1699,988,2608,1881,119,1762,4,1186,584,1752
"n4730106","4730106",2596,930,1666,16,315,1324,1629,1947,818,1129,10,256,846,1097
"n3610011","3610011",1449,815,634,30,210,359,554,1093,682,411,21,134,233,355
"n1470018","1470018",5000,3612,1388,65,419,702,1109,3956,3000,956,49,307,451,755
"n2090435","2090435",5347,3507,1840,151,115,1466,1548,3637,2470,1167,92,67,937,993
"n1133310","1133310",5680,1994,3686,95,955,2536,3461,4151,1671,2480,91,678,1614,2274
"n293171","293171",0,0,0,0,0,0,0,0,0,0,0,0,0,0
"n3030053","3030053",6597,2772,3825,268,603,2911,3426,5205,2436,2769,206,434,2052,2441
"n2010433","2010433",1606,269,1337,125,334,896,1207,1201,239,962,83,254,634,873
"n4810203","4810203",5817,1583,4234,48,1919,2281,4124,4412,1341,3071,34,1380,1644,3002
"n4393392","4393392",3062,2363,699,219,77,330,399,2244,1792,452,149,57,191,246
"n850021","850021",6089,3292,2797,1296,564,795,1334,4895,2794,2101,1006,413,567,961
"n2090221","2090221",5023,2387,2636,138,370,2089,2416,3842,1969,1873,80,266,1485,1726
"n3670400","3670400",4413,3428,985,87,125,653,762,3379,2734,645,54,74,410,474
"n293110","293110",4322,1723,2599,194,312,2055,2320,3296,1396,1900,147,246,1473,1690
"n2890012","2890012",1013,702,311,9,209,61,268,806,562,244,7,169,46,213
"n3870011A","3870011A",663,564,99,4,31,32,62,524,449,75,4,22,24,45
"n2150034","2150034",1574,74,1500,42,9,1452,1455,1195,67,1128,33,8,1091,1093
"n4392751","4392751",0,0,0,0,0,0,0,0,0,0,0,0,0,0
"n2730024","2730024",2902,583,2319,224,308,1782,2063,2583,527,2056,205,278,1560,1819
"n3710009","3710009",349,144,205,5,3,189,191,229,102,127,5,1,113,114
"n2010304","2010304",3359,1788,1571,620,178,727,883,2650,1479,1171,472,129,528,646
"n2010370","2010370",4115,2418,1697,359,335,915,1219,3062,1893,1169,264,212,626,830
"n2130001","2130001",1624,814,810,20,225,542,751,1179,668,511,12,147,330,472
"n2910030","2910030",3429,1774,1655,35,405,1135,1530,2442,1360,1082,12,299,697,991
"n1572030","1572030",3472,1844,1628,259,807,591,1334,2826,1618,1208,213,591,408,971
"n4393329","4393329",5374,2042,3332,1000,949,1186,2098,4143,1709,2434,753,690,831,1500
"n1573078","1573078",1014,71,943,378,314,272,561,793,52,741,336,222,190,399
"n1133046","1133046",4465,496,3969,57,2169,1734,3854,3247,436,2811,40,1629,1111,2725
"n1134128","1134128",1520,1204,316,151,13,137,147,1179,967,212,95,5,95,98
"n610006","610006",2327,88,2239,17,22,2202,2215,1831,73,1758,17,18,1722,1735
"n1410209A","1410209A",3238,1430,1808,238,587,895,1393,1808,847,961,150,321,444,730
"n1410106","1410106",4760,407,4353,65,146,4162,4275,3606,332,3274,44,99,3119,3209
"n4790226","4790226",2005,71,1934,10,14,1913,1920,1507,47,1460,6,8,1443,1449
"n4790340","4790340",3220,246,2974,60,20,2901,2909,2490,207,2283,48,13,2225,2231
"n770020","770020",589,552,37,1,7,19,26,472,444,28,1,5,13,18
"n4530439","4530439",3543,1494,2049,241,342,1464,1763,3186,1406,1780,222,313,1234,1512
"n4393247","4393247",4387,1622,2765,145,1669,843,2449,3205,1321,1884,110,1099,594,1654
"n293070","293070",3044,1568,1476,154,167,1156,1281,2527,1391,1136,112,127,882,989
"n1133313","1133313",5421,1278,4143,247,2139,1734,3821,3845,1102,2743,174,1390,1145,2515
"n2790004","2790004",181,68,113,1,4,106,110,118,50,68,1,0,67,67
"n2010287","2010287",2472,1455,1017,198,177,607,772,1975,1210,765,159,141,434,569
"n2010244","2010244",6291,1573,4718,806,1272,2642,3844,4795,1340,3455,653,895,1890,2743
"n2870304","2870304",2125,1583,542,23,54,399,443,1617,1256,361,17,32,255,283
"n2010330","2010330",7885,1506,6379,624,566,5170,5678,5992,1341,4651,533,449,3643,4059
"n1133805","1133805",7867,305,7562,45,6683,934,7498,5730,262,5468,38,4850,604,5407
"n2730033","2730033",612,233,379,34,26,319,337,454,185,269,24,20,220,236
"n1410169","1410169",7921,185,7736,26,40,7660,7680,5351,134,5217,14,20,5160,5175
"n710016","710016",3443,2129,1314,27,122,1109,1218,2341,1489,852,14,80,709,781
"n3730002","3730002",923,775,148,9,26,86,110,742,635,107,7,11,64,75
"n1134057","1134057",3320,186,3134,8,247,2864,3101,2427,174,2253,8,195,2034,2227
"n3510017","3510017",119,24,95,1,91,3,94,106,22,84,1,80,3,83
"n293113","293113",2176,732,1444,89,180,1142,1313,1860,666,1194,79,153,936,1080
"n1132801","1132801",4754,2843,1911,843,248,717,949,3601,2292,1309,583,163,477,633
"n4392827A","4392827A",0,0,0,0,0,0,0,0,0,0,0,0,0,0
"n1391016","1391016",4257,858,3399,25,999,2314,3271,2932,687,2245,12,679,1487,2160
"n294015","294015",2949,531,2418,37,102,2276,2353,2450,479,1971,31,73,1864,1922
"n291155","291155",2838,560,2278,131,364,1841,2143,1979,438,1541,96,237,1222,1436
"n294184","294184",26,0,26,1,0,25,25,26,0,26,1,0,25,25
"n370015","370015",805,701,104,5,62,17,78,625,547,78,5,45,13,57
"n610078","610078",6571,830,5741,51,89,5568,5625,4738,685,4053,26,53,3919,3962
"n2150189","2150189",3404,85,3319,3,3,3292,3292,2090,65,2025,2,2,2006,2006
"n2570015","2570015",5055,3691,1364,44,200,908,1095,3842,2933,909,36,127,571,694
"n2850309","2850309",1865,1481,384,9,152,201,346,1402,1163,239,6,111,104,211
"n3390007","3390007",3434,2146,1288,27,97,1018,1108,2585,1720,865,19,71,667,733
"n3490303","3490303",1774,1314,460,17,167,212,376,1401,1070,331,13,132,136,265
"n4230012","4230012",3384,258,3126,14,1508,1622,3093,2229,213,2016,14,1036,969,1989
"n850030","850030",6965,4014,2951,523,748,1501,2215,5192,3136,2056,384,483,1037,1513
"n1132139","1132139",3031,247,2784,83,1043,1654,2678,2143,232,1911,60,780,1062,1829
"n1131409","1131409",1803,249,1554,31,196,1323,1504,1329,228,1101,24,178,890,1059
"n1211063","1211063",2718,1672,1046,96,257,619,858,2091,1361,730,68,189,419,600
"n2010690","2010690",6714,3784,2930,680,390,1734,2079,4915,3023,1892,477,243,1068,1294
"n2150020","2150020",6614,131,6483,6,15,6466,6469,4505,70,4435,3,12,4425,4428
"n294038","294038",3850,1928,1922,167,339,1374,1672,3093,1660,1433,124,234,1010,1235
"n294161","294161",1568,206,1362,100,670,639,1260,1191,173,1018,87,485,460,923
"n291058","291058",5275,947,4328,95,75,4142,4193,3869,791,3078,80,43,2927,2956
"n292019","292019",3209,125,3084,27,30,3037,3056,2424,89,2335,23,17,2299,2313
"n37004B","37004B",2006,1331,675,31,438,154,580,1567,1109,458,13,323,86,403
"n610101","610101",2880,158,2722,28,31,2660,2681,1893,124,1769,26,11,1729,1736
"n3990006","3990006",180,132,48,0,1,39,40,140,115,25,0,0,22,22
"n2150043","2150043",5040,127,4913,59,10,4839,4842,3391,89,3302,45,6,3248,3249
"n2150166","2150166",1496,120,1376,35,30,1313,1333,1004,97,907,19,12,864,876
"n2591010","2591010",3913,2394,1519,110,90,1256,1326,2928,1900,1028,69,57,853,900
"n2790011","2790011",1073,550,523,4,33,476,504,749,426,323,4,16,290,306
"n3390028C","3390028C",61,24,37,1,2,29,31,49,15,34,1,2,26,28
"n3470042","3470042",4500,1355,3145,28,337,2740,3071,3142,1143,1999,22,230,1711,1939
"n850007","850007",2272,1236,1036,255,358,390,737,1809,1027,782,219,252,280,526
"n850130","850130",5262,2685,2577,1653,395,450,831,3953,2107,1846,1202,279,298,565
"n1132114","1132114",2841,2402,439,116,62,196,249,2730,2336,394,104,52,169,215
"n1134601","1134601",7025,2192,4833,518,362,3846,4184,5413,1901,3512,441,282,2688,2957
"n1131719","1131719",6294,1274,5020,193,1153,3627,4735,4508,1104,3404,139,791,2404,3185
"n2010836","2010836",427,23,404,7,256,149,396,398,22,376,7,245,130,368
"n410013","410013",3032,1836,1196,61,277,790,1043,2418,1565,853,41,190,550,734
"n950204","950204",156,88,68,2,1,56,57,130,81,49,1,0,40,40
"n1132098","1132098",1984,1531,453,110,104,222,317,1883,1468,415,106,84,203,284
"n1133095","1133095",3219,1630,1589,228,835,486,1296,3006,1569,1437,212,738,440,1162
"n1131742","1131742",9130,2320,6810,1298,3341,2181,5387,6849,1942,4907,1013,2350,1483,3772
"n1391025","1391025",4817,2897,1920,40,763,1007,1732,3726,2425,1301,30,507,656,1155
"n3030012","3030012",2718,1861,857,48,140,642,758,2023,1470,553,32,82,411,483
"n3310207","3310207",1159,588,571,13,158,401,544,870,482,388,7,112,266,368
"n3530003","3530003",3172,1616,1556,61,244,1262,1441,2370,1308,1062,47,136,848,968
"n3750426","3750426",2108,590,1518,76,272,1168,1401,1324,453,871,39,117,682,791
"n4870001B","4870001B",184,164,20,4,2,6,8,143,128,15,2,1,6,7
"n1410213","1410213",497,18,479,1,3,476,477,337,8,329,0,1,326,327
"n1550401","1550401",276,207,69,4,13,53,61,230,192,38,2,8,28,33
"n2010982","2010982",5713,3155,2558,742,358,1401,1729,3824,2212,1612,446,247,864,1096
"n213003B","213003B",4182,3369,813,11,130,553,678,3203,2655,548,9,89,359,446
"n2150229","2150229",3459,48,3411,13,9,3378,3381,2323,27,2296,13,8,2269,2272
"n2450085","2450085",1704,358,1346,30,1046,276,1308,1429,328,1101,22,883,195,1070
"n410073","410073",3757,2930,827,174,159,415,565,2668,2151,517,117,83,245,326
"n750201","750201",1358,949,409,12,56,300,350,1033,763,270,6,29,195,221
"n890303","890303",775,700,75,4,9,39,47,649,589,60,3,7,30,37
"n1134655","1134655",82,42,40,1,11,27,33,68,40,28,1,3,19,22
"n1133316","1133316",4503,1305,3198,226,1359,1586,2902,3357,1114,2243,195,926,1073,1986
"n1211000","1211000",4478,3336,1142,46,65,849,904,3494,2721,773,25,52,546,590
"n3210002","3210002",769,639,130,6,17,92,106,691,600,91,4,12,59,69
"n3550099","3550099",1264,115,1149,3,46,1102,1135,974,100,874,1,42,831,863
"n3950011","3950011",1988,1182,806,7,160,586,743,1542,981,561,2,125,380,504
"n4394499","4394499",8596,3011,5585,1051,1569,2901,4359,6234,2452,3782,758,989,1929,2877
"n4910204","4910204",5970,3297,2673,1311,303,926,1203,4235,2428,1807,888,212,601,799
"n1350202","1350202",4398,2301,2097,94,268,1659,1880,3242,1852,1390,63,182,1085,1243
"n1990018","1990018",5897,5182,715,104,79,373,445,4503,4024,479,62,42,237,274
"n2010876","2010876",3822,1805,2017,456,538,998,1472,2661,1292,1369,323,351,658,989
"n2090100","2090100",0,0,0,0,0,0,0,0,0,0,0,0,0,0
"n2550013","2550013",64,27,37,3,1,28,29,51,25,26,2,1,20,21
"n2870403","2870403",380,297,83,0,23,55,76,315,250,65,0,19,42,60
"n293053","293053",3042,1843,1199,171,177,813,966,2626,1706,920,133,129,616,734
"n291075","291075",6333,530,5803,87,258,5495,5685,4260,413,3847,63,186,3599,3751
"n1410012","1410012",4715,1153,3562,263,279,3066,3274,3355,927,2428,190,190,2062,2217
"n1470005","1470005",841,771,70,4,3,21,23,659,607,52,2,1,14,15
"n1572051","1572051",3807,62,3745,75,2932,779,3635,2735,50,2685,58,2142,491,2608
"n1670422","1670422",2163,1284,879,159,272,431,698,1607,993,614,124,204,271,473
"n4530456","4530456",4590,1787,2803,400,529,1838,2321,3994,1697,2297,328,450,1474,1892
"n4530135","4530135",2074,748,1326,133,286,881,1151,1814,669,1145,119,255,742,985
"n4610005","4610005",178,71,107,3,6,92,95,126,53,73,2,4,59,62
"n4790133","4790133",4090,46,4044,10,6,4015,4016,2778,32,2746,6,6,2729,2730
"n4810403","4810403",1169,415,754,9,188,558,728,874,332,542,5,139,391,523
"n2150183","2150183",8125,142,7983,3,30,7955,7967,5254,91,5163,2,20,5146,5157
"n2450039","2450039",2827,93,2734,17,2408,329,2712,2032,70,1962,13,1752,205,1943
"n3390013","3390013",6926,4801,2125,112,195,1637,1811,5226,3852,1374,66,132,1037,1157
"n4391457","4391457",0,0,0,0,0,0,0,0,0,0,0,0,0,0
"n4391150","4391150",3485,486,2999,55,967,1931,2879,2476,439,2037,39,711,1252,1949
"n4392721","4392721",3405,1938,1467,240,566,567,1119,2607,1557,1050,171,416,378,787
"n2010767","2010767",268,51,217,9,23,184,201,204,40,164,8,17,136,150
"n2011016","2011016",5564,2922,2642,235,999,1328,2286,4272,2372,1900,180,719,937,1628
"n2010190","2010190",5485,448,5037,59,92,4883,4948,3856,364,3492,40,49,3386,3429
"n2010436","2010436",7015,3788,3227,1130,741,1234,1935,6080,3426,2654,885,633,1006,1613
"n2010522","2010522",5109,3148,1961,589,316,926,1211,3855,2465,1390,414,228,641,853
"n2010684","2010684",8698,3134,5564,1679,1190,2632,3727,5814,2228,3586,1158,711,1618,2300
"n1133920","1133920",7069,3080,3989,58,1165,2619,3758,5726,2785,2941,56,957,1802,2739
"n1211046","1211046",1296,853,443,60,56,281,329,1021,724,297,41,40,175,209
"n1573093","1573093",838,146,692,148,299,238,525,650,136,514,113,228,167,387
"n1770001","1770001",4271,1977,2294,28,288,1956,2199,3135,1611,1524,17,196,1278,1456
"n1850004","1850004",1602,1216,386,13,104,218,313,1219,986,233,6,67,119,184
"n2010045A","2010045A",7763,644,7119,39,2445,4655,7028,4938,533,4405,26,1475,2897,4352
"n4530381B","4530381B",0,0,0,0,0,0,0,0,0,0,0,0,0,0
"n4890011","4890011",425,43,382,0,3,382,382,305,28,277,0,1,277,277
"n3490101","3490101",2806,1237,1569,38,576,851,1402,2027,976,1051,27,427,520,933
"n4010112","4010112",4107,2640,1467,28,620,700,1303,3200,2100,1100,24,472,504,967
"n4391684","4391684",633,411,222,17,14,189,197,506,370,136,13,5,116,119
"n4393590","4393590",0,0,0,0,0,0,0,0,0,0,0,0,0,0
"n4394705","4394705",5354,2134,3220,783,1063,1404,2375,3748,1576,2172,545,700,929,1578
"n4510114","4510114",1769,148,1621,28,87,1546,1598,1370,112,1258,20,57,1202,1241
"n2010376","2010376",3751,766,2985,59,242,2658,2873,2607,635,1972,49,176,1722,1882
"n2010081","2010081",5727,447,5280,24,66,5171,5216,3979,385,3594,14,39,3522,3555
"n2010830","2010830",110,41,69,29,23,18,41,97,41,56,22,23,12,35
"n2011162","2011162",0,0,0,0,0,0,0,0,0,0,0,0,0,0
"n2150037","2150037",2098,164,1934,31,13,1901,1906,1577,134,1443,22,10,1419,1423
"n2270207","2270207",1518,1129,389,15,22,324,338,1175,913,262,10,10,212,222
"n150207","150207",958,742,216,1,61,110,170,780,629,151,1,48,74,122
"n291121","291121",6074,1813,4261,568,999,2799,3658,4000,1245,2755,347,614,1824,2375
"n610038","610038",779,147,632,0,3,624,626,650,137,513,0,1,509,509
"n850070","850070",2399,1763,636,217,117,269,380,1902,1451,451,170,71,180,247
"n1134143","1134143",301,14,287,4,82,199,280,244,14,230,4,77,149,225
"n1410052","1410052",4038,543,3495,86,289,3178,3379,3042,470,2572,62,182,2339,2481
"n277004GB","277004GB",154,118,36,4,5,18,23,112,90,22,3,2,10,12
"n3030155","3030155",3094,2460,634,47,31,501,527,2252,1831,421,31,26,316,341
"n4170101B","4170101B",499,408,91,3,3,76,77,391,332,59,2,0,48,48
"n4391295","4391295",2031,346,1685,13,336,1328,1645,1410,294,1116,8,245,845,1085
"n4394458","4394458",0,0,0,0,0,0,0,0,0,0,0,0,0,0
"n4790349","4790349",6439,363,6076,147,64,5887,5938,4125,260,3865,100,44,3726,3765
"n1870228","1870228",1139,642,497,15,33,437,464,922,550,372,9,21,334,351
"n2010476","2010476",2128,422,1706,92,234,1374,1592,1542,358,1184,68,167,936,1094
"n2010730","2010730",3751,2325,1426,390,280,750,998,3261,2104,1157,309,240,600,812
"n2010482","2010482",6778,3309,3469,516,795,2091,2795,4993,2600,2393,375,548,1393,1899
"n2430004","2430004",274,148,126,12,11,91,96,240,133,107,11,10,74,79
"n2610001","2610001",85,20,65,2,3,58,59,58,15,43,0,2,41,41
"n294201","294201",71,55,16,3,3,10,13,67,55,12,3,0,9,9
"n292059","292059",4858,508,4350,52,212,4109,4260,3775,459,3316,48,164,3108,3233
"n293203","293203",595,259,336,28,20,283,299,491,239,252,22,13,208,220
"n530001","530001",1933,1585,348,13,12,250,260,1570,1324,246,8,10,168,176
"n1134016","1134016",2449,688,1761,91,791,865,1644,2057,639,1418,73,679,649,1321
"n1131315","1131315",134,14,120,3,13,105,117,90,12,78,0,10,66,76
"n4710304","4710304",10971,5733,5238,57,2520,2480,4957,9684,5013,4671,47,2337,2138,4438
"n2150126","2150126",2983,555,2428,8,12,2397,2407,2224,533,1691,5,6,1668,1673
"n3390106","3390106",3076,2400,676,69,79,382,453,2114,1659,455,41,67,248,309
"n3390064","3390064",4880,2094,2786,43,104,2505,2584,3456,1683,1773,30,63,1585,1636
"n3630013","3630013",958,769,189,8,23,113,133,757,620,137,8,13,79,90
"n4391001","4391001",2240,1367,873,98,377,341,702,2026,1302,724,86,306,276,571
"n4410405","4410405",3353,1857,1496,68,322,1071,1348,2454,1465,989,41,177,705,871
"n1410152","1410152",4428,113,4315,11,75,4268,4299,3271,82,3189,7,39,3161,3180
"n1410158","1410158",2321,348,1973,23,76,1888,1939,1765,302,1463,22,51,1400,1440
"n1810307","1810307",3358,2751,607,13,60,407,453,2537,2168,369,6,28,236,260
"n2010582","2010582",3386,78,3308,18,1829,1486,3281,2326,70,2256,10,1290,962,2238
"n2011122","2011122",7252,282,6970,109,3169,3780,6830,4953,239,4714,71,2238,2466,4636
"n2150083","2150083",6352,901,5451,190,74,5174,5221,4553,710,3843,137,53,3648,3681
"n90002","90002",1060,938,122,19,12,64,75,851,762,89,13,5,50,54
"n294098","294098",2894,952,1942,101,404,1483,1802,2181,796,1385,78,271,1032,1267
"n293059","293059",3522,1469,2053,246,357,1449,1755,2760,1216,1544,183,253,1076,1306
"n390045","390045",5212,3079,2133,145,372,1520,1837,3893,2501,1392,97,222,981,1188
"n850116","850116",6402,3599,2803,1769,437,497,915,4936,2872,2064,1285,344,336,666
"n1010301","1010301",338,175,163,5,59,99,153,267,146,121,5,42,73,113
"n4394231","4394231",4744,255,4489,47,288,4152,4410,3201,216,2985,20,161,2793,2938
"n4970003","4970003",1649,1398,251,16,16,162,177,1250,1083,167,8,8,105,113
"n2710001","2710001",702,376,326,12,9,283,288,577,334,243,9,4,209,213
"n2710004","2710004",1087,773,314,18,15,250,261,981,718,263,11,11,203,213
"n3030057","3030057",3779,1958,1821,132,268,1362,1603,3152,1740,1412,111,213,1019,1223
"n3550040","3550040",5254,3983,1271,201,71,848,899,4260,3347,913,137,41,612,646
"n3730005","3730005",2073,1729,344,7,105,159,263,1822,1540,282,7,69,138,207
"n4090106","4090106",1233,715,518,16,41,437,472,980,610,370,12,33,307,336
"n1213149","1213149",4214,2908,1306,425,259,503,748,3360,2377,983,311,206,383,579
"n1890307","1890307",628,201,427,0,64,359,409,466,170,296,0,45,241,279
"n2010773","2010773",5515,221,5294,2410,1506,1419,2881,4267,176,4091,1964,1122,1038,2124
"n2011022","2011022",3663,1983,1680,265,504,862,1346,2724,1547,1177,196,360,579,925
"n2090347","2090347",3317,1973,1344,108,205,955,1125,2835,1730,1105,95,176,755,907
"n2450045","2450045",3119,439,2680,144,580,1985,2524,2206,370,1836,117,424,1305,1703
"n270302","270302",8267,4294,3973,266,1626,1998,3470,6519,3699,2820,201,1173,1339,2441
"n293157","293157",3313,1896,1417,114,162,1090,1242,2697,1611,1086,82,134,819,947
"n292104","292104",475,34,441,12,13,426,432,350,33,317,7,9,306,312
"n350005","350005",2374,2081,293,8,22,139,159,1956,1758,198,4,6,85,91
"n430004","430004",2320,1111,1209,32,72,1086,1135,1804,891,913,22,50,813,853
"n850216","850216",7977,5160,2817,378,1000,1167,2138,5207,3472,1735,219,636,699,1320
"n4393421","4393421",1840,1471,369,136,38,154,192,1429,1183,246,87,26,99,125
"n2510014","2510014",722,550,172,3,17,116,126,537,419,118,2,13,78,86
"n2930204","2930204",769,589,180,2,41,133,166,601,479,122,2,30,85,109
"n3090080B","3090080B",0,0,0,0,0,0,0,0,0,0,0,0,0,0
"n3390109","3390109",1758,1153,605,152,130,296,417,1434,997,437,109,94,217,307
"n3590404","3590404",222,198,24,2,2,20,22,160,146,14,2,1,11,12
"n4250003","4250003",2265,1664,601,45,25,478,496,1674,1291,383,29,18,297,310
"n1132506","1132506",3017,2087,930,121,149,579,720,2186,1589,597,84,84,370,453
"n2010087","2010087",3860,2823,1037,585,60,325,376,2775,2096,679,377,42,209,244
"n2010628","2010628",5957,516,5441,131,443,4872,5258,4281,456,3825,114,292,3393,3667
"n2030003","2030003",3700,632,3068,21,2397,618,2989,2855,573,2282,13,1847,379,2220
"n2150080","2150080",2628,31,2597,2,5,2591,2591,1704,12,1692,2,1,1688,1688
"n2270404","2270404",1016,625,391,4,20,341,358,777,514,263,0,10,232,241
"n270115","270115",6656,4724,1932,379,500,962,1382,4649,3439,1210,245,305,570,850
"n294055","294055",2283,1026,1257,88,229,939,1141,1878,913,965,67,188,696,866
"n293096","293096",4450,2358,2092,367,196,1484,1659,3288,1843,1445,230,137,1022,1144
"n410007","410007",1423,1126,297,15,35,207,239,1126,933,193,12,24,125,147
"n530015","530015",1281,965,316,8,31,237,265,1008,802,206,5,16,148,161
"n1391031","1391031",1125,617,508,12,224,253,467,840,479,361,9,163,173,328
"n4850406","4850406",5424,3763,1661,222,496,862,1310,4128,3052,1076,151,293,546,823
"n4910424","4910424",5264,3535,1729,483,313,843,1135,3828,2675,1153,323,202,546,740
"n2150223","2150223",949,111,838,29,14,798,808,573,69,504,19,11,475,484
"n3670315","3670315",5867,4725,1142,179,146,588,722,4669,3883,786,132,88,383,466
"n4170307","4170307",343,288,55,6,9,32,36,278,240,38,4,7,20,23
"n4391061","4391061",641,62,579,18,242,314,549,444,51,393,14,174,200,373
"n4393538","4393538",5453,3627,1826,1011,192,501,676,3718,2549,1169,649,124,310,425
"n4530306","4530306",4531,3443,1088,254,80,599,669,3818,2962,856,189,57,496,548
"n1574141","1574141",4367,2160,2207,1061,592,522,1091,3859,2066,1793,919,435,398,819
"n2010562","2010562",1403,31,1372,8,331,1057,1361,1040,29,1011,5,272,745,1001
"n2010064","2010064",5686,287,5399,31,163,5184,5329,4292,243,4049,23,123,3882,3994
"n2010727","2010727",2358,449,1909,136,1228,584,1748,1854,423,1431,117,890,452,1295
"n2011059","2011059",3911,632,3279,247,587,2468,2996,2881,525,2356,199,398,1755,2121
"n2090140","2090140",5465,1652,3813,1055,599,2121,2641,5042,1574,3468,1026,520,1886,2348
"n50032","50032",146,104,42,1,7,22,29,110,86,24,0,4,11,15
"n270305","270305",3131,1982,1149,99,369,649,980,2588,1767,821,70,261,441,687
"n292144","292144",2874,790,2084,63,82,1931,1993,2352,690,1662,52,58,1545,1591
"n293119","293119",4095,1998,2097,185,290,1588,1830,3335,1733,1602,145,215,1197,1384
"n350002","350002",1788,1077,711,4,18,636,648,1332,865,467,1,13,406,417
"n410030","410030",5460,1195,4265,50,914,3278,4125,3731,945,2786,43,608,2088,2672
"n4530337","4530337",6809,3021,3788,338,647,2732,3301,5603,2687,2916,269,515,2027,2495
"n4770208","4770208",2707,1630,1077,53,169,822,980,1997,1309,688,42,107,502,609
"n489002A","489002A",2121,155,1966,11,9,1929,1934,1544,113,1431,10,3,1401,1402
"n1574032","1574032",2128,265,1863,718,823,324,1132,1591,230,1361,567,545,236,772
"n1670495","1670495",2971,2240,731,238,78,363,429,2124,1657,467,148,49,224,270
"n2010207","2010207",1649,514,1135,34,30,1063,1087,1367,440,927,30,22,877,893
"n2010704","2010704",5057,3145,1912,140,81,1571,1633,3770,2464,1306,116,50,1044,1088
"n4392644","4392644",6068,1514,4554,974,2625,980,3539,3990,1060,2930,608,1708,590,2273
"n4530111","4530111",3836,919,2917,106,1676,1127,2739,3082,805,2277,86,1374,783,2133
"n850090","850090",4033,2598,1435,977,161,251,403,3110,2119,991,679,98,162,255
"n1132006","1132006",1930,1510,420,114,49,196,243,1463,1180,283,64,36,135,171
"n1134111","1134111",770,31,739,30,27,669,694,562,27,535,23,23,473,496
"n1211006","1211006",11,5,6,0,0,1,1,9,5,4,0,0,1,1
"n1391008","1391008",281,99,182,3,15,152,166,211,91,120,3,15,91,105
"n1410115","1410115",6077,728,5349,180,425,4802,5132,4180,567,3613,115,281,3212,3464
"n37001B","37001B",2301,579,1722,11,1467,183,1640,1609,467,1142,7,971,116,1084
"n910205","910205",6125,3932,2193,241,581,1253,1778,4875,3237,1638,176,458,881,1310
"n1131101","1131101",5201,226,4975,24,319,4644,4938,3520,199,3321,13,240,3065,3294
"n1134081","1134081",7706,208,7498,47,796,6678,7410,5302,151,5151,33,431,4672,5083
"n1150004","1150004",2518,1027,1491,24,94,1380,1439,1851,867,984,16,52,903,944
"n1213146","1213146",3611,2249,1362,527,260,501,740,2721,1785,936,345,187,340,515
"n3290108B","3290108B",0,0,0,0,0,0,0,0,0,0,0,0,0,0
"n3550034","3550034",1111,258,853,8,52,801,842,749,166,583,4,15,561,575
"n3810418","3810418",5928,3898,2030,113,461,1325,1707,4358,3122,1236,72,229,793,999
"n4392357","4392357",4466,2596,1870,320,858,587,1422,3280,2024,1256,204,599,378,959
"n4630002","4630002",1761,640,1121,3,9,1087,1093,1361,544,817,0,3,793,796
"n1470002","1470002",1771,1567,204,18,17,87,101,1411,1264,147,12,14,54,67
"n1670412","1670412",14,0,14,3,4,3,7,6,0,6,0,3,3,6
"n2010939","2010939",0,0,0,0,0,0,0,0,0,0,0,0,0,0
"n2170013","2170013",4112,3171,941,38,201,555,749,3160,2543,617,25,138,327,465
"n2490016","2490016",1413,103,1310,11,45,1242,1279,1031,80,951,9,34,895,925
"n2950404","2950404",468,390,78,1,3,39,42,364,318,46,0,1,22,23
"n294081","294081",1280,713,567,87,247,219,436,828,455,373,47,171,140,297
"n294032","294032",3098,344,2754,18,212,2552,2721,2368,314,2054,8,155,1891,2030
"n610021","610021",1855,97,1758,4,14,1726,1737,1396,76,1320,2,10,1290,1299
"n710005","710005",3627,2777,850,71,80,560,628,2774,2219,555,44,53,354,404
"n890201","890201",4372,2810,1562,17,441,1071,1469,3466,2370,1096,14,327,705,1027
"n1131136","1131136",26,8,18,0,0,18,18,23,8,15,0,0,15,15
"n2150246","2150246",23,0,23,0,1,18,19,23,0,23,0,1,18,19
"n3290404","3290404",3850,2417,1433,158,213,953,1146,3029,1972,1057,114,159,691,837
"n38702-1B","38702-1B",82,57,25,2,18,2,20,76,57,19,2,13,2,15
"n4370007","4370007",688,562,126,4,10,109,118,502,412,90,3,5,77,82
"n4394290","4394290",5109,2211,2898,215,213,2404,2580,3759,1820,1939,158,120,1590,1697
"n4930101","4930101",5023,2366,2657,57,143,2325,2448,4032,1979,2053,41,120,1775,1883
"n1132902","1132902",3709,1391,2318,372,1133,783,1878,3127,1304,1823,308,879,600,1458
"n1133110","1133110",4545,440,4105,77,3195,842,3974,3315,367,2948,60,2320,555,2852
"n1214168","1214168",2474,1691,783,93,183,424,592,2090,1492,598,78,126,309,431
"n1890101","1890101",680,184,496,1,31,458,487,517,164,353,1,24,323,346
"n2010585","2010585",5047,104,4943,29,2905,2055,4894,3412,83,3329,19,2016,1310,3295
"n2010916","2010916",6687,3900,2787,333,672,1658,2303,4779,2969,1810,230,437,1044,1470
"n50007","50007",1965,1578,387,16,50,261,311,1373,1159,214,12,32,127,159
"n50012","50012",1560,1014,546,28,127,363,489,1205,863,342,26,87,204,291
"n292118","292118",105,3,102,0,1,97,98,76,1,75,0,1,72,73
"n670011","670011",1030,697,333,9,268,25,292,806,549,257,6,215,12,227
"n1134035","1134035",2313,426,1887,25,1344,517,1844,1561,372,1189,16,841,321,1158
"n1131049","1131049",3025,1857,1168,144,457,562,992,2387,1482,905,99,368,419,772
"n4510358","4510358",3091,2071,1020,30,59,828,874,2268,1599,669,18,24,548,568
"n4510308","4510308",703,213,490,15,47,437,475,539,177,362,11,25,327,352
"n2450082","2450082",6020,1373,4647,421,3261,991,4187,4408,1231,3177,319,2191,660,2822
"n3030015","3030015",4207,3017,1190,213,125,740,844,3435,2581,854,145,94,519,606
"n3030141","3030141",4325,2244,2081,71,393,1559,1921,3301,1839,1462,46,265,1079,1336
"n323001C","323001C",6959,120,6839,32,32,6765,6780,4932,86,4846,24,21,4803,4817
"n4391608","4391608",1158,844,314,25,33,238,270,894,675,219,18,21,163,183
"n4394410","4394410",5506,2180,3326,776,1080,1387,2424,4363,1879,2484,623,790,980,1752
"n1133015","1133015",704,192,512,3,57,448,499,517,163,354,3,37,307,343
"n1131739","1131739",4448,1590,2858,1082,829,909,1725,3536,1369,2167,863,637,626,1256
"n1710007","1710007",3770,2777,993,21,28,860,881,3112,2423,689,17,18,576,591
"n2010399","2010399",10254,1270,8984,183,4469,4389,8669,7170,1130,6040,135,2934,2956,5805
"n2010393","2010393",3476,1277,2199,378,638,1160,1741,2711,1096,1615,261,480,814,1276
"n2010227","2010227",2139,1763,376,174,24,171,193,1625,1385,240,104,11,112,122
"n10018","10018",2845,2275,570,16,259,175,428,2249,1840,409,13,195,107,300
"n250009","250009",1015,87,928,1,22,903,919,768,72,696,1,16,675,688
"n293076","293076",1513,1047,466,43,42,371,411,1226,889,337,32,33,271,302
"n1391051","1391051",4950,2192,2758,62,705,1878,2558,3689,1794,1895,41,497,1258,1749
"n1610004A","1610004A",448,358,90,2,5,76,78,345,286,59,2,5,45,47
"n1770005","1770005",888,618,270,4,73,173,242,697,525,172,4,51,99,149
"n4850207","4850207",54,40,14,2,3,7,9,41,33,8,2,0,4,4
"n3070402","3070402",403,345,58,2,8,36,39,324,283,41,1,4,21,23
"n3090042","3090042",2623,585,2038,7,620,1429,2004,1887,478,1409,5,419,969,1378
"n3550057","3550057",1376,218,1158,9,56,1094,1136,1074,187,887,7,41,837,869
"n4392462","4392462",3315,824,2491,313,1165,1013,2130,2423,671,1752,213,850,665,1497
"n4510107","4510107",2279,827,1452,44,159,1241,1371,1626,693,933,27,101,781,870
"n4530270","4530270",5762,3951,1811,714,226,725,924,4723,3372,1351,532,159,536,681
"n2010250","2010250",4213,497,3716,46,1316,2358,3631,2909,409,2500,26,991,1470,2445
"n2090317","2090317",754,344,410,10,30,359,384,600,306,294,9,24,249,270
"n2310429","2310429",434,391,43,4,8,25,32,361,341,20,1,4,9,13
"n2410007","2410007",1790,704,1086,13,679,363,1034,1384,570,814,13,501,277,774
"n2470001","2470001",1181,79,1102,4,5,1079,1083,856,64,792,4,5,773,777
"n2990203","2990203",3352,2743,609,24,24,428,445,2855,2426,429,22,16,285,296
"n212014","212014",4659,3035,1624,47,139,1324,1448,3657,2538,1119,26,90,891,973
"n294012","294012",1752,57,1695,11,487,1221,1677,1186,47,1139,9,360,783,1126
"n292167","292167",156,36,120,13,24,88,110,132,32,100,9,17,74,91
"n410050","410050",21,7,14,4,7,3,8,11,7,4,3,0,1,1
"n910110","910110",3099,2090,1009,96,68,774,838,2468,1750,718,62,52,544,595
"n1134087","1134087",6747,279,6468,41,455,5974,6394,4564,241,4323,30,349,3942,4272
"n4530241","4530241",9366,2034,7332,352,1035,5877,6806,7002,1855,5147,328,816,3908,4659
"n4790169","4790169",4199,113,4086,6,21,4066,4076,2735,69,2666,5,15,2650,2659
"n2370002","2370002",1579,1359,220,14,12,159,165,1235,1099,136,4,2,99,99
"n3090019","3090019",4318,3022,1296,196,404,638,1024,3307,2423,884,133,264,427,689
"n3290203","3290203",1532,632,900,17,45,801,836,1136,516,620,13,34,544,572
"n3630028","3630028",1779,1119,660,1,51,545,592,1298,873,425,0,28,355,379
"n4391154","4391154",6362,896,5466,1464,2667,1324,3944,4431,848,3583,869,1728,965,2675
"n4391439","4391439",600,30,570,0,427,149,565,310,25,285,0,200,86,281
"n1133209","1133209",266,80,186,3,57,121,178,189,74,115,3,35,73,108
"n1410092","1410092",5244,921,4323,113,385,3857,4173,4348,850,3498,83,320,3105,3375
"n1630005","1630005",1064,519,545,4,8,508,516,816,421,395,2,6,364,370
"n1870110","1870110",271,150,121,2,12,105,114,243,143,100,0,9,87,95
"n2010519","2010519",5519,2452,3067,470,1130,1390,2467,4233,2071,2162,342,756,956,1690
"n2170007","2170007",1401,1151,250,7,35,166,198,1067,900,167,6,27,103,129
"n550401","550401",1940,357,1583,19,222,1356,1549,1460,294,1166,13,171,975,1136
"n910406","910406",5820,4306,1514,115,168,1132,1267,4963,3798,1165,91,145,840,962
"n1131081","1131081",4585,1739,2846,97,695,2001,2650,3643,1537,2106,92,520,1429,1929
"n1133319","1133319",185,28,157,1,93,63,150,118,18,100,1,57,41,96
"n1870211","1870211",151,87,64,1,14,49,60,124,79,45,1,7,38,44
"n2010419","2010419",6426,1494,4932,68,191,4632,4801,4606,1305,3301,41,109,3097,3202
"n3810131","3810131",3516,2785,731,19,42,520,555,2873,2367,506,15,27,339,363
"n4394512","4394512",0,0,0,0,0,0,0,0,0,0,0,0,0,0
"n4391095","4391095",942,843,99,13,6,60,65,766,694,72,13,4,37,41
"n4391515","4391515",77,38,39,0,5,32,35,58,33,25,0,1,22,23
"n2010542","2010542",5177,49,5128,63,1891,3248,5064,3819,42,3777,56,1452,2317,3725
"n2010959","2010959",10,5,5,0,2,4,4,10,5,5,0,2,4,4
"n2011082","2011082",0,0,0,0,0,0,0,0,0,0,0,0,0,0
"n2210105","2210105",3289,2862,427,20,31,261,287,2459,2170,289,16,22,166,186
"n325004B","325004B",5721,2279,3442,34,93,3227,3287,4258,1800,2458,26,64,2285,2333
"n3670115","3670115",4247,3374,873,50,88,557,636,3238,2647,591,29,54,353,407
"n390008","390008",1453,905,548,15,54,437,484,1147,768,379,9,32,300,329
"n550100","550100",861,322,539,18,19,469,484,677,283,394,10,7,355,361
"n790404","790404",628,128,500,7,38,466,493,443,93,350,5,24,322,345
"n850239","850239",6673,4418,2255,635,793,738,1484,4249,2855,1394,375,490,442,909
"n1131170","1131170",1877,1366,511,82,131,256,376,1557,1176,381,55,95,198,282
"n1132400","1132400",258,160,98,3,21,71,92,212,143,69,2,16,47,63
"n2910008","2910008",4103,3528,575,21,107,337,437,3098,2685,413,14,86,225,307
"n3090061","3090061",4672,2935,1737,221,587,875,1427,3587,2366,1221,164,394,601,982
"n3390045","3390045",3734,2446,1288,241,203,743,926,2902,2014,888,176,126,515,630
"n3550077","3550077",611,39,572,2,10,564,571,471,34,437,0,9,429,436
"n1134624","1134624",4356,1091,3265,129,262,2866,3093,3192,961,2231,92,189,1925,2092
"n1133611","1133611",1738,396,1342,27,870,439,1298,1287,352,935,22,628,270,898
"n2090204","2090204",1887,579,1308,64,206,1034,1207,1289,450,839,39,109,661,765
"n2150146","2150146",5853,108,5745,12,31,5720,5731,3694,47,3647,6,8,3626,3633
"n2310107","2310107",5029,3408,1621,172,568,704,1254,3878,2789,1089,118,395,435,824
"n2510037","2510037",2294,1831,463,37,73,297,370,1737,1440,297,17,55,183,238
"n50026","50026",2241,1855,386,7,107,248,351,1779,1522,257,6,63,161,223
"n292181F","292181F",125,37,88,13,16,54,68,74,24,50,8,9,30,38
"n850133","850133",4742,2246,2496,451,1053,890,1913,3386,1737,1649,322,665,553,1203
"n1134100","1134100",65,37,28,3,11,16,24,21,16,5,0,3,5,5
"n1132015","1132015",2683,1100,1583,74,321,1178,1486,2067,980,1087,51,254,766,1014
"n1132055","1132055",5351,914,4437,187,1267,2955,4171,4004,852,3152,158,948,2019,2930
"n4790266","4790266",4904,164,4740,24,41,4683,4711,3287,115,3172,17,34,3125,3149
"n2450025","2450025",3620,2458,1162,110,628,340,960,2737,1963,774,68,445,201,643
"n3030111","3030111",3136,2090,1046,121,126,728,841,2260,1586,674,86,86,442,525
"n3030037","3030037",1481,944,537,39,145,325,464,838,571,267,17,73,163,234
"n41901SE","41901SE",3119,728,2391,234,1398,740,2115,2302,589,1713,154,1046,496,1533
"n4392614","4392614",508,153,355,24,262,63,322,332,107,225,10,172,37,208
"n4530162","4530162",6496,2655,3841,707,1268,1870,3047,4877,2096,2781,517,926,1291,2170
"n1410072","1410072",2530,121,2409,18,42,2364,2382,1978,106,1872,9,36,1835,1849
"n1670341","1670341",4544,1034,3510,49,404,3018,3375,3090,835,2255,40,250,1926,2160
"n2010164","2010164",2585,64,2521,21,1319,1198,2492,1906,59,1847,17,1080,759,1823
"n2010213","2010213",4285,3431,854,423,48,329,367,3132,2541,591,300,34,204,236
"n2010710","2010710",3840,2580,1260,463,164,571,718,3349,2315,1034,373,126,460,577
"n2450062","2450062",3698,2449,1249,155,595,414,998,2864,2027,837,108,393,260,651
"n294181","294181",20,0,20,7,6,10,11,18,0,18,6,6,9,10
"n293139A","293139A",1955,781,1174,164,290,701,956,1517,644,873,122,206,526,708
"n1212069","1212069",4178,2467,1711,393,544,696,1214,3065,1849,1216,282,375,490,852
"n1350402","1350402",5456,697,4759,50,1222,3482,4630,4059,602,3457,43,926,2466,3358
"n1810103","1810103",4679,2028,2651,43,650,1818,2436,3334,1631,1703,25,453,1106,1547
"n1870117","1870117",2910,1425,1485,111,184,1183,1325,1929,1014,915,79,118,700,796
"n4393361","4393361",4436,3191,1245,194,213,746,938,3665,2727,938,144,160,542,689
"n4393716","4393716",3239,2256,983,353,202,375,563,2430,1773,657,241,127,250,366
"n4394599","4394599",4744,2573,2171,505,637,992,1574,3313,1864,1449,334,406,654,1039
"n4393574","4393574",1835,843,992,462,238,278,505,1480,721,759,316,202,227,420
"n1590202","1590202",1681,996,685,15,275,349,607,1226,754,472,8,197,241,424
"n1870404","1870404",6016,2717,3299,290,938,2116,2912,4218,2093,2125,186,603,1304,1840
"n2010242","2010242",5959,856,5103,66,356,4659,4973,4191,716,3475,36,230,3167,3384
"n2450020","2450020",2758,234,2524,47,1594,878,2459,1901,216,1685,36,1105,537,1635
"n2790009","2790009",1364,594,770,5,71,700,755,1046,509,537,4,47,483,525
"n3090079","3090079",3102,1585,1517,20,206,1217,1409,2211,1257,954,14,138,738,869
"n270318","270318",7361,4586,2775,362,767,1546,2229,5170,3383,1787,214,484,970,1417
"n294090","294090",4099,1387,2712,290,766,1697,2361,3066,1154,1912,212,529,1149,1629
"n292156","292156",2825,869,1956,550,331,1082,1379,2551,826,1725,487,267,961,1209
"n610036","610036",4106,701,3405,98,69,3241,3287,3044,639,2405,80,51,2265,2306
"n850151","850151",2815,1173,1642,811,485,278,753,1976,865,1111,548,314,193,504
"n1133007","1133007",2428,1764,664,223,150,264,392,2345,1729,616,212,134,247,365
"n4910136","4910136",678,116,562,6,18,525,540,463,98,365,4,13,334,347
"n49904-3","49904-3",5339,4123,1216,49,338,681,1007,4326,3346,980,36,286,525,805
"n3730003","3730003",2772,2077,695,26,268,311,564,2385,1895,490,19,215,182,392
"n4230010","4230010",4440,1555,2885,12,1665,1136,2780,3375,1221,2154,8,1381,707,2080
"n4391747","4391747",0,0,0,0,0,0,0,0,0,0,0,0,0,0
"n4393669","4393669",11,5,6,2,1,2,3,8,5,3,2,0,0,0
"n4530125","4530125",1723,361,1362,87,188,1075,1253,1321,331,990,73,162,745,900
"n4590016","4590016",2714,1841,873,35,457,246,701,2089,1497,592,23,331,134,464
"n1134126","1134126",2164,1792,372,135,44,149,190,1727,1454,273,92,34,114,146
"n1131163","1131163",1952,1580,372,78,39,182,216,1369,1126,243,47,26,123,147
"n1214183","1214183",613,554,59,6,5,38,43,477,433,44,5,5,27,32
"n1410127","1410127",998,57,941,4,7,929,932,728,45,683,0,3,674,674
"n1574076","1574076",4837,1302,3535,1368,1302,873,2133,3716,1065,2651,1060,968,613,1558
"n3490300","3490300",6454,2272,4182,124,1056,2644,3651,4744,1935,2809,92,757,1703,2441
"n1410196","1410196",6494,495,5999,138,350,5580,5823,4377,371,4006,80,212,3699,3870
"n1670144","1670144",4149,2252,1897,142,417,1211,1599,3181,1878,1303,126,266,789,1047
"n1910401","1910401",385,269,116,2,12,95,102,314,226,88,1,7,73,78
"n2010288","2010288",2484,48,2436,2,1968,471,2422,1939,33,1906,2,1610,297,1894
"n2010620","2010620",7185,2458,4727,1179,2212,1304,3428,5972,2165,3807,1012,1697,1041,2679
"n2010951","2010951",871,91,780,46,215,535,731,607,76,531,36,142,355,491
"n4530152","4530152",5057,2063,2994,1027,886,1067,1890,3382,1431,1951,670,556,693,1221
"n4630014","4630014",84,57,27,0,2,24,25,76,51,25,0,1,22,23
"n4790250B","4790250B",8,0,8,0,0,8,8,5,0,5,0,0,5,5
"n4910186","4910186",5838,1741,4097,3205,185,608,779,3955,1319,2636,2001,128,433,552
"n4970018","4970018",2263,1139,1124,14,156,917,1069,1764,929,835,11,137,655,792
"n2090436","2090436",2191,1659,532,116,54,316,369,1551,1192,359,76,39,210,248
"n2190035","2190035",386,131,255,2,17,234,250,268,110,158,2,13,140,153
"n4230033","4230033",1507,1061,446,28,264,119,380,1169,894,275,14,164,76,238
"n4394018","4394018",2130,1183,947,41,122,744,849,1565,971,594,34,60,464,522
"n4392145","4392145",6010,801,5209,146,837,4191,4979,4179,684,3495,114,582,2763,3321
"n4530380","4530380",5754,4011,1743,599,210,813,994,4578,3293,1285,437,156,594,733
"n1134529","1134529",1048,263,785,130,346,333,648,768,219,549,87,256,213,457
"n1219200","1219200",0,0,0,0,0,0,0,0,0,0,0,0,0,0
"n1410173","1410173",3700,82,3618,12,16,3602,3608,2569,64,2505,6,6,2499,2501
"n1610011B","1610011B",428,215,213,4,183,17,197,352,177,175,4,153,8,161
"n1890205","1890205",821,73,748,4,66,688,745,574,66,508,1,52,456,505
"n2010928","2010928",82,61,21,7,1,11,12,57,40,17,7,1,8,9
"n4530352","4530352",4496,2903,1593,270,189,1054,1227,3779,2481,1298,212,154,859,1002
"n4530182","4530182",5655,830,4825,563,772,3496,4207,4136,724,3412,435,596,2353,2912
"n467001C","467001C",2501,2070,431,14,20,316,334,1924,1639,285,9,10,205,214
"n4790130","4790130",5859,86,5773,2,10,5765,5768,3834,37,3797,0,5,3794,3796
"n4910253","4910253",7746,4704,3042,450,549,1907,2364,5529,3525,2004,288,355,1207,1517
"n4930416","4930416",2806,1833,973,41,98,765,849,2129,1437,692,20,81,536,610
"n2010265","2010265",6363,3815,2548,1568,239,667,886,4874,3051,1823,1093,186,489,664
"n2010597","2010597",6311,678,5633,1475,1240,2919,4112,4619,581,4038,1110,795,2104,2877
"n4394092","4394092",2798,126,2672,13,44,2617,2650,2029,105,1924,9,31,1886,1910
"n4391146","4391146",4050,1402,2648,141,1576,905,2420,3095,1221,1874,102,1130,603,1699
"n4394595","4394595",220,72,148,1,3,142,145,154,54,100,0,3,95,98
"n4392708","4392708",2942,1059,1883,213,1209,419,1612,2047,797,1250,140,800,272,1064
"n294159","294159",92,23,69,5,23,52,60,54,18,36,4,5,30,30
"n291132","291132",926,142,784,21,9,761,768,691,129,562,18,4,543,546
"n330004","330004",151,120,31,7,5,25,27,107,92,15,1,1,15,15
"n850005","850005",1645,1004,641,88,148,347,472,1247,833,414,55,100,211,297
"n1132112","1132112",183,99,84,20,23,36,59,182,98,84,20,23,36,59
"n1211044","1211044",2145,1214,931,98,331,449,759,1677,1019,658,82,239,294,520
"n4910305","4910305",1469,988,481,37,111,308,405,1058,750,308,26,72,190,257
"n3350001","3350001",1790,1036,754,21,79,636,702,1289,802,487,16,32,416,446
"n3550097","3550097",2014,190,1824,9,72,1757,1796,1529,154,1375,7,43,1325,1353
"n39304-2","39304-2",89,82,7,0,2,2,4,75,69,6,0,2,1,3
"n4391085","4391085",2169,345,1824,189,438,1194,1618,1451,269,1182,93,298,788,1078
"n4394497","4394497",8917,2629,6288,220,3882,2163,5912,6512,2269,4243,139,2613,1428,3979
"n4770104","4770104",3950,1113,2837,68,1701,1036,2702,2956,928,2028,40,1287,668,1946
"n1211038","1211038",2642,1215,1427,282,648,439,1075,1708,826,882,174,403,258,655
"n1571144","1571144",7661,3425,4236,2366,392,1346,1697,5306,2615,2691,1484,255,859,1092
"n2010079","2010079",6115,152,5963,22,216,5761,5918,4618,134,4484,13,148,4331,4461
"n2010742","2010742",2527,1026,1501,734,285,449,726,1902,812,1090,544,203,301,502
"n21304SE","21304SE",4192,3280,912,27,187,541,722,3405,2781,624,21,126,348,471
"n2550005","2550005",1236,380,856,5,21,817,833,896,328,568,4,14,543,553
"n291110","291110",6439,1346,5093,386,1060,3797,4680,4073,949,3124,233,624,2293,2834
"n850028","850028",4698,2865,1833,716,499,549,1028,3822,2415,1407,596,355,377,725
"n1132137","1132137",4306,484,3822,309,1399,2124,3472,3272,442,2830,248,1113,1464,2545
"n1211061","1211061",5304,2928,2376,116,533,1618,2114,4090,2458,1632,72,383,1080,1443
"n1572023","1572023",5609,132,5477,78,1710,3737,5376,4103,100,4003,67,1306,2647,3918
"n2010096","2010096",6487,289,6198,49,2584,3652,6096,4120,205,3915,30,1700,2218,3847
"n2670004","2670004",651,389,262,9,8,226,234,536,339,197,9,8,166,174
"n3030010","3030010",2240,937,1303,144,320,780,1070,1966,872,1094,124,271,654,901
"n329108A","329108A",820,417,403,16,18,353,365,640,328,312,13,11,269,278
"n3550075","3550075",3578,158,3420,19,76,3349,3394,2758,130,2628,12,40,2574,2608
"n4391021","4391021",3791,2791,1000,107,195,576,767,3039,2341,698,81,130,391,517
"n4394375","4394375",4418,2999,1419,205,369,735,1080,3388,2412,976,143,252,491,739
"n2010102","2010102",4267,519,3748,39,540,3156,3647,3246,427,2819,28,435,2320,2730
"n2010765","2010765",6301,1129,5172,961,2417,1808,4116,4832,972,3860,811,1683,1352,2964
"n2010643","2010643",8745,1886,6859,594,1440,4833,6149,6444,1603,4841,451,977,3378,4291
"n2130002","2130002",585,469,116,5,18,65,83,428,352,76,5,6,44,50
"n2150095","2150095",8579,152,8427,41,28,8355,8364,6096,102,5994,34,12,5944,5947
"n2510029","2510029",1892,1545,347,21,44,192,232,1378,1159,219,14,25,116,140
"n294113","294113",1995,186,1809,35,734,1063,1763,1476,177,1299,21,544,745,1271
"n291010","291010",910,128,782,10,25,747,765,765,121,644,6,23,612,628
"n292017","292017",2364,53,2311,7,35,2270,2294,1731,38,1693,5,17,1671,1683
"n37003B","37003B",3923,1426,2497,30,1952,463,2383,3056,1224,1832,27,1450,305,1741
"n730042","730042",2491,399,2092,17,1049,1023,2056,1726,317,1409,8,758,633,1386
"n850128","850128",3820,2992,828,264,113,319,426,2717,2195,522,157,68,216,282
"n4530372A","4530372A",954,583,371,263,24,71,93,639,382,257,185,21,47,66
"n3390028A","3390028A",6751,4588,2163,81,152,1737,1873,5061,3647,1414,48,84,1133,1213
"n3390098","3390098",3784,2238,1546,384,348,750,1080,2863,1751,1112,265,249,549,791
"n3550052","3550052",1319,117,1202,7,66,1126,1183,995,99,896,3,54,836,884
"n3990004","3990004",653,338,315,3,23,288,305,499,280,219,2,19,195,212
"n4350201","4350201",824,353,471,4,8,456,463,647,308,339,1,4,330,334
"n4392827B","4392827B",0,0,0,0,0,0,0,0,0,0,0,0,0,0
"n1132805","1132805",5792,2841,2951,1810,362,697,1022,4207,2248,1959,1219,236,445,658
"n2010788","2010788",1216,264,952,10,69,873,935,854,229,625,6,38,574,610
"n2150118","2150118",3675,159,3516,41,14,3473,3477,2543,127,2416,26,8,2382,2386
"n2210101","2210101",3117,2631,486,44,73,284,344,2664,2358,306,26,38,167,202
"n2730034","2730034",1367,615,752,15,17,701,713,1122,546,576,9,7,539,545
"n2970014","2970014",1201,726,475,2,8,447,454,933,583,350,1,1,331,332
"n294136","294136",1962,669,1293,55,341,906,1218,1408,524,884,34,230,606,829
"n291033","291033",4788,576,4212,71,217,3917,4088,3375,504,2871,50,142,2662,2789
"n291154B","291154B",19,6,13,3,0,8,8,19,6,13,3,0,8,8
"n370013","370013",56,42,14,1,2,5,7,48,41,7,1,0,3,3
"n770024","770024",459,424,35,2,10,11,21,362,338,24,1,7,4,11
"n850105","850105",82,46,36,1,25,4,29,69,44,25,0,15,4,19
"n4392673","4392673",0,0,0,0,0,0,0,0,0,0,0,0,0,0
"n2930405","2930405",387,331,56,1,7,39,46,317,282,35,1,4,22,26
"n3390005","3390005",407,354,53,1,9,33,41,340,299,41,1,5,26,31
"n3430103","3430103",932,532,400,10,275,88,360,760,448,312,6,215,69,282
"n3550029","3550029",5126,1870,3256,346,237,2607,2809,3822,1548,2274,262,142,1806,1941
"n397001D","397001D",1798,811,987,76,325,522,837,1256,612,644,51,225,328,548
"n4150009","4150009",680,535,145,3,5,114,118,505,406,99,1,0,79,79
"n1132087","1132087",4030,2406,1624,145,369,1026,1376,3373,2131,1242,113,297,738,1027
"n2010934","2010934",424,68,356,23,266,78,332,329,63,266,9,209,53,255
"n2150141","2150141",185,21,164,9,7,147,154,136,21,115,9,7,100,107
"n2170005","2170005",1820,1559,261,6,42,159,197,1407,1246,161,5,16,98,114
"n2570013","2570013",7149,3369,3780,283,1883,1518,3322,4882,2496,2386,191,1135,922,2038
"n277003F","277003F",1313,1114,199,6,10,130,139,894,762,132,5,6,86,92
"n270216","270216",5884,2558,3326,377,1457,1396,2724,4550,2171,2379,267,1034,933,1912
"n293195","293195",2945,858,2087,286,413,1394,1785,2621,773,1848,255,357,1238,1579
"n292057","292057",4521,293,4228,38,88,4121,4167,3467,252,3215,23,61,3127,3168
"n410025","410025",1883,147,1736,32,1111,607,1692,1250,104,1146,14,788,340,1120
"n690301","690301",1448,557,891,8,33,836,864,1056,476,580,7,26,543,566
"n850168","850168",2574,1799,775,408,103,191,289,1721,1246,475,253,71,103,170
"n4890009","4890009",1509,65,1444,9,20,1425,1435,1123,60,1063,7,12,1049,1056
"n5050002","5050002",2874,152,2722,11,6,2705,2707,1948,133,1815,7,6,1805,1807
"n2450097","2450097",770,199,571,14,471,86,545,515,178,337,11,269,53,314
"n2790002","2790002",1493,279,1214,8,156,1059,1197,1058,211,847,5,110,726,831
"n2910025","2910025",1940,1599,341,7,24,250,274,1452,1228,224,4,13,159,172
"n4393584","4393584",0,0,0,0,0,0,0,0,0,0,0,0,0,0
"n4393260","4393260",2015,1549,466,77,114,218,324,1606,1267,339,59,75,155,228
"n4410403","4410403",4777,2770,2007,172,905,888,1736,3924,2398,1526,128,676,651,1305
"n1131307","1131307",885,50,835,8,706,128,827,618,50,568,6,486,78,561
"n1850002","1850002",1323,1072,251,11,37,150,182,1012,855,157,8,15,95,110
"n2010580","2010580",1502,80,1422,9,955,471,1406,1187,67,1120,9,792,319,1105
"n2010911","2010911",1512,561,951,56,318,549,833,1199,494,705,46,221,400,607
"n2011160","2011160",0,0,0,0,0,0,0,0,0,0,0,0,0,0
"n2010828","2010828",2547,1869,678,167,93,348,438,1919,1471,448,100,66,222,288
"n130021","130021",1384,739,645,16,22,586,604,1090,607,483,12,13,441,450
"n294096","294096",5783,1423,4360,164,1139,3139,4154,4482,1263,3219,135,803,2282,3036
"n37016A","37016A",105,101,4,1,1,1,2,84,81,3,0,0,1,1
"n610030","610030",2759,541,2218,17,53,2159,2189,1859,433,1426,16,32,1378,1398
"n910108","910108",2473,1883,590,42,53,420,470,2127,1673,454,34,35,323,357
"n1132027","1132027",1796,1472,324,75,49,178,227,1626,1341,285,73,40,153,193
"n4530393","4530393",5437,3194,2243,1045,283,792,1047,3803,2325,1478,740,161,477,633
"n4610003","4610003",858,244,614,4,35,578,601,633,201,432,3,22,401,419
"n4790311","4790311",3031,82,2949,7,19,2934,2936,2271,74,2197,6,18,2189,2191
"n2150218","2150218",2127,41,2086,4,11,2075,2080,1447,29,1418,1,8,1409,1414
"n2450037","2450037",3756,2779,977,98,173,619,786,2918,2297,621,63,97,384,479
"n3490201","3490201",1449,196,1253,8,988,225,1201,995,133,862,6,694,124,817
"n3710006","3710006",280,56,224,1,1,221,221,226,51,175,1,0,173,173
"n4010318","4010318",1522,1087,435,12,250,149,394,1160,842,318,7,200,89,287
"n4391293","4391293",3159,324,2835,32,932,1890,2787,2225,283,1942,22,693,1226,1903
"n1350305","1350305",1537,227,1310,57,84,1157,1231,1161,192,969,38,59,863,916
"n1870226","1870226",617,224,393,0,17,366,380,496,206,290,0,14,267,278
"n2010520","2010520",1240,39,1201,17,944,260,1171,849,30,819,10,651,165,796
"n2010225","2010225",2702,805,1897,237,831,846,1634,2237,748,1489,195,630,662,1267
"n2090125","2090125",2381,589,1792,41,92,1654,1719,1760,482,1278,37,68,1158,1212
"n2150181","2150181",1003,598,405,0,5,390,392,917,598,319,0,2,306,306
"n292011","292011",3686,235,3451,15,139,3330,3421,2661,199,2462,11,80,2380,2436
"n293149","293149",4776,1153,3623,443,946,2295,3158,4491,1082,3409,408,879,2178,2987
"n730048","730048",883,728,155,4,8,111,117,664,568,96,2,5,59,62
"n1134014","1134014",2394,1932,462,123,50,233,279,1872,1524,348,85,43,174,215
"n1132900","1132900",4427,2390,2037,332,533,1141,1628,3769,2236,1533,262,398,819,1198
"n1133314","1133314",5660,1157,4503,163,2259,2066,4272,4060,969,3091,124,1571,1361,2908
"n4393396","4393396",4541,3160,1381,599,206,438,638,3430,2455,975,412,162,292,453
"n2010534","2010534",2687,1019,1668,96,68,1491,1545,2084,926,1158,59,42,1037,1070
"n2010782","2010782",3230,1604,1626,249,369,962,1305,2526,1320,1206,208,275,667,934
"n2010865","2010865",5453,2098,3355,633,1122,1587,2625,4586,1848,2738,524,923,1262,2119
"n3090040","3090040",3087,1905,1182,71,525,533,1037,2457,1630,827,46,368,363,722
"n3390104","3390104",1716,1016,700,194,109,367,472,1106,686,420,111,68,217,283
"n4391490","4391490",1377,369,1008,76,757,168,914,1058,316,742,63,550,127,666
"n1190009","1190009",358,329,29,3,7,10,16,289,265,24,3,5,9,13
"n1410110","1410110",5274,522,4752,114,246,4420,4609,4053,458,3595,101,164,3332,3474
"n1572089","1572089",1698,30,1668,28,1396,260,1635,1321,28,1293,24,1085,188,1263
"n1574012","1574012",5740,1065,4675,47,401,4226,4583,4145,908,3237,31,269,2911,3167
"n1670461","1670461",5090,3797,1293,280,171,705,863,3711,2839,872,207,115,460,569
"n1810209","1810209",2195,1809,386,18,80,240,315,1758,1484,274,12,67,160,224
"n5017B","5017B",610,533,77,1,10,27,36,448,399,49,0,5,9,14
"n291027","291027",800,146,654,69,87,492,572,554,118,436,53,62,319,378
"n293005","293005",4496,2452,2044,190,367,1422,1756,3153,1803,1350,134,245,908,1136
"n850111","850111",3868,2586,1282,538,286,369,646,2852,1987,865,376,198,239,431
"n1134079","1134079",5168,2938,2230,170,706,1290,1969,4350,2559,1791,136,593,985,1564
"n1132096","1132096",0,0,0,0,0,0,0,0,0,0,0,0,0,0
"n4530454","4530454",4490,1684,2806,415,532,1848,2323,3787,1511,2276,347,445,1459,1861
"n4550015","4550015",151,139,12,2,4,3,7,125,115,10,2,2,3,5
"n4810401","4810401",5586,1372,4214,38,866,3321,4136,3914,1103,2811,21,597,2184,2762
"n2010142","2010142",2256,73,2183,18,38,2139,2159,1641,60,1581,12,29,1548,1560
"n2010474","2010474",1579,770,809,160,246,381,613,1186,607,579,125,173,266,426
"n2150135","2150135",3672,403,3269,139,67,3034,3090,2890,365,2525,114,54,2326,2377
"n3670260","3670260",4472,3728,744,76,76,449,516,3486,2982,504,46,45,294,337
"n4150015","4150015",3619,1054,2565,34,171,2332,2478,2526,822,1704,17,118,1524,1638
"n4510304","4510304",6362,2715,3647,66,232,3236,3424,4724,2238,2486,49,135,2181,2306
"n1213144","1213144",5233,3194,2039,1308,168,456,610,3718,2390,1328,838,124,287,407
"n1391023","1391023",0,0,0,0,0,0,0,0,0,0,0,0,0,0
"n1410050","1410050",5084,621,4463,139,368,4000,4258,3593,504,3089,93,244,2739,2932
"n1550201","1550201",277,211,66,3,7,52,59,221,178,43,2,3,34,37
"n1870104","1870104",2115,913,1202,48,193,946,1120,1765,814,951,41,154,731,880
"n2010388","2010388",5145,886,4259,264,2044,1968,3928,3564,686,2878,182,1399,1280,2630
"n294153","294153",339,122,217,3,13,195,203,246,90,156,2,9,140,145
"n293111","293111",0,0,0,0,0,0,0,0,0,0,0,0,0,0
"n33003B","33003B",56,43,13,1,4,9,12,43,33,10,1,3,7,9
"n430002","430002",1655,887,768,38,40,644,670,1394,801,593,30,25,487,508
"n1133802","1133802",6606,413,6193,50,4537,1655,6112,4727,375,4352,33,3293,1042,4300
"n1132501","1132501",4234,3086,1148,213,229,568,791,3699,2705,994,167,207,489,695
"n4690008","4690008",5859,1542,4317,78,643,3635,4162,4156,1279,2877,63,389,2395,2761
"n3390060","3390060",8597,2482,6115,334,886,4831,5663,6639,2074,4565,270,641,3582,4199
"n3550092A","3550092A",2783,1195,1588,62,100,1383,1459,2251,1048,1203,47,81,1018,1090
"n3950006","3950006",2209,1664,545,16,307,182,481,1648,1288,360,10,201,121,319
"n4250001","4250001",2305,1581,724,23,33,557,584,1723,1248,475,17,16,354,369
"n4530327","4530327",3670,2716,954,533,44,300,339,2550,1927,623,352,18,195,208
"n4690002","4690002",1588,631,957,15,122,807,918,1352,561,791,9,104,664,762
"n1350111","1350111",4663,1561,3102,218,332,2519,2823,2996,1071,1925,148,217,1519,1725
"n1750042","1750042",876,708,168,3,20,129,144,695,571,124,3,17,88,101
"n2010328","2010328",5741,431,5310,120,666,4602,5178,4078,397,3681,97,453,3176,3580
"n2011074","2011074",2310,214,2096,174,1397,573,1903,1686,199,1487,136,949,415,1335
"n2150078","2150078",4443,118,4325,7,8,4306,4311,3245,95,3150,3,8,3138,3143
"n2250003","2250003",2468,729,1739,9,1402,318,1711,1843,618,1225,5,1009,200,1205
"n50002","50002",5254,946,4308,41,2076,2174,4217,3768,788,2980,29,1511,1424,2922
"n291073","291073",6070,1701,4369,412,737,3256,3884,4065,1187,2878,268,489,2092,2530
"n291116","291116",2298,718,1580,85,288,1232,1468,1675,573,1102,59,177,859,1019
"n850022","850022",6397,4378,2019,144,361,1346,1671,4514,3211,1303,86,242,856,1076
"n850065","850065",1940,1059,881,184,181,484,656,1532,912,620,137,125,322,442
"n1010101","1010101",344,251,93,8,23,66,86,274,206,68,6,18,47,62
"n4910421","4910421",1778,793,985,58,245,659,870,1246,622,624,35,155,409,548
"n2690003","2690003",70,60,10,2,4,6,9,55,48,7,2,1,6,6
"n3030004","3030004",2259,191,2068,20,207,1860,2038,1665,154,1511,16,143,1357,1487
"n3310105","3310105",1876,1291,585,5,43,499,532,1424,1034,390,2,35,321,351
"n4090101","4090101",749,271,478,2,13,455,461,554,201,353,2,6,336,340
"n4394222","4394222",2420,766,1654,44,99,1479,1560,1760,649,1111,31,57,996,1044
"n4392520","4392520",2930,1480,1450,275,549,585,1123,2205,1211,994,211,373,370,740
"n1133093","1133093",55,3,52,1,5,47,51,39,3,36,1,3,33,35
"n1410004","1410004",3083,317,2766,55,62,2650,2700,2366,279,2087,33,43,2001,2041
"n1670197","1670197",1914,975,939,28,177,695,856,1431,829,602,24,127,421,546
"n2010434","2010434",2381,1379,1002,279,258,441,681,2226,1334,892,250,219,394,602
"n2010974","2010974",3631,335,3296,504,1275,1554,2780,2403,222,2181,372,795,1031,1799
"n2330021","2330021",4132,3445,687,41,53,345,390,3291,2793,498,20,26,240,266
"n230003","230003",861,670,191,5,30,126,153,680,556,124,1,15,78,93
"n294199","294199",3124,818,2306,203,503,1634,2074,2120,601,1519,144,295,1081,1353
"n294196","294196",0,0,0,0,0,0,0,0,0,0,0,0,0,0
"n293155","293155",4377,2116,2261,415,257,1521,1754,3093,1555,1538,290,160,1024,1178
"n410065","410065",341,236,105,23,22,44,66,255,183,72,20,17,25,42
"n850214","850214",5812,4550,1262,372,419,373,785,3887,3112,775,223,254,218,471
"n4394683","4394683",0,0,0,0,0,0,0,0,0,0,0,0,0,0
"n2510012B","2510012B",1577,1262,315,21,29,205,232,1124,918,206,16,18,137,153
"n2870401","2870401",1160,611,549,7,295,239,512,893,513,380,5,210,144,349
"n3090034","3090034",1867,1281,586,17,173,374,533,1507,1140,367,14,104,223,324
"n3590303","3590303",442,294,148,14,13,123,126,333,241,92,8,5,78,79
"n3870004","3870004",1694,904,790,18,560,176,726,1359,805,554,12,420,87,506
"n4230027","4230027",3303,1959,1344,127,547,613,1138,2734,1729,1005,104,397,446,828
"n1132154","1132154",67,28,39,6,14,17,30,60,28,32,4,13,10,23
"n1131121","1131121",5783,652,5131,569,894,3649,4513,4255,577,3678,445,719,2469,3176
"n1230303","1230303",718,485,233,1,21,199,214,551,386,165,1,14,141,153
"n2010040","2010040",638,514,124,41,23,56,77,515,424,91,29,15,43,57
"n2011120","2011120",4185,1299,2886,594,744,1524,2213,2832,953,1879,401,437,1014,1423
"n2150032","2150032",4191,194,3997,15,41,3962,3983,2857,157,2700,14,21,2679,2687
"n7004A","7004A",1295,1025,270,20,12,180,183,1188,954,234,14,9,157,159
"n294050","294050",2368,1051,1317,94,285,931,1180,1969,957,1012,82,210,689,884
"n291070","291070",2528,321,2207,41,245,1935,2152,1840,271,1569,35,183,1360,1519
"n293011","293011",1220,607,613,65,51,496,537,1010,541,469,45,33,379,412
"n390043","390043",8268,4381,3887,522,798,2455,3153,6375,3646,2729,402,543,1643,2145
"n570009","570009",1722,731,991,29,35,910,937,1279,588,691,18,22,635,653
"n4391120","4391120",4747,340,4407,77,2652,1710,4310,3402,277,3125,58,2013,1054,3048
"n4394070","4394070",3629,1782,1847,155,666,966,1586,2948,1620,1328,109,479,668,1124
"n2430002","2430002",494,257,237,10,4,216,218,405,221,184,8,3,169,170
"n2593060","2593060",969,727,242,20,7,174,177,781,605,176,12,1,129,130
"n3030054","3030054",3828,3020,808,64,118,559,665,3094,2545,549,45,63,374,433
"n3290104","3290104",2344,552,1792,20,136,1624,1747,1681,460,1221,11,90,1105,1190
"n3530001","3530001",1898,1057,841,23,135,653,763,1427,847,580,13,79,435,511
"n3670230","3670230",2345,1837,508,13,48,328,374,1777,1448,329,7,33,202,234
"n850068","850068",3581,1352,2229,147,368,1633,1970,2724,1185,1539,112,256,1096,1340
"n930012","930012",2975,2109,866,8,32,755,775,2347,1737,610,5,20,525,539
"n1133047","1133047",5638,508,5130,238,3469,1139,4575,4070,433,3637,216,2456,781,3215
"n1212101","1212101",8486,2108,6378,754,3675,1923,5475,7034,1959,5075,668,2811,1532,4275
"n2010725","2010725",5474,790,4684,124,1970,2665,4532,3937,668,3269,88,1395,1812,3158
"n2090342B","2090342B",57,44,13,3,3,3,6,49,38,11,3,3,1,4
"n170001","170001",1650,647,1003,1,22,965,979,1155,508,647,0,9,622,630
"n1131079","1131079",3290,1139,2151,109,879,1133,1988,2622,983,1639,91,688,821,1500
"n1133108","1133108",3612,1346,2266,97,1315,810,2094,2775,1170,1605,75,942,531,1464
"n1132504","1132504",2007,1310,697,148,117,383,491,1598,1097,501,122,79,258,335
"n1213124","1213124",294,161,133,72,24,32,51,247,144,103,56,18,22,38
"n1430025","1430025",1225,838,387,13,13,335,346,933,674,259,8,7,221,228
"n3550012","3550012",2023,267,1756,8,26,1717,1735,1425,186,1239,0,19,1211,1225
"n4050003","4050003",432,245,187,6,141,46,183,363,229,134,2,111,21,131
"n4392281","4392281",2127,1071,1056,145,472,413,852,1798,987,811,125,362,298,644
"n4393216","4393216",5914,3116,2798,1102,648,899,1521,4585,2543,2042,799,451,660,1097
"n4410305","4410305",4918,3719,1199,176,288,646,903,3967,3143,824,132,184,443,617
"n1830017","1830017",1908,737,1171,16,645,463,1099,1355,583,772,8,476,248,721
"n1990013","1990013",3940,3455,485,49,60,251,305,2975,2661,314,33,27,164,189
"n2010325","2010325",5995,414,5581,74,1599,3951,5473,4187,377,3810,51,1075,2684,3721
"n2450103","2450103",476,387,89,14,16,52,68,329,270,59,9,10,34,44
"n2930103","2930103",894,735,159,7,56,72,121,729,607,122,2,40,46,86
"n3070302","3070302",313,252,61,3,5,51,51,276,224,52,2,1,44,44
"n1150002","1150002",2500,639,1861,21,104,1732,1815,1786,492,1294,11,70,1200,1262
"n1410090","1410090",2339,380,1959,35,66,1866,1917,1858,330,1528,26,48,1456,1494
"n1450403","1450403",1183,684,499,1,144,330,470,909,549,360,1,128,206,334
"n1670399","1670399",733,122,611,23,84,487,566,571,91,480,17,69,382,449
"n1870107","1870107",1694,1199,495,24,43,364,401,1336,999,337,5,30,248,277
"n2010348","2010348",4420,1591,2829,183,374,2230,2563,3555,1462,2093,137,269,1623,1875
"n323001A","323001A",2590,61,2529,17,5,2488,2491,2006,54,1952,12,2,1925,1925
"n3510021","3510021",536,472,64,4,12,36,48,432,382,50,2,9,29,38
"n3610015","3610015",2550,1894,656,41,365,160,520,1980,1545,435,22,231,124,351
"n4230047","4230047",652,336,316,3,193,81,274,518,278,240,3,158,49,207
"n2010845","2010845",837,410,427,50,185,192,368,750,392,358,40,157,159,308
"n2010182","2010182",1577,564,1013,257,463,291,741,1332,483,849,200,412,229,632
"n2150058","2150058",7133,253,6880,52,58,6804,6830,5025,193,4832,34,27,4781,4796
"n2450080","2450080",394,291,103,7,8,74,82,306,238,68,7,7,45,52
"n2594090","2594090",1587,1116,471,38,38,353,377,1252,938,314,24,22,228,244
"n3030139","3030139",2643,1939,704,118,48,483,520,1920,1430,490,80,31,324,353
"n294030","294030",1008,29,979,4,296,708,967,677,21,656,2,222,435,645
"n292099","292099",2714,922,1792,153,214,1440,1622,2126,773,1353,129,149,1058,1198
"n390063","390063",6806,1056,5750,638,3174,1974,5051,4712,785,3927,449,2169,1282,3420
"n610093","610093",1003,89,914,31,14,877,883,712,68,644,24,9,611,616
"n850208","850208",3687,2302,1385,528,338,430,740,2631,1715,916,355,227,273,481
"n1134555","1134555",73,28,45,0,1,40,40,60,26,34,0,0,31,31
"n4710302","4710302",1294,749,545,18,191,303,492,974,603,371,8,126,210,335
"n4910390A","4910390A",4339,2682,1657,693,230,660,863,3026,1915,1111,471,167,419,564
"n2450054","2450054",684,38,646,10,555,82,632,521,36,485,5,423,58,478
"n2570030","2570030",4112,2169,1943,32,128,1699,1807,2765,1637,1128,8,74,965,1033
"n3390022","3390022",7870,5607,2263,105,487,1397,1863,5973,4465,1508,71,318,895,1205
"n4370004","4370004",1030,273,757,8,133,617,737,731,215,516,6,86,419,500
"n4394285","4394285",3260,1213,2047,96,879,1053,1886,2292,992,1300,74,531,661,1176
"n4530267","4530267",4055,2842,1213,512,125,526,627,3169,2265,904,381,95,384,463
"n1131714","1131714",5295,1162,4133,86,272,3739,3974,3720,978,2742,55,177,2468,2628
"n1574025","1574025",9033,2385,6648,322,1543,4765,6210,6388,1907,4481,223,976,3243,4177
"n2010205","2010205",2646,53,2593,8,1942,656,2567,1988,43,1945,6,1521,423,1925
"n2010374","2010374",1288,61,1227,9,40,1181,1214,992,60,932,5,28,901,925
"n2011037","2011037",5630,297,5333,2088,1532,1732,3224,4298,246,4052,1698,1083,1271,2332
"n2070003","2070003",882,552,330,12,63,258,311,670,448,222,7,37,171,207
"n292073","292073",2388,314,2074,19,116,1943,2032,1772,268,1504,17,63,1417,1468
"n670007","670007",3350,2484,866,13,519,234,746,2487,1922,565,9,341,134,472
"n1131737","1131737",5893,3653,2240,1256,397,503,881,4838,3165,1673,945,304,353,643
"n1133090","1133090",1985,1110,875,158,403,297,697,1937,1092,845,150,385,293,675
"n1290401","1290401",813,569,244,20,105,110,207,635,468,167,12,75,68,139
"n2010560","2010560",2632,80,2552,9,56,2504,2540,1939,64,1875,5,29,1848,1870
"n2890013","2890013",1056,891,165,5,47,96,141,926,794,132,5,43,70,111
"n3810332","3810332",3223,2508,715,44,36,532,562,2267,1807,460,36,15,321,335
"n4394203","4394203",6753,1619,5134,212,2485,2415,4805,4600,1364,3236,159,1555,1477,2989
"n4392355","4392355",2721,1433,1288,120,555,574,1111,1932,1095,837,88,345,368,706
"n4690022","4690022",2037,1650,387,9,38,289,319,1635,1357,278,5,23,202,225
"n2010020","2010020",4190,1577,2613,510,1265,784,2013,3801,1490,2311,459,1132,688,1786
"n2010682","2010682",4876,2743,2133,82,306,1634,1917,3788,2254,1534,69,200,1149,1345
"n2011014","2011014",0,0,0,0,0,0,0,0,0,0,0,0,0,0
"n2090134","2090134",4289,769,3520,44,127,3332,3430,2975,647,2328,23,79,2201,2269
"n2150221","2150221",3139,136,3003,35,23,2947,2958,2240,118,2122,26,13,2084,2088
"n2250021","2250021",465,334,131,2,76,40,115,370,274,96,1,63,23,86
"n293192","293192",0,0,0,0,0,0,0,0,0,0,0,0,0,0
"n410028","410028",477,406,71,8,9,40,49,368,319,49,7,2,26,28
"n410105","410105",145,67,78,9,21,35,55,120,53,67,8,20,26,45
"n610050","610050",2950,385,2565,32,33,2501,2517,2249,354,1895,19,16,1849,1857
"n1134055","1134055",6714,347,6367,192,1265,4905,6125,4915,311,4604,156,1000,3415,4396
"n1350102","1350102",7027,1079,5948,22,65,5793,5836,4759,842,3917,18,46,3787,3827
"n4770203","4770203",2336,1664,672,24,291,321,598,1935,1440,495,18,237,210,441
"n4890012","4890012",154,19,135,0,1,133,134,123,12,111,0,1,109,110
"n4910283","4910283",6654,3302,3352,402,626,2165,2735,4870,2620,2250,272,387,1446,1815
"n21301TC","21301TC",4132,3463,669,45,58,398,452,3414,2924,490,32,28,271,298
"n2150244","2150244",1724,95,1629,12,21,1600,1610,1244,72,1172,5,17,1152,1160
"n3630007","3630007",948,755,193,7,7,141,146,711,574,137,7,4,99,101
"n3630001","3630001",763,637,126,7,12,80,91,636,529,107,6,10,65,75
"n3810114","3810114",6336,3489,2847,247,419,2098,2453,4598,2784,1814,167,226,1300,1514
"n4391378","4391378",7391,1137,6254,300,2705,3271,5872,5235,985,4250,220,1897,2105,3964
"n1410064","1410064",5367,328,5039,50,205,4827,4962,4025,283,3742,44,130,3587,3682
"n1410070","1410070",4057,357,3700,32,54,3634,3666,3253,304,2949,28,37,2901,2924
"n2010914","2010914",276,51,225,2,63,154,216,247,50,197,2,60,128,188
"n2011157","2011157",0,0,0,0,0,0,0,0,0,0,0,0,0,0
"n3090060","3090060",4789,3516,1273,79,332,710,1020,3502,2674,828,49,210,460,660
"n2010561","2010561",5916,2506,3410,94,744,2531,3203,4523,2089,2434,62,532,1756,2259
"n4910254","4910254",6107,3648,2459,394,339,1602,1902,4656,2938,1718,276,210,1113,1306
"n4530216","4530216",5175,2273,2902,427,512,1929,2378,4363,2100,2263,351,411,1462,1839
"n3890010","3890010",2538,305,2233,46,50,2128,2166,1823,242,1581,34,35,1506,1536
"n294031","294031",3489,260,3229,33,198,3033,3192,2576,212,2364,21,128,2225,2343
"n2150099","2150099",10163,289,9874,13,38,9820,9828,7062,235,6827,8,22,6791,6799
"n5070002","5070002",2429,78,2351,10,37,2311,2335,1714,67,1647,9,19,1616,1632
"n970022","970022",2254,2055,199,16,18,61,79,1998,1847,151,14,11,42,53
"n3030110","3030110",4905,3856,1049,242,128,579,689,3655,2968,687,176,71,352,419
"n294223","294223",63,37,26,4,11,20,26,42,32,10,0,5,7,10
"n1574106","1574106",11189,1086,10103,2859,4212,3153,7195,8055,887,7168,2177,2813,2230,4951
"n850149","850149",6307,3743,2564,759,863,829,1640,4416,2730,1686,522,550,532,1065
"n1670146","1670146",4589,2387,2202,95,595,1463,2014,3555,1989,1566,62,392,1042,1422
"n850046","850046",6783,1849,4934,360,712,3780,4448,5242,1664,3578,318,519,2660,3159
"n1572028","1572028",2927,1300,1627,240,946,418,1325,2437,1177,1260,172,742,304,1030
"n1133607","1133607",5049,363,4686,103,4071,555,4569,3876,304,3572,68,3150,355,3479
"n3090082","3090082",3793,2983,810,56,86,558,631,2975,2433,542,36,56,349,401
"n1134056","1134056",7864,390,7474,75,2230,5220,7366,5640,338,5302,56,1755,3502,5214
"n1430030","1430030",856,722,134,6,9,63,71,667,589,78,2,8,32,39
"n294094","294094",2754,1140,1614,73,226,1294,1476,2227,1035,1192,62,157,931,1066
"n2150228","2150228",3642,55,3587,4,28,3566,3568,2619,30,2589,2,17,2572,2574
"n4910393","4910393",3086,2909,177,24,18,79,96,3074,2904,170,20,15,76,90
"n850212","850212",9623,2320,7303,6132,643,355,988,5841,1538,4303,3622,403,207,603
"n293196","293196",18,7,11,1,1,8,8,15,7,8,0,1,7,7
"n2010498","2010498",3476,807,2669,166,1071,1423,2460,2631,721,1910,144,753,984,1726
"n1150003","1150003",2522,1215,1307,21,98,1197,1267,1852,1001,851,19,48,777,818
"n90004","90004",911,691,220,1,3,204,206,681,524,157,1,2,142,144
"n4850405","4850405",7791,4118,3673,174,751,2484,3148,5947,3411,2536,129,516,1650,2122
"n3750425","3750425",5564,813,4751,560,1421,2780,4137,3569,672,2897,350,789,1728,2498
"n1134012","1134012",127,53,74,11,9,53,62,98,46,52,4,9,38,47
"n1572033","1572033",1470,310,1160,80,746,354,1076,1154,285,869,66,561,247,799
"n293153","293153",1993,940,1053,104,195,755,931,1642,829,813,86,152,563,706
"n4810302","4810302",3883,1695,2188,29,299,1857,2109,2779,1399,1380,27,174,1163,1324
"n2010329","2010329",4550,411,4139,340,757,3102,3777,3295,370,2925,276,513,2165,2628
"n293112","293112",2868,825,2043,135,352,1585,1866,2306,747,1559,109,221,1231,1418
"n850152","850152",995,103,892,21,19,852,866,740,87,653,21,10,623,629
"n1133803","1133803",6685,264,6421,72,5224,1135,6289,4769,239,4530,50,3714,741,4420
"n2150185","2150185",7,4,3,1,0,2,2,5,3,2,1,0,1,1
"n4090108","4090108",7124,3018,4106,173,223,3517,3694,5094,2395,2699,117,134,2288,2397
"n1630001","1630001",2055,292,1763,9,14,1726,1734,1504,247,1257,7,14,1226,1234
"n910202A","910202A",3570,1719,1851,106,339,1354,1672,2533,1317,1216,79,228,853,1070
"n2150059","2150059",5076,102,4974,7,20,4936,4945,3504,54,3450,4,17,3421,3429
"n1573022","1573022",4785,2040,2745,983,557,1177,1706,3785,1749,2036,765,416,811,1211
"n294117","294117",700,339,361,19,34,312,331,554,287,267,8,29,225,241
"n2130003","2130003",3688,912,2776,32,1101,1620,2697,2735,805,1930,29,829,1038,1863
"n397002C","397002C",2008,1555,453,101,78,200,269,1567,1265,302,61,44,126,169
"n2010455","2010455",2829,42,2787,10,1747,1068,2767,2186,40,2146,6,1436,719,2130
"n4910426","4910426",1414,964,450,44,64,280,327,1090,774,316,29,49,192,236
"n2150142","2150142",5833,116,5717,21,24,5651,5661,3791,80,3711,15,22,3656,3666
"n850195","850195",1235,880,355,51,40,231,253,910,703,207,31,22,128,141
"n4394129","4394129",1468,1263,205,36,29,114,138,1077,941,136,22,14,76,88
"n2870303","2870303",332,286,46,3,28,19,39,274,241,33,1,21,11,28
"n4410407","4410407",2299,1554,745,106,191,394,561,1680,1228,452,76,102,222,317
"n2010412","2010412",884,59,825,16,397,433,810,688,58,630,9,339,297,621
"n1710009","1710009",202,169,33,1,2,25,26,171,147,24,1,1,18,19
"n1670215","1670215",5851,2451,3400,119,1079,2104,3125,4865,2224,2641,79,820,1632,2423
"n50009","50009",373,261,112,11,69,34,101,297,231,66,8,42,17,58
"n2010686","2010686",1069,173,896,331,159,420,562,698,119,579,165,123,299,410
"n3810415","3810415",6420,3802,2618,253,394,1837,2201,4566,2841,1725,171,229,1193,1414
"n1134505","1134505",3782,992,2790,92,636,2031,2628,2836,878,1958,70,442,1402,1822
"n850169","850169",5933,2535,3398,1821,818,681,1471,3950,1822,2128,1149,510,408,908
"n3030140","3030140",3740,2527,1213,172,130,854,976,2715,1937,778,119,75,529,604
"n4270001","4270001",3465,94,3371,5,7,3351,3354,2408,74,2334,1,5,2326,2328
"n49904-4","49904-4",1204,980,224,17,43,106,148,919,767,152,16,20,68,87
"n3090080A","3090080A",3233,2756,477,26,71,275,340,2446,2114,332,13,53,180,231
"n2010581","2010581",1399,22,1377,6,905,479,1369,1045,19,1026,4,749,279,1020
"n4394400","4394400",873,376,497,8,25,453,473,671,333,338,4,16,306,319
"n294200","294200",5204,565,4639,145,341,4214,4475,3586,451,3135,100,215,2836,3022
"n2010518","2010518",7077,2513,4564,1275,1328,1894,3165,5683,2185,3498,1030,1021,1370,2350
"n1211002","1211002",340,274,66,0,9,46,55,256,211,45,0,5,33,38
"n390004","390004",5765,3299,2466,61,1028,1290,2286,4703,2718,1985,37,892,976,1855
"n323002A","323002A",1340,27,1313,3,0,1304,1304,996,26,970,3,0,964,964
"n1134623","1134623",5978,1171,4807,246,348,4159,4466,4340,1029,3311,195,234,2823,3033
"n350001","350001",886,724,162,4,9,131,135,693,601,92,3,0,73,73
"n294137","294137",199,144,55,5,4,40,43,158,116,42,5,3,28,30
"n11340A3","11340A3",0,0,0,0,0,0,0,0,0,0,0,0,0,0
"n4394204","4394204",7905,4037,3868,302,834,2476,3251,5993,3310,2683,227,556,1674,2202
"n3090038","3090038",1477,530,947,12,298,636,904,1056,415,641,11,204,407,605
"n4230014","4230014",3189,1383,1806,47,580,1133,1695,2275,1075,1200,37,429,689,1113
"n4394689","4394689",328,103,225,5,5,216,220,247,96,151,5,5,142,146
"n4910488","4910488",4772,2578,2194,742,395,1034,1387,3340,1872,1468,500,264,673,915
"n4910341","4910341",4096,2530,1566,68,320,1105,1372,3106,2085,1021,51,174,717,866
"n294074","294074",4059,1164,2895,40,88,2743,2789,3024,966,2058,29,49,1939,1975
"n411002B","411002B",690,346,344,19,5,314,319,513,295,218,14,1,197,198
"n4010319","4010319",406,239,167,0,147,14,160,340,190,150,0,139,6,145
"n4393511","4393511",5496,2192,3304,717,1475,1047,2443,4425,1958,2467,570,1065,770,1781
"n3030030","3030030",4249,1919,2330,118,431,1717,2114,3232,1616,1616,99,269,1161,1425
"n2150248","2150248",164,0,164,0,4,164,164,111,0,111,0,2,111,111
"n4910198","4910198",170,13,157,138,6,7,10,100,9,91,85,3,1,4
"n4394016","4394016",2016,1468,548,44,186,296,467,1731,1319,412,25,128,228,351
"n1134033","1134033",7021,2761,4260,235,2633,1401,3968,6896,2740,4156,225,2574,1366,3876
"n2230012","2230012",360,319,41,3,3,29,32,280,256,24,0,2,21,23
"n2010286","2010286",6922,202,6720,72,2698,4002,6629,5264,167,5097,58,2184,2892,5028
"n950203","950203",136,120,16,2,1,10,10,115,101,14,2,1,8,8
"n2150016","2150016",3111,72,3039,8,25,3023,3031,2165,56,2109,6,15,2101,2106
"n3390066","3390066",7260,4424,2836,147,243,2240,2466,5282,3507,1775,102,158,1354,1507
"n1870113","1870113",2018,1089,929,23,32,800,829,1566,930,636,11,16,556,571
"n2010832","2010832",1560,102,1458,38,220,1210,1413,1062,98,964,30,175,764,926
"n1131411","1131411",7379,1156,6223,126,1939,4147,6025,5014,976,4038,98,1319,2589,3882
"n2450001","2450001",3444,256,3188,11,1973,1208,3160,2393,233,2160,9,1404,743,2136
"n1214209","1214209",4403,2631,1772,251,237,1124,1333,3281,2099,1182,171,118,755,866
"n1870230","1870230",67,48,19,2,1,15,15,51,40,11,1,0,10,10
"n270405","270405",10012,2097,7915,618,4743,2651,6983,6851,1629,5222,433,3010,1722,4534
"n410029","410029",985,651,334,13,187,104,287,847,577,270,9,155,77,228
"n2310103","2310103",1005,809,196,10,18,118,136,818,671,147,6,13,85,98
"n4391297","4391297",5407,197,5210,38,3741,1448,5134,3835,183,3652,31,2716,892,3591
"n1250005","1250005",256,188,68,5,11,58,61,206,156,50,4,7,43,46
"n1830001","1830001",3194,1833,1361,36,702,546,1230,2529,1554,975,26,545,334,868
"n2010875","2010875",7185,1939,5246,1269,1648,2337,3883,4983,1471,3512,896,1059,1511,2527
"n2350200","2350200",378,299,79,4,11,65,74,310,244,66,4,8,55,62
"n4391149","4391149",7717,1054,6663,143,3012,3528,6455,5340,881,4459,80,2220,2142,4320
"n270110","270110",10130,5038,5092,558,1885,2478,4157,8155,4193,3962,451,1410,1921,3211
"n410072","410072",50,35,15,1,5,10,14,36,29,7,1,2,5,6
"n1131164","1131164",3112,2340,772,156,146,342,482,2631,2022,609,120,123,265,384
"n4530213","4530213",3924,2787,1137,303,138,623,742,3557,2523,1034,280,114,560,660
"n2270013","2270013",5481,825,4656,56,461,4131,4510,5133,751,4382,46,383,3944,4251
"n4290004","4290004",2207,1642,565,10,38,450,484,1746,1356,390,6,25,299,322
"n1213125","1213125",728,291,437,282,56,74,130,549,224,325,210,45,57,102
"n212010","212010",1340,790,550,47,181,304,479,1130,696,434,34,144,240,379
"n390021","390021",8092,1581,6511,383,2880,3283,6045,5460,1195,4265,268,1889,2068,3912
"n3370002","3370002",3203,2655,548,16,34,363,391,2585,2175,410,13,15,268,279
"n1790006","1790006",4282,2939,1343,34,83,1088,1158,3146,2349,797,22,38,616,649
"n2010746","2010746",1781,735,1046,224,237,545,769,1462,649,813,185,182,406,581
"n1131097","1131097",6647,469,6178,36,1065,5099,6120,4677,424,4253,27,832,3393,4210
"n291034","291034",7595,2458,5137,501,1285,3404,4527,4875,1716,3159,291,780,2027,2751
"n1131741","1131741",8464,1923,6541,2052,2065,2343,4343,6285,1653,4632,1572,1437,1542,2953
"n4530336","4530336",4688,2518,2170,252,224,1637,1799,3699,2123,1576,194,150,1158,1280
"n2010661","2010661",6251,2268,3983,817,1219,1931,3099,4907,1933,2974,679,857,1402,2234
"n4530102","4530102",3485,2004,1481,245,495,689,1152,3048,1792,1256,217,417,578,972
"n2170003","2170003",3514,818,2696,23,725,1941,2648,2452,693,1759,19,500,1221,1721
"n3030104","3030104",1619,1109,510,125,66,306,360,1165,814,351,80,53,208,255
"n1212082","1212082",2288,1127,1161,769,142,195,334,1481,782,699,454,88,115,201
"n3290307","3290307",2096,913,1183,29,105,1005,1098,1579,750,829,15,78,696,768
"n2010495","2010495",3870,1717,2153,771,465,830,1280,3104,1466,1638,591,360,610,963
"n2150096","2150096",4887,821,4066,160,74,3802,3860,3753,687,3066,132,55,2854,2898
"n4530268","4530268",3297,1535,1762,1460,48,210,252,2398,1197,1201,997,39,128,163
"n4230051","4230051",5784,3369,2415,499,1177,615,1763,4240,2649,1591,343,767,386,1145
"n130019","130019",692,311,381,3,9,344,352,517,238,279,2,9,246,254
"n390064","390064",117,30,87,9,25,54,75,69,25,44,3,3,34,37
"n1710003","1710003",2120,1394,726,37,30,632,653,1674,1209,465,30,13,395,406
"n2010789","2010789",5405,2017,3388,465,1384,1577,2844,4294,1730,2564,381,1027,1159,2115
"n294071","294071",1897,1326,571,16,65,464,527,1552,1153,399,13,42,315,357
"n1132037","1132037",2252,1839,413,121,76,166,242,2168,1778,390,117,70,157,227
"n910109","910109",2107,1618,489,28,51,346,388,1604,1285,319,19,29,218,244
"n370017","370017",2419,2077,342,17,188,78,262,1841,1582,259,8,146,52,196
"n1574099","1574099",6430,735,5695,2036,1702,2029,3651,4994,661,4333,1658,1243,1459,2655
"n1211022","1211022",6277,3318,2959,1565,695,604,1263,4478,2530,1948,983,492,402,875
"n294220","294220",10,0,10,0,5,7,10,7,0,7,0,3,4,7
"n2011021","2011021",2204,484,1720,108,780,810,1564,1692,445,1247,93,553,580,1111
"n1110001","1110001",767,472,295,3,6,269,274,533,352,181,1,3,169,171
"n110404","110404",41,39,2,2,0,1,1,30,30,0,0,0,0,0
"n1134600","1134600",4442,1063,3379,1113,453,1754,2177,3318,902,2416,811,316,1235,1534
"n3090057","3090057",2806,1231,1575,89,391,1056,1422,2238,1104,1134,80,299,698,994
"n325002C","325002C",6635,3055,3580,86,115,3281,3366,5022,2452,2570,58,69,2353,2406
"n2150202","2150202",1831,669,1162,7,11,1133,1138,1406,657,749,4,6,728,730
"n4230008","4230008",2158,1587,571,12,267,252,511,1692,1284,408,7,213,157,366
"n4394276","4394276",4066,2175,1891,205,466,1148,1584,2908,1673,1235,142,300,733,1013
"n2010703","2010703",3554,2827,727,154,134,352,471,2798,2274,524,116,96,255,339
"n1670340","1670340",1520,107,1413,14,673,728,1389,1010,86,924,9,465,446,906
"n291077","291077",2745,114,2631,7,27,2600,2616,2114,93,2021,4,12,2001,2012
"n4392161","4392161",4733,1739,2994,1016,1072,863,1904,4367,1634,2733,946,992,743,1716
"n3130101","3130101",5002,1904,3098,36,1285,1768,3026,4345,1649,2696,31,1194,1459,2634
"n397001E","397001E",2798,2159,639,126,173,283,442,2061,1646,415,94,117,164,267
"n4391025","4391025",4186,780,3406,51,1003,2359,3325,2975,699,2276,39,731,1494,2205
"n2010601","2010601",5547,3514,2033,465,571,889,1434,4158,2750,1408,346,392,585,973
"n3390028B","3390028B",110,34,76,1,0,68,68,77,31,46,0,0,39,39
"n2230002","2230002",3380,2295,1085,46,296,635,922,2564,1806,758,26,212,422,633
"n4570001","4570001",539,444,95,2,44,35,77,420,361,59,1,26,17,43
"n2010683","2010683",955,70,885,4,30,853,878,674,59,615,2,18,594,609
"n1211062","1211062",3761,2334,1427,166,407,737,1120,3024,2023,1001,117,270,508,767
"n110303","110303",63,57,6,2,2,6,6,53,47,6,2,2,6,6
"n490214","490214",1112,979,133,4,14,77,88,949,849,100,4,9,53,59
"n4510306","4510306",3747,1772,1975,145,245,1544,1742,2538,1284,1254,93,150,943,1075
"n2450064","2450064",1085,230,855,23,584,253,824,854,207,647,19,460,160,617
"n1212105","1212105",3180,1868,1312,346,209,700,893,2582,1601,981,270,174,497,657
"n390001","390001",8300,3425,4875,115,797,3879,4576,6115,2767,3348,87,506,2636,3112
"n4250002","4250002",2267,1894,373,15,42,255,287,1775,1533,242,9,19,157,173
"n1090004","1090004",547,111,436,13,20,402,416,405,91,314,11,18,285,297
"n1930005","1930005",150,134,16,4,1,7,8,128,116,12,4,1,3,4
"n390044","390044",6973,2418,4555,1823,1691,1014,2642,4881,1744,3137,1224,1219,663,1850
"n2270209","2270209",0,0,0,0,0,0,0,0,0,0,0,0,0,0
"n1670277","1670277",3790,2971,819,25,46,616,655,2961,2390,571,15,26,421,445
"n2010852","2010852",3614,2526,1088,182,250,572,801,2585,1892,693,121,166,347,507
"n410049","410049",858,520,338,70,95,175,264,780,476,304,68,80,156,233
"n4370006","4370006",568,223,345,7,26,309,325,412,173,239,2,17,212,225
"n1219201","1219201",0,0,0,0,0,0,0,0,0,0,0,0,0,0
"n2010726","2010726",2644,1929,715,42,65,559,620,1996,1538,458,22,38,365,403
"n323001B","323001B",2502,137,2365,38,16,2312,2322,1814,104,1710,30,10,1668,1674
"n4910485","4910485",3411,1627,1784,251,376,1094,1447,2362,1208,1154,162,231,700,926
"n2010641","2010641",6651,1998,4653,810,1448,2362,3748,5078,1747,3331,647,982,1656,2601
"n4530305","4530305",2948,1932,1016,394,96,455,531,2679,1827,852,309,78,394,459
"n4090125","4090125",84,37,47,1,3,42,42,61,29,32,1,0,30,30
"n2010558","2010558",2909,567,2342,406,994,950,1905,2272,504,1768,342,726,704,1401
"n2410006","2410006",1954,957,997,11,590,366,954,1516,815,701,8,433,235,666
"n1131721","1131721",3184,1318,1866,134,450,1236,1668,2550,1203,1347,95,331,870,1193
"n3390006","3390006",6212,3797,2415,831,297,1217,1491,4292,2681,1611,557,209,799,993
"n294134","294134",19,7,12,0,2,9,10,16,6,10,0,2,7,8
"n291011","291011",2169,112,2057,10,16,2039,2045,1698,95,1603,8,11,1590,1594
"n4394592","4394592",0,0,0,0,0,0,0,0,0,0,0,0,0,0
"n2010515","2010515",3949,2793,1156,404,213,473,677,3106,2272,834,303,148,321,463
"n2150245","2150245",1454,19,1435,2,8,1426,1426,932,5,927,2,5,922,922
"n2010809","2010809",391,60,331,26,23,279,299,275,51,224,22,19,179,196
"n4450401","4450401",2428,810,1618,7,90,1522,1586,1746,652,1094,7,64,1022,1075
"n4391394","4391394",0,0,0,0,0,0,0,0,0,0,0,0,0,0
"n1134678","1134678",371,82,289,230,30,37,60,271,70,201,170,12,19,30
"n3530005","3530005",145,135,10,0,1,5,6,124,119,5,0,0,2,2
"n4391094","4391094",3103,1266,1837,121,495,1185,1663,2595,1172,1423,108,379,888,1257
"n1310007","1310007",239,49,190,1,6,174,179,200,42,158,0,2,145,147
"n1850003","1850003",4557,908,3649,18,1460,2162,3580,3252,703,2549,16,1062,1446,2491
"n190203","190203",3077,2304,773,52,50,571,613,2469,1911,558,40,29,407,432
"n3290108A","3290108A",1713,772,941,36,80,793,868,1252,590,662,23,54,551,605
"n1131311","1131311",4243,1344,2899,118,619,2160,2707,3117,1152,1965,85,423,1421,1810
"n1670492","1670492",2455,1823,632,107,78,387,457,1932,1495,437,63,65,266,325
"n294114","294114",226,28,198,17,55,137,177,153,24,129,8,34,89,119
"n1810210","1810210",3196,2617,579,34,66,250,313,2351,1994,357,21,41,136,177
"n4530333","4530333",3364,1830,1534,283,206,990,1164,2875,1599,1276,254,176,792,947
"n1134620","1134620",5002,932,4070,152,288,3594,3856,3645,824,2821,132,230,2424,2641
"n2270024","2270024",557,434,123,32,7,73,79,436,352,84,30,5,42,46
"n510308","510308",567,439,128,1,79,46,124,454,357,97,0,64,33,97
"n4530240","4530240",10070,2187,7883,463,875,6497,7262,7473,1937,5536,339,627,4494,5069
"n1870210","1870210",1329,569,760,21,39,690,725,1025,480,545,17,27,492,518
"n33002B","33002B",66,60,6,4,1,4,5,54,50,4,3,1,3,4
"n3090015","3090015",398,257,141,2,13,122,132,296,192,104,2,12,87,97
"n2010915","2010915",4851,2686,2165,342,554,1195,1718,3388,1971,1417,240,342,777,1106
"n1131169","1131169",3940,3179,761,172,112,394,493,2864,2332,532,117,86,258,333
"n3390044","3390044",5774,2638,3136,118,918,2033,2892,4138,2134,2004,93,553,1307,1829
"n4530153","4530153",5714,3087,2627,563,705,1297,1964,3973,2281,1692,344,471,804,1257
"n3390105","3390105",5023,4137,886,100,170,437,599,3927,3323,604,78,119,291,407
"n270409","270409",3505,1178,2327,278,1209,861,1938,2492,923,1569,177,807,542,1284
"n3090077","3090077",2806,1983,823,23,157,565,707,2103,1564,539,11,97,367,461
"n294177","294177",54,0,54,0,0,54,54,37,0,37,0,0,37,37
"n1131045","1131045",7585,993,6592,162,2709,3704,6350,5746,901,4845,137,2094,2581,4641
"n4230054","4230054",4876,3412,1464,243,624,487,1089,4159,3040,1119,174,470,365,827
"n4970019","4970019",707,584,123,3,8,88,94,612,520,92,0,5,65,69
"n1214167","1214167",8868,3341,5527,362,1273,3755,4985,7373,3040,4333,344,1048,2823,3847
"n1134502","1134502",5973,1267,4706,859,1983,1889,3806,4441,1062,3379,630,1432,1284,2692
"n2310428","2310428",3896,2236,1660,92,924,472,1382,3298,1885,1413,85,844,336,1171
"n410091B","410091B",16,13,3,0,1,3,3,11,10,1,0,1,1,1
"n4394685","4394685",18,1,17,1,5,13,17,8,1,7,0,2,5,7
"n49904-1","49904-1",1185,1007,178,11,25,100,125,907,780,127,9,14,72,86
"n4950101","4950101",1927,739,1188,23,58,1097,1132,1355,588,767,11,24,718,738
"n2150179","2150179",1424,22,1402,1,1,1400,1400,886,13,873,1,1,873,873
"n4090102","4090102",3656,938,2718,18,45,2628,2658,2766,795,1971,11,29,1900,1927
"n4490018","4490018",487,190,297,14,18,255,271,319,146,173,6,11,145,156
"n3190405","3190405",965,763,202,6,11,168,175,792,645,147,5,10,118,124
"n1190010","1190010",534,463,71,7,22,27,45,438,390,48,3,16,18,32
"n2010621","2010621",3002,779,2223,330,483,1409,1860,2421,680,1741,283,364,1088,1435
"n294197","294197",57,15,42,0,14,30,39,29,7,22,0,7,17,22
"n4230011","4230011",4601,366,4235,30,1798,2400,4167,3246,304,2942,25,1400,1506,2893
"n2170006","2170006",2796,1439,1357,23,215,1033,1238,2097,1200,897,8,134,687,817
"n1670401","1670401",2317,1318,999,333,210,428,628,1527,903,624,221,125,247,368
"n70004","70004",4876,3710,1166,233,55,709,754,4188,3307,881,185,24,514,536
"n990415","990415",299,253,46,4,2,24,26,237,205,32,2,2,15,17
"n4530155","4530155",5415,2414,3001,432,900,1587,2438,3801,1792,2009,297,600,1025,1613
"n4391611","4391611",36,9,27,0,0,27,27,26,4,22,0,0,22,22
"n1132097","1132097",0,0,0,0,0,0,0,0,0,0,0,0,0,0
"n2010706","2010706",6392,1605,4787,1538,2156,1046,3154,5156,1426,3730,1268,1612,810,2388
"n37004A","37004A",2075,672,1403,47,1153,160,1303,1511,599,912,36,730,102,829
"n3470044","3470044",2851,2144,707,20,138,485,616,2152,1695,457,12,89,304,388
"n4310001B","4310001B",65,43,22,1,0,22,22,50,38,12,0,0,12,12
"n1391007","1391007",2857,1884,973,37,220,637,843,2136,1483,653,26,156,406,556
"n1810102","1810102",4663,1553,3110,169,806,2021,2794,3455,1307,2148,160,595,1290,1877
"n1131048","1131048",3342,2354,988,114,130,670,784,2741,2044,697,82,90,453,539
"n4391441","4391441",2078,332,1746,105,1222,396,1595,1603,296,1307,89,897,300,1183
"n325003C","325003C",3655,1650,2005,28,60,1853,1896,2801,1358,1443,22,35,1326,1356
"n1211042","1211042",4387,2191,2196,299,893,936,1792,3000,1582,1418,208,575,574,1133
"n1132141","1132141",2273,540,1733,90,638,1001,1625,1840,483,1357,85,536,727,1260
"n3510008C","3510008C",4,4,0,0,0,0,0,4,4,0,0,0,0,0
"n1350201","1350201",5585,2855,2730,396,280,1954,2222,3935,2132,1803,295,178,1246,1419
"n1830004","1830004",4349,3393,956,93,507,283,779,3538,2812,726,74,415,174,585
"n212013","212013",4477,2900,1577,57,133,1228,1340,3571,2500,1071,34,89,814,890
"n1214170","1214170",7672,3258,4414,989,1437,1911,3260,7218,3144,4074,919,1368,1699,2986
"n4150013","4150013",663,429,234,3,5,211,213,491,339,152,3,3,138,140
"n1131701","1131701",4648,1185,3463,338,309,2755,3046,3443,989,2454,284,229,1875,2095
"n1670202","1670202",2416,1503,913,112,323,435,726,2060,1370,690,100,201,327,517
"n2010872","2010872",2986,610,2376,26,45,2277,2312,1957,464,1493,16,33,1421,1449
"n4410401","4410401",4095,2833,1262,238,316,620,921,2759,1959,800,167,191,376,559
"n1890215","1890215",723,247,476,9,34,430,460,530,183,347,6,17,322,339
"n2010578","2010578",2579,1826,753,142,87,438,514,1949,1410,539,84,65,314,377
"n4530381A","4530381A",4628,2241,2387,466,676,1233,1831,3757,1945,1812,356,488,921,1372
"n2230005","2230005",986,698,288,30,22,200,221,710,541,169,26,11,106,117
"n50003","50003",3546,2350,1196,13,198,896,1093,2723,1916,807,13,160,572,731
"n550400","550400",1745,476,1269,15,74,1159,1230,1239,414,825,11,61,734,793
"n2430003","2430003",490,290,200,10,8,181,185,403,261,142,4,1,130,131
"n4230082","4230082",127,42,85,0,13,68,81,71,30,41,0,5,32,37
"n270114","270114",5551,2831,2720,236,1005,1416,2281,3987,2202,1785,168,669,855,1461
"n3370005","3370005",1746,1372,374,23,24,257,279,1306,1070,236,17,8,152,160
"n390024","390024",2271,1207,1064,28,88,923,999,1740,976,764,21,57,658,711
"n329309A","329309A",150,75,75,4,17,45,60,136,71,65,2,17,37,52
"n4530180","4530180",5960,1526,4434,661,842,2928,3677,4339,1273,3066,502,589,1935,2471
"n2450084","2450084",1321,53,1268,8,935,330,1256,1001,45,956,7,729,222,945
"n1212085","1212085",5300,3236,2064,332,521,1052,1549,4175,2700,1475,253,354,733,1076
"n291117","291117",638,43,595,9,23,555,577,497,35,462,9,18,430,448
"n1830021","1830021",9720,2787,6933,101,3142,3607,6676,7141,2421,4720,63,2239,2335,4540
"n291014","291014",2642,82,2560,21,55,2504,2530,1948,67,1881,15,30,1836,1856
"n4530430","4530430",3957,2274,1683,103,226,1262,1471,3402,2035,1367,81,204,986,1180
"n1710006","1710006",831,600,231,1,12,204,216,698,528,170,1,4,153,157
"n2010766","2010766",1243,54,1189,3,51,1138,1183,930,54,876,1,38,837,873
"n410009","410009",3130,1824,1306,495,247,535,759,2730,1641,1089,453,185,422,592
"n2010664","2010664",8437,375,8062,92,660,7348,7948,5810,322,5488,78,473,4933,5390
"n2270205","2270205",1870,1449,421,19,51,314,353,1384,1118,266,15,23,191,206
"n3390085","3390085",6642,3959,2683,56,234,2219,2432,4929,3205,1724,29,136,1410,1534
"n2310106","2310106",4295,2267,2028,76,962,920,1844,3363,1941,1422,54,664,636,1280
"n2010958","2010958",5105,211,4894,469,1373,3050,4399,3490,147,3343,340,972,2043,2994
"n1131100","1131100",7143,163,6980,44,2531,4462,6925,4857,127,4730,35,1718,3008,4697
"n1214187","1214187",4490,1812,2678,330,671,1602,2212,3831,1671,2160,302,560,1225,1731
"n4530310","4530310",4268,2081,2187,1159,207,779,976,3987,1937,2050,1094,184,730,908
"n1213148","1213148",4150,2688,1462,351,281,711,971,3072,2109,963,226,204,440,639
"n2010792","2010792",3947,194,3753,44,565,3165,3696,2881,162,2719,37,455,2229,2669
"n2010895","2010895",1136,847,289,96,34,140,172,894,705,189,63,22,89,110
"n930013","930013",330,280,50,1,1,40,40,276,242,34,1,0,27,27
"n2450021","2450021",6021,2257,3764,21,2313,1453,3740,5944,2229,3715,18,2275,1444,3695
"n2010024","2010024",1620,317,1303,129,859,306,1156,1334,291,1043,117,698,228,921
"n1134646","1134646",1615,357,1258,32,85,1136,1216,1230,334,896,30,64,799,859
"n1131314","1131314",5671,942,4729,80,1049,3574,4594,3935,826,3109,61,708,2317,3011
"n4530131","4530131",8935,1357,7578,357,1059,6225,7169,6355,1181,5174,246,812,4133,4877
"n291139","291139",3791,525,3266,158,430,2729,3091,2740,409,2331,117,307,1916,2195
"n370014","370014",1098,878,220,15,89,50,138,874,705,169,11,67,39,105
"n4230031","4230031",4998,3765,1233,44,217,842,1035,3988,3150,838,40,139,557,684
"n1750043","1750043",477,365,112,0,27,72,99,376,306,70,0,21,38,59
"n170004B","170004B",203,125,78,1,1,76,76,147,97,50,0,0,48,48
"n1131077","1131077",0,0,0,0,0,0,0,0,0,0,0,0,0,0
"n1132057","1132057",689,543,146,39,22,71,91,519,405,114,35,13,54,65
"n2250004","2250004",2938,1537,1401,50,695,637,1297,2275,1340,935,33,495,386,859
"n291097","291097",1488,76,1412,7,23,1398,1404,1137,59,1078,3,15,1072,1074
"n2190045","2190045",2697,1175,1522,10,97,1400,1470,2004,1004,1000,9,49,915,958
"n1670481","1670481",308,200,108,3,4,95,98,252,170,82,3,4,70,73
"n1810303","1810303",699,518,181,5,20,123,142,525,414,111,0,13,78,90
"n419001S","419001S",3118,1709,1409,70,502,804,1296,2296,1377,919,49,330,504,833
"n2150242","2150242",120,7,113,1,3,110,111,83,7,76,1,1,73,74
"n2410003","2410003",1388,1188,200,7,118,32,147,1136,981,155,7,88,19,107
"n3310203","3310203",575,433,142,3,28,91,116,469,372,97,0,16,62,76
"n1131718","1131718",3341,1120,2221,91,294,1811,2088,2493,981,1512,63,238,1176,1406
"n1211019","1211019",4613,2411,2202,1321,405,378,765,2900,1630,1270,762,239,217,451
"n5050003","5050003",3589,383,3206,10,4,3171,3175,2477,349,2128,8,3,2102,2105
"n4530183","4530183",2536,505,2031,477,476,1078,1529,1840,436,1404,374,315,705,1007
"n1350401","1350401",1854,572,1282,41,195,1033,1202,1406,473,933,29,147,736,871
"n1870207","1870207",2462,546,1916,18,247,1668,1875,1741,450,1291,11,159,1117,1265
"n870301","870301",562,299,263,8,57,206,252,411,240,171,6,36,128,161
"n4050004","4050004",659,338,321,7,233,83,312,496,301,195,4,150,43,190
"n1590301","1590301",1149,885,264,5,14,198,210,893,717,176,4,7,127,134
"n1131129","1131129",976,32,944,139,282,532,804,618,20,598,80,186,336,516
"n2150159","2150159",1518,32,1486,3,8,1468,1468,1085,24,1061,3,3,1048,1048
"n4391227","4391227",3169,611,2558,353,1622,608,2168,2263,497,1766,246,1120,412,1495
"n250003","250003",10625,2249,8376,84,2004,6299,8270,9616,2046,7570,76,1936,5551,7471
"n294217","294217",198,49,149,5,21,124,141,189,48,141,4,20,116,133
"n2310325","2310325",3563,2853,710,59,196,309,492,2887,2397,490,47,152,181,327
"n1219204","1219204",0,0,0,0,0,0,0,0,0,0,0,0,0,0
"n10009","10009",2131,1507,624,41,281,234,510,1612,1194,418,26,192,143,334
"n410006","410006",1446,1049,397,11,45,265,303,1120,859,261,9,30,161,188
"n3130404","3130404",2712,2143,569,40,101,356,455,2104,1707,397,24,60,255,314
"n1670142","1670142",8217,3083,5134,119,2232,2723,4887,6322,2593,3729,75,1629,1935,3542
"n3390047","3390047",4452,2113,2339,271,604,1332,1906,3146,1569,1577,186,411,877,1279
"n1214190","1214190",4709,3321,1388,91,205,931,1112,3296,2400,896,64,122,582,692
"n4370002","4370002",1569,703,866,6,96,757,834,1122,573,549,2,49,476,522
"n1213145","1213145",6073,4217,1856,750,222,730,943,4473,3254,1219,487,153,466,616
"n4530356","4530356",3644,2465,1179,313,105,633,726,2916,2045,871,230,78,457,531
"n4410106","4410106",4834,2671,2163,284,739,1086,1741,3202,1888,1314,175,456,606,1021
"n970018","970018",2369,2099,270,11,12,137,148,1749,1580,169,7,7,92,98
"n4530243","4530243",5159,2409,2750,422,406,1855,2212,4168,2150,2018,338,323,1299,1592
"n2510016","2510016",840,590,250,8,23,205,223,665,494,171,4,10,142,148
"n1870412","1870412",5004,1972,3032,287,1053,1728,2635,3420,1412,2008,190,742,1071,1738
"n2010769","2010769",232,14,218,0,187,33,218,213,14,199,0,173,28,199
"n291054","291054",4349,444,3905,35,59,3801,3838,3222,384,2838,26,31,2757,2784
"n4910390B","4910390B",0,0,0,0,0,0,0,0,0,0,0,0,0,0
"n4530126","4530126",6593,1312,5281,208,1534,3605,5038,4579,1076,3503,156,1062,2300,3320
"n3450002","3450002",100,81,19,0,0,15,15,84,71,13,0,0,9,9
"n270301","270301",6390,4574,1816,57,252,1319,1533,4626,3471,1155,40,130,829,948
"n4970016","4970016",3506,2844,662,30,40,451,482,2746,2278,468,24,26,295,318
"n4391294","4391294",4990,2755,2235,153,933,1077,1974,3701,2215,1486,106,614,691,1297
"n2010723","2010723",5702,380,5322,535,2283,2559,4759,4245,332,3913,453,1744,1732,3440
"n1213128","1213128",4367,1656,2711,678,958,1035,1940,3388,1430,1958,507,682,720,1375
"n2010749","2010749",1380,80,1300,59,495,805,1233,997,66,931,54,375,527,871
"n2010644","2010644",9199,3683,5516,2285,1015,2198,3114,6607,2729,3878,1605,677,1548,2173
"n3290310","3290310",1651,432,1219,33,177,1010,1161,1117,327,790,16,125,639,754
"n1970004","1970004",913,673,240,3,38,173,207,713,557,156,2,29,101,128
"n4391088","4391088",3747,264,3483,36,456,2973,3411,2595,225,2370,28,341,1974,2306
"n410052","410052",32,10,22,5,1,12,13,21,8,13,5,1,4,5
"n130022","130022",989,535,454,9,6,409,414,742,416,326,5,5,292,297
"n910307","910307",3019,1339,1680,37,94,1537,1602,2299,1119,1180,33,61,1071,1120
"n4530105","4530105",3572,1507,2065,189,852,1021,1834,3029,1354,1675,160,731,764,1476
"n291157","291157",5191,608,4583,206,743,3742,4355,3454,475,2979,135,478,2391,2811
"n4470002","4470002",356,299,57,2,6,44,47,288,245,43,0,1,34,35
"n2010413","2010413",5199,928,4271,109,1177,2994,4110,3878,817,3061,87,963,1996,2926
"n2010967","2010967",6432,281,6151,123,2017,4108,5984,4256,229,4027,100,1341,2627,3902
"n3550068","3550068",1921,207,1714,8,42,1665,1692,1436,191,1245,6,27,1202,1227
"n1550101","1550101",270,212,58,3,10,45,52,224,176,48,3,7,39,43
"n2970013","2970013",678,519,159,2,3,123,125,557,436,121,2,2,90,91
"n1410083","1410083",2580,57,2523,16,30,2484,2497,1967,52,1915,9,18,1892,1898
"n3550110","3550110",3241,1103,2138,61,100,1962,2032,2349,870,1479,54,56,1340,1386
"n4393579","4393579",1212,899,313,120,51,102,150,932,724,208,78,35,62,94
"n610029","610029",3179,843,2336,32,25,2272,2277,2453,775,1678,21,10,1635,1638
"n850107","850107",4496,2489,2007,1209,298,425,719,3545,2059,1486,914,208,303,508
"n2011136","2011136",7958,760,7198,588,3208,3488,6554,5317,582,4735,432,1991,2321,4250
"n650401","650401",990,829,161,5,8,90,94,761,642,119,3,4,65,67
"n293067","293067",1788,935,853,54,37,740,769,1453,800,653,44,32,557,585
"n4790310","4790310",648,13,635,3,5,630,634,488,12,476,2,4,472,476
"n1391059","1391059",1173,820,353,18,50,226,273,859,622,237,12,29,147,174
"n2830001","2830001",1392,301,1091,12,22,1053,1062,1037,261,776,10,11,745,751
"n2090122","2090122",2660,1086,1574,113,331,1129,1428,2375,995,1380,102,293,974,1245
"n293130","293130",2165,1393,772,136,36,582,609,1686,1120,566,98,29,428,452
"n2010198","2010198",931,62,869,34,668,173,831,719,49,670,30,516,130,640
"n1133063","1133063",7029,202,6827,49,5414,1444,6757,5020,178,4842,35,3942,901,4786
"n1573127B","1573127B",20,3,17,6,3,8,10,15,0,15,6,2,8,9
"n850190","850190",118,71,47,1,13,28,39,86,58,28,0,6,15,21
"n1571132","1571132",9553,3907,5646,3001,876,1674,2507,6584,2823,3761,1983,570,1137,1671
"n21303NW","21303NW",930,682,248,3,60,159,219,728,564,164,2,45,101,146
"n293024","293024",0,0,0,0,0,0,0,0,0,0,0,0,0,0
"n1133101","1133101",1093,194,899,35,646,209,847,809,175,634,26,468,131,595
"n2150054","2150054",3449,419,3030,160,79,2772,2842,2397,334,2063,113,50,1875,1921
"n3890007","3890007",2312,292,2020,30,44,1934,1971,1759,259,1500,25,35,1423,1455
"n4850201","4850201",7494,4459,3035,433,1293,1178,2399,6280,3809,2471,360,1065,953,1967
"n4790124","4790124",4009,54,3955,13,24,3934,3942,2852,46,2806,11,22,2787,2795
"n3730019","3730019",1628,1480,148,8,17,64,81,1551,1426,125,8,10,50,60
"n1450302","1450302",2075,1185,890,22,302,523,813,1607,950,657,19,213,375,586
"n4910139","4910139",6638,3038,3600,639,1006,1874,2779,5089,2533,2556,458,719,1283,1959
"n3810315","3810315",404,375,29,3,7,10,15,385,363,22,1,5,4,8
"n4790405","4790405",3733,40,3693,0,6,3679,3679,2578,22,2556,0,4,2551,2551
"n3610034","3610034",2528,2203,325,61,25,152,170,1920,1698,222,39,11,97,108
"n2011156","2011156",0,0,0,0,0,0,0,0,0,0,0,0,0,0
"n850233","850233",3084,1656,1428,261,544,563,1099,2184,1250,934,187,344,354,696
"n850127","850127",5535,3049,2486,892,674,852,1498,4261,2495,1766,648,455,594,1033
"n2090338","2090338",2831,2413,418,38,10,271,281,2322,2050,272,22,8,172,180
"n1572088","1572088",2467,225,2242,254,1107,881,1966,1864,194,1670,203,836,623,1441
"n4650033","4650033",2474,1086,1388,19,37,1312,1335,1917,926,991,12,22,937,951
"n1410189","1410189",388,24,364,12,12,336,346,270,15,255,6,3,242,245
"n293050","293050",1853,913,940,43,142,755,875,1502,803,699,32,106,550,650
"n4394017","4394017",9380,892,8488,247,1458,6769,8153,6273,682,5591,134,880,4537,5384
"n2011093","2011093",2512,1719,793,91,37,594,624,2069,1491,578,72,28,424,448
"n850064","850064",4518,2326,2192,1156,367,576,928,3403,1900,1503,792,258,390,641
"n850001","850001",4198,2471,1727,74,441,1132,1539,3270,2074,1196,59,291,776,1052
"n1410126","1410126",7538,560,6978,199,315,6528,6775,5634,451,5183,150,229,4826,5022
"n4710201B","4710201B",28,5,23,0,16,6,21,22,4,18,0,14,2,16
"n3550005","3550005",2211,1065,1146,29,62,1019,1061,1800,938,862,21,39,759,785
"n4394218","4394218",3322,913,2409,256,48,2085,2125,2424,806,1618,213,37,1349,1382
"n2010350","2010350",6895,2917,3978,1981,845,1152,1931,5995,2631,3364,1631,724,990,1666
"n292152","292152",1100,185,915,11,62,847,899,924,174,750,9,53,686,736
"n570005","570005",2728,1321,1407,243,47,1102,1142,2092,1088,1004,173,40,775,811
"n3670225","3670225",1806,1512,294,13,35,187,217,1458,1273,185,11,17,111,128
"n293174","293174",5994,3130,2864,552,283,1986,2223,4270,2393,1877,363,174,1301,1458
"n1133967","1133967",2189,1075,1114,128,352,612,940,1657,908,749,98,225,393,611
"n293133","293133",0,0,0,0,0,0,0,0,0,0,0,0,0,0
"n4850204","4850204",1002,826,176,27,16,99,113,809,677,132,15,3,78,81
"n2090440","2090440",775,526,249,20,14,184,197,549,396,153,9,12,110,121
"n850044","850044",3878,1346,2532,44,367,2053,2393,2882,1143,1739,33,267,1364,1618
"n2010307","2010307",5347,3413,1934,293,450,1107,1511,4360,2907,1453,230,330,812,1113
"n3730022","3730022",251,221,30,4,5,14,19,233,210,23,4,5,8,13
"n1133605","1133605",3787,370,3417,23,2692,723,3351,2929,347,2582,17,2085,470,2534
"n1490112","1490112",1816,1155,661,3,106,511,609,1419,983,436,1,68,333,399
"n293090","293090",4718,2178,2540,197,411,1893,2242,3814,1843,1971,166,304,1446,1713
"n2910001","2910001",1929,1529,400,10,78,239,311,1519,1244,275,5,60,149,207
"n4393516","4393516",2313,1822,491,128,83,219,290,1949,1582,367,89,64,157,213
"n4790237","4790237",570,32,538,1,9,533,536,416,28,388,1,3,383,386
"n2070002","2070002",1506,903,603,11,111,465,566,1253,748,505,7,91,393,479
"n730038","730038",1282,228,1054,6,260,769,1020,872,198,674,4,180,476,653
"n4393332","4393332",6240,2841,3399,730,865,1664,2472,4463,2235,2228,548,472,1080,1523
"n1133086","1133086",5604,4052,1552,433,304,730,1021,5458,3977,1481,416,282,694,968
"n277002F","277002F",314,247,67,3,7,40,47,243,201,42,3,3,24,27
"n690101","690101",1281,240,1041,2,8,1010,1018,958,189,769,2,7,750,757
"n1430024","1430024",2549,2018,531,57,76,351,411,2082,1716,366,48,49,221,260
"n3670420","3670420",2945,2476,469,50,67,299,357,2237,1936,301,37,35,186,218
"n1133043","1133043",3679,59,3620,15,1952,1666,3588,2569,44,2525,8,1530,974,2500
"n2670003","2670003",311,245,66,4,6,55,59,269,215,54,4,6,44,48
"n3570002","3570002",2489,904,1585,17,18,1517,1527,1707,705,1002,12,9,948,955
"n4392505","4392505",2552,1432,1120,107,278,687,944,1945,1201,744,74,176,441,610
"n2950106","2950106",770,300,470,5,9,440,448,565,251,314,4,7,295,301
"n3030108","3030108",2120,1013,1107,73,224,820,1013,1406,742,664,60,118,474,585
"n21304MS","21304MS",1562,989,573,10,427,85,511,1286,819,467,6,356,62,417
"n2010264","2010264",6879,1490,5389,280,209,4853,5033,5196,1329,3867,209,147,3454,3581
"n293047","293047",2257,1610,647,53,39,498,530,1648,1227,421,31,23,324,344
"n1410103","1410103",2844,520,2324,49,118,2206,2282,2269,473,1796,34,81,1699,1759
"n850087","850087",6533,543,5990,5631,178,143,315,3967,344,3623,3405,109,98,205
"n2010496","2010496",4960,500,4460,333,582,3528,4090,3591,451,3140,294,430,2411,2832
"n3070301","3070301",1628,1046,582,9,32,519,542,1231,835,396,7,16,350,364
"n2150097","2150097",5518,331,5187,31,38,5120,5137,3946,264,3682,17,20,3637,3648
"n467004C","467004C",2679,2202,477,28,60,311,370,2118,1761,357,22,50,218,268
"n397002A","397002A",4167,3240,927,143,201,452,645,3454,2789,665,105,144,310,450
"n1410146","1410146",2058,61,1997,15,46,1958,1976,1673,58,1615,12,31,1583,1596
"n1574100","1574100",4988,600,4388,478,1168,2815,3907,3800,525,3275,404,861,2061,2872
"n4770101","4770101",1721,903,818,14,568,196,762,1344,734,610,10,463,116,579
"n2011050","2011050",1634,17,1617,13,1245,368,1605,1307,16,1291,9,1070,214,1282
"n4393156","4393156",2187,1587,600,86,99,305,397,1734,1339,395,55,55,197,250
"n293004","293004",0,0,0,0,0,0,0,0,0,0,0,0,0,0
"n3650022","3650022",542,299,243,0,209,15,224,443,246,197,0,172,13,185
"n4690021","4690021",5849,3554,2295,214,214,1766,1952,4363,2803,1560,143,146,1178,1310
"n610069","610069",7092,215,6877,31,49,6821,6833,4965,157,4808,14,21,4774,4780
"n4394593","4394593",1769,394,1375,29,205,1130,1327,1244,336,908,22,154,723,870
"n1410043","1410043",2864,855,2009,219,384,1440,1772,2289,745,1544,180,287,1080,1341
"n2010178","2010178",2933,2003,930,356,222,342,553,2473,1723,750,266,183,278,457
"n2090227","2090227",5101,1618,3483,202,295,2971,3220,3665,1280,2385,144,183,2015,2185
"n3610014","3610014",2651,1742,909,31,500,289,786,2162,1498,664,24,391,179,568
"n2011113","2011113",6589,773,5816,1220,1186,3444,4568,4641,631,4010,910,817,2281,3065
"n2011010","2011010",2930,198,2732,231,1087,1455,2501,2019,160,1859,182,718,986,1678
"n4910252","4910252",6021,3423,2598,1193,300,1013,1259,4193,2536,1657,750,177,651,804
"n292132","292132",0,0,0,0,0,0,0,0,0,0,0,0,0,0
"n4393695","4393695",6326,3976,2350,784,471,958,1393,4189,2741,1448,494,286,556,836
"n2593010","2593010",3093,2049,1044,69,62,840,891,2291,1602,689,45,35,556,583
"n4050005","4050005",610,463,147,7,62,64,123,450,353,97,6,42,36,75
"n2010075","2010075",2831,1780,1051,225,104,695,783,2327,1504,823,166,90,540,619
"n4394284","4394284",398,307,91,4,20,51,69,299,243,56,4,13,29,40
"n2830004","2830004",113,54,59,1,0,54,54,87,45,42,1,0,38,38
"n4392600","4392600",0,0,0,0,0,0,0,0,0,0,0,0,0,0
"n1410211A","1410211A",820,239,581,5,154,421,575,820,239,581,5,154,421,575
"n2090132","2090132",1161,661,500,16,77,403,463,934,565,369,13,63,285,334
"n3670240","3670240",2426,1863,563,40,40,357,392,1880,1517,363,18,19,224,242
"n2450093","2450093",1890,216,1674,69,576,1024,1584,1439,202,1237,59,489,676,1162
"n4391633","4391633",75,31,44,0,0,41,41,66,28,38,0,0,38,38
"n4790129","4790129",4432,72,4360,4,19,4327,4336,3114,53,3061,3,11,3041,3044
"n850024","850024",4386,1542,2844,404,1704,727,2369,3626,1388,2238,334,1326,546,1830
"n3630025","3630025",189,133,56,3,10,38,46,154,110,44,3,7,30,35
"n2010033","2010033",5836,3655,2181,688,269,1098,1344,5396,3447,1949,605,231,970,1190
"n1132150","1132150",3091,281,2810,28,112,2653,2741,2387,265,2122,25,78,1994,2062
"n293027","293027",2208,1216,992,128,79,773,834,1708,1006,702,77,45,551,591
"n1133104","1133104",3836,548,3288,133,2084,1104,3129,2913,499,2414,102,1583,737,2294
"n4393406","4393406",0,0,0,0,0,0,0,0,0,0,0,0,0,0
"n2510006","2510006",626,507,119,7,27,55,78,509,430,79,3,18,41,56
"n4730209","4730209",4384,2783,1601,47,116,1326,1434,3313,2249,1064,31,84,858,939
"n2010201","2010201",1491,38,1453,12,781,679,1440,1082,27,1055,8,622,441,1047
"n292175","292175",4742,1206,3536,1561,407,1557,1918,3836,1095,2741,1137,322,1255,1559
"n1133066","1133066",4744,73,4671,19,2496,2169,4621,3159,61,3098,7,1791,1295,3071
"n292007","292007",3491,106,3385,17,58,3317,3357,2628,92,2536,11,43,2484,2514
"n850150","850150",2210,1370,840,182,295,316,601,1589,1027,562,128,205,194,389
"n1450402","1450402",1651,920,731,6,130,556,681,1233,746,487,6,93,350,443
"n2030014","2030014",1987,1363,624,13,326,203,529,1534,1073,461,7,263,122,385
"n2090342A","2090342A",1557,897,660,30,86,511,585,1202,724,478,23,62,371,426
"n4550010","4550010",395,375,20,2,3,8,11,323,308,15,1,1,8,9
"n293194","293194",6921,3781,3140,539,313,2203,2449,4727,2693,2034,336,203,1424,1585
"n292092","292092",992,232,760,36,94,626,710,792,224,568,28,70,459,525
"n1134010","1134010",1842,1013,829,74,52,662,709,1501,872,629,50,41,499,539
"n2150014","2150014",1867,102,1765,10,13,1732,1737,1438,90,1348,7,9,1322,1327
"n4392425","4392425",5513,2237,3276,276,1905,1062,2881,4287,1908,2379,215,1371,737,2071
"n2010115","2010115",4141,144,3997,13,1012,2999,3971,2913,131,2782,10,791,1984,2759
"n2010327","2010327",2625,97,2528,21,1679,839,2489,1966,56,1910,15,1350,538,1877
"n4392269","4392269",998,199,799,135,235,426,654,717,172,545,117,150,269,414
"n850067","850067",4208,2513,1695,743,429,446,861,3710,2259,1451,664,360,347,699
"n1132411","1132411",2573,211,2362,62,95,2218,2291,1902,187,1715,60,72,1595,1654
"n3750422","3750422",8931,2289,6642,160,2541,3854,6262,6645,1944,4701,103,1871,2588,4412
"n1133023","1133023",1939,36,1903,1,1388,500,1881,1506,31,1475,0,1134,328,1458
"n2650109","2650109",2048,1577,471,39,36,363,388,1713,1374,339,26,23,253,269
"n770014","770014",227,205,22,2,1,12,12,175,160,15,2,1,5,5
"n294072","294072",4254,2300,1954,77,205,1578,1763,3413,1944,1469,46,150,1186,1324
"n1134503","1134503",7754,1208,6546,959,2398,3201,5497,5726,1035,4691,748,1696,2220,3864
"n4393668","4393668",506,364,142,65,11,60,66,355,272,83,45,1,31,32
"n2930404","2930404",537,393,144,5,39,83,120,430,334,96,2,30,45,74
"n1410166","1410166",5819,616,5203,33,72,5082,5130,4329,526,3803,16,55,3712,3749
"n710013","710013",0,0,0,0,0,0,0,0,0,0,0,0,0,0
"n294115","294115",266,125,141,7,16,111,122,219,106,113,7,15,84,94
"n1134030","1134030",287,28,259,0,113,146,254,40,1,39,0,3,36,36
"n2010390","2010390",5734,1643,4091,1477,1612,1016,2605,5551,1604,3947,1462,1506,983,2474
"n4910338","4910338",3826,2866,960,126,78,628,695,3016,2353,663,90,41,431,469
"n2010284","2010284",14660,1714,12946,1353,2120,9478,11373,10513,1523,8990,861,1564,6575,7990
"n2011133","2011133",161,58,103,22,39,46,82,100,39,61,9,24,26,49
"n3030028","3030028",3006,1856,1150,189,189,713,882,2363,1574,789,141,114,465,573
"n4394125","4394125",1759,538,1221,12,68,1127,1185,1256,433,823,6,54,739,793
"n294009","294009",2342,129,2213,59,650,1570,2152,1644,118,1526,39,395,1114,1474
"n2870301","2870301",210,164,46,0,12,29,40,163,133,30,0,8,18,26
"n1134078","1134078",3212,1112,2100,89,298,1690,1969,2712,1027,1685,77,255,1321,1566
"n4910191","4910191",1308,680,628,82,186,337,507,981,545,436,54,128,231,353
"n1133801","1133801",1289,112,1177,6,163,1005,1163,922,93,829,3,132,688,817
"n4393509","4393509",3483,2165,1318,163,244,771,985,2646,1737,909,122,142,530,654
"n3810325","3810325",2794,2117,677,51,60,472,531,2028,1598,430,34,32,292,323
"n2570026","2570026",4203,1026,3177,35,1782,1357,3093,2937,804,2133,29,1231,834,2060
"n2010221","2010221",6235,607,5628,65,91,5470,5538,4612,542,4070,54,69,3934,3994
"n730044","730044",2218,1520,698,23,67,547,614,1690,1212,478,17,44,360,404
"n4790413","4790413",4316,79,4237,7,25,4210,4215,3115,61,3054,3,15,3043,3045
"n4392670","4392670",306,103,203,3,64,132,192,234,97,137,1,43,95,134
"n610089","610089",1929,99,1830,14,11,1806,1812,1342,87,1255,9,7,1241,1244
"n292050","292050",3103,483,2620,41,169,2422,2562,2347,417,1930,31,103,1788,1882
"n2010453","2010453",1962,407,1555,92,334,1131,1438,1514,341,1173,73,266,831,1081
"n1571143","1571143",13512,4855,8657,4691,1119,2648,3713,8437,3102,5335,2854,687,1656,2313
"n1132083","1132083",2116,1321,795,102,56,607,651,1834,1188,646,90,42,484,521
"n4850403","4850403",5758,3686,2072,206,450,1267,1646,4283,2975,1308,150,270,751,994
"n4393215","4393215",3199,2302,897,134,254,417,654,2635,2007,628,94,168,299,458
"n2010158","2010158",4734,48,4686,43,4216,496,4637,3319,31,3288,31,2978,311,3253
"n2510025","2510025",3848,1948,1900,148,416,1284,1679,3148,1618,1530,128,381,978,1346
"n293151","293151",4762,2216,2546,394,233,1886,2084,3369,1625,1744,276,154,1265,1404
"n1133203","1133203",3446,737,2709,65,1383,1268,2610,2567,644,1923,51,1013,844,1840
"n3590101","3590101",271,168,103,5,44,56,93,90,59,31,0,14,17,26
"n4394261","4394261",5927,2543,3384,674,807,1821,2590,4489,2079,2410,523,534,1273,1778
"n1572151","1572151",3758,825,2933,697,1838,406,2210,2846,687,2159,520,1365,280,1624
"n294026","294026",6892,659,6233,41,206,6001,6145,5124,591,4533,30,139,4346,4462
"n2150051","2150051",3908,45,3863,6,12,3836,3838,2731,26,2705,2,8,2689,2691
"n3030102","3030102",637,492,145,4,13,99,108,477,384,93,4,11,54,63
"n4910244","4910244",3756,2754,1002,163,201,528,711,2856,2188,668,113,124,346,466
"n2010407","2010407",7186,2622,4564,877,562,3094,3605,5694,2277,3417,741,415,2211,2595
"n3030025","3030025",2226,468,1758,20,325,1385,1682,1661,407,1254,19,222,981,1192
"n3890004","3890004",76,38,38,0,1,37,38,62,34,28,0,0,28,28
"n4910331","4910331",2060,502,1558,1286,95,165,252,1246,329,917,762,60,86,143
"n1573125","1573125",7107,1300,5807,3449,1468,847,2278,5370,999,4371,2648,1059,615,1655
"n850187","850187",803,602,201,13,11,130,141,624,482,142,9,7,85,92
"n4394122","4394122",5837,448,5389,21,145,5196,5311,4006,378,3628,19,87,3493,3569
"n4393757","4393757",0,0,0,0,0,0,0,0,0,0,0,0,0,0
"n850144","850144",3819,2159,1660,839,394,337,723,2881,1674,1207,611,294,233,523
"n2150094","2150094",6036,241,5795,21,32,5743,5749,4069,194,3875,16,17,3849,3854
"n2970007","2970007",67,36,31,1,1,26,26,51,28,23,0,1,19,19
"n397001C","397001C",5906,4489,1417,280,330,609,921,4274,3345,929,185,209,405,602
"n4910420","4910420",5938,2531,3407,252,963,2187,3051,3991,1828,2163,134,606,1338,1914
"n850230","850230",8997,3616,5381,2500,1738,1011,2695,6483,2865,3618,1641,1174,697,1846
"n4010314B","4010314B",239,47,192,0,16,175,190,130,33,97,0,9,87,96
"n1574083","1574083",8709,2020,6689,2154,2702,1847,4463,6079,1524,4555,1517,1801,1223,2983
"n1572010","1572010",6067,3497,2570,70,348,2033,2353,4427,2733,1694,48,246,1326,1555
"n294069","294069",1142,552,590,10,86,464,541,991,514,477,7,78,367,438
"n850101","850101",6353,3382,2971,1514,601,716,1294,4923,2693,2230,1129,465,521,974
"n1134500","1134500",3817,863,2954,528,972,1456,2394,2807,728,2079,369,672,1004,1672
"n2150137","2150137",58,14,44,1,1,43,43,47,13,34,1,1,33,33
"n2010493","2010493",6466,834,5632,1213,1529,2946,4390,4783,741,4042,980,1049,2035,3039
"n293188","293188",0,0,0,0,0,0,0,0,0,0,0,0,0,0
"n1134051","1134051",42,7,35,4,8,24,26,28,7,21,4,6,12,14
"n2150008","2150008",3301,462,2839,86,41,2723,2737,2609,420,2189,68,26,2087,2100
"n3070102","3070102",204,121,83,0,3,75,76,177,108,69,0,2,62,63
"n3810306","3810306",3253,2560,693,82,59,458,512,2485,1982,503,54,40,336,373
"n4910135","4910135",6504,2351,4153,464,982,2630,3545,5232,2084,3148,376,736,1926,2624
"n4394496","4394496",1448,459,989,85,434,442,864,1173,431,742,80,297,340,629
"n1670203","1670203",1450,1240,210,27,17,127,142,1278,1130,148,18,12,85,97
"n294198","294198",2976,625,2351,116,908,1406,2221,2121,485,1636,87,614,944,1521
"n50004","50004",3006,1298,1708,37,650,968,1612,2215,1044,1171,28,494,604,1096
"n294155","294155",3435,942,2493,57,103,2310,2380,2909,843,2066,47,79,1902,1961
"n2010579","2010579",4368,210,4158,61,1307,2822,4086,3086,180,2906,40,979,1896,2855
"n4391023","4391023",6766,2895,3871,232,1903,1678,3509,4719,2235,2484,154,1219,1034,2231
"n4530211","4530211",3201,2392,809,195,128,412,523,2659,1990,669,167,106,333,427
"n1134558","1134558",0,0,0,0,0,0,0,0,0,0,0,0,0,0
"n3750323","3750323",6133,4595,1538,53,144,1077,1208,4786,3723,1063,33,81,720,794
"n4950201","4950201",1049,266,783,8,22,757,773,741,216,525,8,19,506,522
"n3090036","3090036",1265,975,290,28,62,177,235,1008,810,198,23,36,119,155
"n2150180","2150180",903,16,887,1,0,880,880,535,12,523,1,0,516,516
"n2010450","2010450",7985,948,7037,130,2303,4648,6853,5780,795,4985,103,1815,3088,4838
"n910107","910107",4051,2883,1168,111,193,804,970,3141,2336,805,70,150,522,660
"n4450202","4450202",810,321,489,4,4,466,470,595,240,355,1,0,339,339
"n4970014","4970014",1188,887,301,7,13,254,259,935,736,199,4,6,159,163
"n4230085","4230085",1682,1257,425,32,95,248,339,1264,979,285,21,71,153,222
"n1211060","1211060",1872,1373,499,54,116,306,408,1646,1255,391,47,87,229,310
"n930014","930014",160,135,25,1,0,17,17,130,114,16,1,0,11,11
"n1670479","1670479",2008,1421,587,24,26,456,475,1557,1156,401,15,17,302,317
"n1134648","1134648",6507,845,5662,2088,2220,1367,3514,5071,757,4314,1596,1719,992,2674
"n3310101","3310101",4060,2379,1681,34,413,1201,1582,3086,1992,1094,22,262,758,1012
"n2150240","2150240",2161,171,1990,26,13,1951,1956,1518,158,1360,20,3,1330,1333
"n293044","293044",2184,1103,1081,103,146,843,962,1794,944,850,81,97,667,749
"n10903-3","10903-3",54,21,33,3,3,28,30,48,21,27,0,2,25,27
"n4850307","4850307",2026,794,1232,24,254,944,1179,1490,679,811,20,146,639,775
"n2010536","2010536",7448,503,6945,1302,904,4797,5596,5495,424,5071,1045,674,3346,3974
"n1211020","1211020",3497,2300,1197,624,225,310,512,2204,1483,721,377,146,172,308
"n2010639","2010639",3953,2314,1639,85,225,1246,1446,3134,1930,1204,69,156,903,1049
"n1610011A","1610011A",571,335,236,1,187,38,222,464,267,197,0,163,22,183
"n1134096","1134096",160,149,11,0,6,5,9,154,149,5,0,1,2,3
"n4970017","4970017",3933,3259,674,16,44,443,479,2947,2513,434,14,22,265,284
"n1134675","1134675",501,36,465,14,27,427,449,337,28,309,12,16,282,295
"n4090123","4090123",254,60,194,6,4,180,182,166,44,122,4,0,112,112
"n294175","294175",0,0,0,0,0,0,0,0,0,0,0,0,0,0
"n3090055","3090055",6272,4080,2192,350,673,1075,1695,4527,3100,1427,220,441,659,1081
"n4393500","4393500",688,524,164,31,38,84,122,548,436,112,20,24,55,79
"n419001W","419001W",959,433,526,9,38,466,503,663,358,305,2,19,271,290
"n294218","294218",206,50,156,2,66,92,153,202,48,154,2,66,91,152
"n870201","870201",558,268,290,6,44,220,258,410,218,192,3,34,132,166
"n2150243","2150243",132,13,119,0,2,116,118,82,9,73,0,2,71,73
"n4394588","4394588",6437,3569,2868,821,703,1227,1893,4648,2654,1994,617,466,826,1268
"n2090426","2090426",3398,2417,981,73,73,748,806,2682,1993,689,46,39,517,555
"n850207","850207",6258,3764,2494,703,961,700,1630,4187,2625,1562,449,594,413,999
"n1134027","1134027",776,7,769,4,17,760,761,543,7,536,4,12,527,528
"n3030003","3030003",5403,841,4562,645,462,3441,3842,4433,777,3656,605,366,2637,2980
"n1573174","1573174",2580,703,1877,813,639,423,1052,2006,574,1432,628,483,312,788
"n3090013","3090013",51,39,12,3,2,7,8,39,34,5,1,1,4,4
"n4394069","4394069",2438,1783,655,87,127,350,470,1983,1541,442,62,85,232,312
"n4910184","4910184",2265,933,1332,181,372,736,1068,1652,727,925,141,245,512,734
"n2010513","2010513",4118,2376,1742,274,696,699,1364,3305,2049,1256,214,491,472,949
"n2010387","2010387",10301,4053,6248,139,1324,4674,5913,7398,3319,4079,95,910,2953,3815
"n2010599","2010599",1234,439,795,76,190,537,702,971,393,578,68,139,369,496
"n170003","170003",1753,418,1335,1,22,1293,1306,1196,341,855,1,10,831,839
"n1134125","1134125",0,0,0,0,0,0,0,0,0,0,0,0,0,0
"n3850002","3850002",693,493,200,8,10,171,177,593,449,144,6,6,122,125
"n4530127","4530127",7529,1251,6278,179,1649,4503,5995,5184,1034,4150,130,1088,2904,3937
"n2010681","2010681",257,141,116,26,33,55,87,253,140,113,26,31,53,84
"n2150117","2150117",6281,162,6119,6,17,6067,6075,4554,115,4439,1,10,4403,4408
"n2010430","2010430",8039,724,7315,1989,1403,3994,5281,5556,560,4996,1216,949,2876,3748
"n294006","294006",833,257,576,43,50,480,519,738,248,490,39,44,403,440
"n4394374","4394374",3524,1854,1670,353,357,925,1248,2667,1482,1185,280,212,641,840
"n37020A","37020A",436,177,259,4,197,48,245,345,142,203,3,160,31,191
"n4393139","4393139",2756,1336,1420,69,407,869,1241,2052,1092,960,47,243,588,820
"n2010724","2010724",1731,741,990,595,102,251,345,1312,573,739,445,87,171,254
"n870302","870302",111,86,25,2,2,22,23,90,73,17,1,0,15,15
"n1133200","1133200",2721,1027,1694,77,909,671,1560,2258,928,1330,68,728,500,1222
"n2150160","2150160",926,297,629,86,39,508,533,767,273,494,73,32,390,413
"n10010","10010",6985,2641,4344,51,2377,1894,4250,6772,2529,4243,36,2347,1842,4170
"n850081","850081",4525,2396,2129,821,512,729,1224,3612,2022,1590,598,402,538,933
"n2150071","2150071",482,19,463,0,2,460,462,285,17,268,0,2,265,267
"n1134618","1134618",1131,213,918,40,37,836,868,826,183,643,31,27,577,601
"n321003B","321003B",1261,608,653,57,40,550,578,904,484,420,42,13,349,360
"n3950002","3950002",2035,978,1057,9,330,726,1025,1512,789,723,2,230,473,699
"n850164","850164",2055,1338,717,477,86,117,196,1807,1262,545,365,63,87,144
"n2930401","2930401",3201,1063,2138,34,956,1130,2054,2369,923,1446,17,687,711,1388
"n293191","293191",310,145,165,47,1,114,114,237,111,126,38,0,84,84
"n397001A","397001A",4727,2975,1752,214,560,842,1376,3788,2499,1289,164,388,619,995
"n1133602","1133602",689,74,615,27,542,49,586,590,70,520,23,460,37,495
"n293087","293087",2390,1104,1286,70,131,1042,1157,1936,965,971,53,95,767,857
"n3990003","3990003",2358,1348,1010,24,60,879,932,1809,1128,681,18,43,576,615
"n2010324","2010324",3695,2467,1228,144,235,826,1046,2809,1932,877,98,178,571,743
"n910104","910104",2752,2193,559,32,65,367,423,2373,1949,424,26,40,268,303
"n2150028","2150028",7206,513,6693,25,54,6623,6640,4852,452,4400,20,32,4351,4364
"n4910287","4910287",3590,2308,1282,200,311,696,991,2624,1738,886,148,209,481,678
"n4410307","4410307",5608,4240,1368,230,239,810,1012,3951,3101,850,152,149,470,598
"n294049","294049",5128,894,4234,486,1470,2309,3671,3875,773,3102,386,1082,1613,2647
"n3290106","3290106",7216,2517,4699,225,629,3782,4314,5256,2004,3252,152,396,2597,2964
"n1574074","1574074",7871,1869,6002,680,2111,3268,5248,5847,1587,4260,516,1432,2273,3669
"n277001I","277001I",481,392,89,4,17,27,44,374,307,67,3,12,15,27
"n2010619","2010619",7067,4485,2582,1042,378,1059,1414,5256,3404,1852,757,262,747,997
"n1212103","1212103",3837,1200,2637,268,336,2011,2320,2907,1058,1849,210,238,1362,1592
"n1590302","1590302",1477,1126,351,24,43,217,256,1108,878,230,16,19,135,153
"n294112","294112",915,674,241,20,53,159,206,850,636,214,15,49,142,186
"n1134075","1134075",2551,324,2227,32,132,2042,2165,1969,300,1669,27,109,1510,1615
"n2010261","2010261",5093,376,4717,28,428,4259,4650,3695,317,3378,18,332,3013,3329
"n1211040","1211040",2291,634,1657,909,489,241,709,1362,414,948,539,261,127,379
"n4910229","4910229",388,283,105,17,18,56,74,307,240,67,11,12,29,41
"n1134007","1134007",250,130,120,10,35,62,97,198,107,91,7,26,47,73
"n4393664","4393664",0,0,0,0,0,0,0,0,0,0,0,0,0,0
"n1573060","1573060",7960,686,7274,3138,2849,1341,4114,5876,568,5308,2466,1926,934,2822
"n4090103","4090103",621,335,286,8,9,257,264,501,295,206,4,5,181,185
"n2010556","2010556",6620,314,6306,958,1987,3361,5272,4840,277,4563,774,1470,2312,3726
"n3350003","3350003",1707,1050,657,14,71,543,601,1286,863,423,9,39,340,378
"n4510241","4510241",6901,5102,1799,178,233,1244,1436,5589,4304,1285,128,183,842,1006
"n212011","212011",2821,1568,1253,162,281,733,997,2050,1244,806,114,187,442,624
"n1710004","1710004",4224,3057,1167,81,54,929,973,3461,2606,855,64,32,666,696
"n130020","130020",5696,3092,2604,63,109,2358,2442,4229,2462,1767,49,57,1601,1652
"n1131046","1131046",473,191,282,30,48,192,236,378,168,210,22,39,132,169
"n2230003","2230003",3245,2137,1108,34,410,590,989,2469,1716,753,25,310,358,663
"n1190007","1190007",334,286,48,4,5,23,27,271,243,28,2,2,11,13
"n294195","294195",7,4,3,0,2,1,3,7,4,3,0,2,1,3
"n49903-2","49903-2",3718,3315,403,17,28,215,241,3309,3008,301,14,23,142,163
"n4393389","4393389",6249,3115,3134,1054,976,986,1907,5003,2664,2339,770,729,735,1432
"n1670196","1670196",1494,328,1166,23,726,430,1120,1145,285,860,17,562,282,823
"n50001","50001",1318,375,943,15,320,607,918,895,319,576,9,195,370,562
"n930011","930011",789,559,230,0,9,185,190,586,450,136,0,3,112,114
"n2150220","2150220",1482,70,1412,34,14,1371,1378,927,44,883,24,4,861,862
"n4150011","4150011",205,156,49,6,7,34,39,168,133,35,6,3,23,26
"n1212083","1212083",2999,1567,1432,712,329,347,657,2115,1115,1000,519,220,220,432
"n1450202","1450202",2209,411,1798,6,1166,640,1773,1633,365,1268,4,824,438,1253
"n2090335","2090335",4420,3374,1046,50,49,788,822,3547,2888,659,30,25,496,510
"n37003A","37003A",2135,1237,898,24,615,199,799,1579,1030,549,19,357,113,465
"n850018","850018",1478,982,496,24,24,376,398,1121,803,318,20,19,221,239
"n1133701","1133701",12,4,8,1,1,6,7,10,3,7,1,1,5,6
"n1610009B","1610009B",312,249,63,0,23,40,61,255,202,53,0,21,31,52
"n2910024","2910024",4813,3503,1310,27,169,965,1124,3671,2797,874,19,120,619,730
"n4070011","4070011",994,684,310,7,164,112,271,797,545,252,4,139,88,223
"n2010533","2010533",2902,716,2186,47,535,1584,2091,2082,587,1495,42,350,1069,1408
"n850061","850061",2121,1355,766,208,195,320,504,1781,1207,574,166,145,216,359
"n3090075","3090075",4530,3688,842,62,76,563,628,3391,2825,566,47,38,368,404
"n3710005","3710005",97,44,53,2,1,49,50,77,38,39,2,1,35,36
"n4910415","4910415",2621,1728,893,9,118,706,810,2057,1439,618,6,92,466,552
"n4393826","4393826",0,0,0,0,0,0,0,0,0,0,0,0,0,0
"n2010367","2010367",2717,523,2194,83,636,1472,2080,2183,492,1691,71,560,1052,1590
"n2150134","2150134",4620,980,3640,84,64,3483,3524,3514,807,2707,60,47,2584,2620
"n2870201","2870201",762,660,102,6,18,68,84,629,561,68,3,12,47,57
"n1134642","1134642",452,80,372,22,18,337,350,345,76,269,16,14,239,252
"n3190210","3190210",961,557,404,4,7,378,381,761,467,294,0,5,278,279
"n990413","990413",11883,6361,5522,105,2521,2777,5249,10867,5731,5136,86,2409,2537,4908
"n2170004","2170004",3265,2661,604,38,63,401,455,2694,2314,380,21,28,230,258
"n4530103","4530103",2903,1591,1312,161,472,630,1074,2611,1471,1140,129,410,554,945
"n2010662","2010662",2989,1743,1246,129,50,1016,1063,2275,1395,880,108,32,689,718
"n3670210","3670210",2834,2290,544,10,42,338,380,2209,1836,373,7,30,219,249
"n293148","293148",2062,991,1071,300,139,639,753,1361,687,674,183,80,407,480
"n1134099","1134099",1555,1077,478,112,116,218,330,1360,962,398,89,92,187,279
"n4850310","4850310",4988,1321,3667,68,1714,1829,3468,3770,1167,2603,45,1218,1261,2442
"n33001B","33001B",84,75,9,1,2,7,8,65,61,4,0,0,4,4
"n2110303","2110303",127,94,33,5,3,28,30,98,80,18,3,0,15,15
"n4394682","4394682",1009,148,861,43,22,798,819,720,141,579,40,7,532,539
"n1572161","1572161",1044,633,411,9,137,234,369,771,496,275,4,98,149,247
"n850147","850147",3629,1716,1913,653,704,527,1211,2711,1358,1353,468,497,357,847
"n4910321","4910321",44,25,19,6,1,12,13,28,18,10,4,0,6,6
"n2010410","2010410",2002,164,1838,35,523,1280,1788,1456,147,1309,27,421,858,1271
